CPRO	PROVINCIA	CMUN	NOMBRE	POB00	VARONES	MUJERES	cod_ine
01	Álava	001	Alegría-Dulantzi	1401	731	670	01001	
01	Álava	002	Amurrio	9720	4839	4881	01002
01	Álava	003	Aramaio	1416	747	669	01003
01	Álava	004	Artziniega	1338	669	669	01004
01	Álava	006	Armiñón	146	76	70	01006
01	Álava	008	Arrazua-Ubarrundia	726	388	338	01008
01	Álava	009	Asparrena	1578	784	794	01009
01	Álava	010	Ayala/Aiara	2064	1028	1036	01010
01	Álava	011	Baños de Ebro/Mañueta	328	181	147	01011
01	Álava	013	Barrundia	610	342	268	01013
01	Álava	014	Berantevilla	430	222	208	01014
01	Álava	016	Bernedo	547	314	233	01016
01	Álava	017	Campezo/Kanpezu	1060	560	500	01017
01	Álava	018	Zigoitia	1242	690	552	01018
01	Álava	019	Kripan	188	99	89	01019
01	Álava	020	Kuartango	374	211	163	01020
01	Álava	021	Elburgo/Burgelu	319	174	145	01021
01	Álava	022	Elciego	925	464	461	01022
01	Álava	023	Elvillar/Bilar	363	194	169	01023
01	Álava	027	Iruraiz-Gauna	431	234	197	01027
01	Álava	028	Labastida	1243	665	578	01028
01	Álava	030	Lagrán	202	107	95	01030
01	Álava	031	Laguardia	1412	730	682	01031
01	Álava	032	Lanciego/Lantziego	652	343	309	01032
01	Álava	033	Lapuebla de Labarca	865	440	425	01033
01	Álava	034	Leza	208	114	94	01034
01	Álava	036	Llodio	19260	9623	9637	01036
01	Álava	037	Arraia-Maeztu	698	375	323	01037
01	Álava	039	Moreda de Álava	290	157	133	01039
01	Álava	041	Navaridas	209	116	93	01041
01	Álava	042	Okondo	832	426	406	01042
01	Álava	043	Oyón/Oion	2328	1177	1151	01043
01	Álava	044	Peñacerrada-Urizaharra	251	137	114	01044
01	Álava	046	Ribera Alta	543	323	220	01046
01	Álava	047	Ribera Baja/Erribera Beitia	596	328	268	01047
01	Álava	049	Añana	190	101	89	01049
01	Álava	051	Salvatierra o Agurain	4014	1995	2019	01051
01	Álava	052	Samaniego	312	158	154	01052
01	Álava	053	San Millán/Donemiliaga	689	377	312	01053
01	Álava	054	Urkabustaiz	871	477	394	01054
01	Álava	055	Valdegovía	929	502	427	01055
01	Álava	056	Harana/Valle de Arana	348	192	156	01056
01	Álava	057	Villabuena de Álava/Eskuernaga	335	166	169	01057
01	Álava	058	Legutiano	1377	720	657	01058
01	Álava	059	Vitoria-Gasteiz	217358	106791	110567	01059
01	Álava	060	Yécora	265	130	135	01060
01	Álava	061	Zalduondo	138	75	63	01061
01	Álava	062	Zambrana	364	196	168	01062
01	Álava	063	Zuia	1725	878	847	01063
01	Álava	901	Iruña Oka/Iruña de Oca	1823	958	865	01901
01	Álava	902	Lantarón	964	545	419	01902
02	Albacete	001	Abengibre	976	479	497	02001
02	Albacete	002	Alatoz	661	345	316	02002
02	Albacete	003	Albacete	149667	73284	76383	02003
02	Albacete	004	Albatana	872	435	437	02004
02	Albacete	005	Alborea	814	422	392	02005
02	Albacete	006	Alcadozo	776	399	377	02006
02	Albacete	007	Alcalá del Júcar	1507	774	733	02007
02	Albacete	008	Alcaraz	1738	833	905	02008
02	Albacete	009	Almansa	23775	11686	12089	02009
02	Albacete	010	Alpera	2349	1213	1136	02010
02	Albacete	011	Ayna	980	497	483	02011
02	Albacete	012	Balazote	2273	1151	1122	02012
02	Albacete	013	Balsa de Ves	259	140	119	02013
02	Albacete	014	Ballestero (El)	565	286	279	02014
02	Albacete	015	Barrax	1938	963	975	02015
02	Albacete	016	Bienservida	912	467	445	02016
02	Albacete	017	Bogarra	1296	681	615	02017
02	Albacete	018	Bonete	1217	615	602	02018
02	Albacete	019	Bonillo (El)	3260	1649	1611	02019
02	Albacete	020	Carcelén	673	358	315	02020
02	Albacete	021	Casas de Juan Núñez	1275	658	617	02021
02	Albacete	022	Casas de Lázaro	445	243	202	02022
02	Albacete	023	Casas de Ves	891	465	426	02023
02	Albacete	024	Casas-Ibáñez	4155	2097	2058	02024
02	Albacete	025	Caudete	8995	4502	4493	02025
02	Albacete	026	Cenizate	1076	558	518	02026
02	Albacete	027	Corral-Rubio	476	244	232	02027
02	Albacete	028	Cotillas	207	102	105	02028
02	Albacete	029	Chinchilla de Monte-Aragón	3205	1665	1540	02029
02	Albacete	030	Elche de la Sierra	3898	1927	1971	02030
02	Albacete	031	Férez	821	411	410	02031
02	Albacete	032	Fuensanta	378	199	179	02032
02	Albacete	033	Fuente-Álamo	2480	1269	1211	02033
02	Albacete	034	Fuentealbilla	1809	914	895	02034
02	Albacete	035	Gineta (La)	2043	1000	1043	02035
02	Albacete	036	Golosalvo	112	53	59	02036
02	Albacete	037	Hellín	26581	13152	13429	02037
02	Albacete	038	Herrera (La)	411	209	202	02038
02	Albacete	039	Higueruela	1319	667	652	02039
02	Albacete	040	Hoya-Gonzalo	791	407	384	02040
02	Albacete	041	Jorquera	577	311	266	02041
02	Albacete	042	Letur	1317	642	675	02042
02	Albacete	043	Lezuza	1762	923	839	02043
02	Albacete	044	Liétor	1635	843	792	02044
02	Albacete	045	Madrigueras	4520	2277	2243	02045
02	Albacete	046	Mahora	1348	666	682	02046
02	Albacete	047	Masegoso	160	94	66	02047
02	Albacete	048	Minaya	1764	896	868	02048
02	Albacete	049	Molinicos	1332	684	648	02049
02	Albacete	050	Montalvos	143	72	71	02050
02	Albacete	051	Montealegre del Castillo	2160	1080	1080	02051
02	Albacete	052	Motilleja	508	249	259	02052
02	Albacete	053	Munera	4031	2035	1996	02053
02	Albacete	054	Navas de Jorquera	545	277	268	02054
02	Albacete	055	Nerpio	1763	945	818	02055
02	Albacete	056	Ontur	2416	1190	1226	02056
02	Albacete	057	Ossa de Montiel	2774	1371	1403	02057
02	Albacete	058	Paterna del Madera	538	281	257	02058
02	Albacete	059	Peñascosa	401	206	195	02059
02	Albacete	060	Peñas de San Pedro	1230	644	586	02060
02	Albacete	061	Pétrola	937	479	458	02061
02	Albacete	062	Povedilla	719	378	341	02062
02	Albacete	063	Pozohondo	1860	956	904	02063
02	Albacete	064	Pozo-Lorente	524	260	264	02064
02	Albacete	065	Pozuelo	708	372	336	02065
02	Albacete	066	Recueja (La)	340	169	171	02066
02	Albacete	067	Riópar	1511	769	742	02067
02	Albacete	068	Robledo	413	218	195	02068
02	Albacete	069	Roda (La)	13651	6819	6832	02069
02	Albacete	070	Salobre	604	303	301	02070
02	Albacete	071	San Pedro	1344	686	658	02071
02	Albacete	072	Socovos	2021	1040	981	02072
02	Albacete	073	Tarazona de la Mancha	6074	3015	3059	02073
02	Albacete	074	Tobarra	7485	3755	3730	02074
02	Albacete	075	Valdeganga	1966	984	982	02075
02	Albacete	076	Vianos	505	244	261	02076
02	Albacete	077	Villa de Ves	68	32	36	02077
02	Albacete	078	Villalgordo del Júcar	1295	645	650	02078
02	Albacete	079	Villamalea	3515	1799	1716	02079
02	Albacete	080	Villapalacios	828	418	410	02080
02	Albacete	081	Villarrobledo	22276	10879	11397	02081
02	Albacete	082	Villatoya	191	100	91	02082
02	Albacete	083	Villavaliente	282	149	133	02083
02	Albacete	084	Villaverde de Guadalimar	528	276	252	02084
02	Albacete	085	Viveros	538	290	248	02085
02	Albacete	086	Yeste	4280	2171	2109	02086
03	Alicante/Alacant	001	Adsubia	547	280	267	03001
03	Alicante/Alacant	002	Agost	4095	2037	2058	03002
03	Alicante/Alacant	003	Agres	639	340	299	03003
03	Alicante/Alacant	004	Aigües	581	299	282	03004
03	Alicante/Alacant	005	Albatera	8811	4447	4364	03005
03	Alicante/Alacant	006	Alcalalí	981	503	478	03006
03	Alicante/Alacant	007	Alcocer de Planes	129	54	75	03007
03	Alicante/Alacant	008	Alcoleja	257	123	134	03008
03	Alicante/Alacant	009	Alcoy/Alcoi	60423	29138	31285	03009
03	Alicante/Alacant	010	Alfafara	394	188	206	03010
03	Alicante/Alacant	011	Alfàs del Pi (l')	14139	6865	7274	03011
03	Alicante/Alacant	012	Algorfa	1243	628	615	03012
03	Alicante/Alacant	013	Algueña	1447	715	732	03013
03	Alicante/Alacant	014	Alicante/Alacant	276886	132771	144115	03014
03	Alicante/Alacant	015	Almoradí	13807	6944	6863	03015
03	Alicante/Alacant	016	Almudaina	117	61	56	03016
03	Alicante/Alacant	017	Alqueria d'Asnar (l')	418	204	214	03017
03	Alicante/Alacant	018	Altea	15579	7661	7918	03018
03	Alicante/Alacant	019	Aspe	16593	8277	8316	03019
03	Alicante/Alacant	020	Balones	183	87	96	03020
03	Alicante/Alacant	021	Banyeres de Mariola	6906	3430	3476	03021
03	Alicante/Alacant	022	Benasau	189	94	95	03022
03	Alicante/Alacant	023	Beneixama	1795	895	900	03023
03	Alicante/Alacant	024	Benejúzar	4942	2441	2501	03024
03	Alicante/Alacant	025	Benferri	1055	550	505	03025
03	Alicante/Alacant	026	Beniarbeig	1172	578	594	03026
03	Alicante/Alacant	027	Beniardá	205	98	107	03027
03	Alicante/Alacant	028	Beniarrés	1397	698	699	03028
03	Alicante/Alacant	029	Benichembla	392	200	192	03029
03	Alicante/Alacant	030	Benidoleig	860	420	440	03030
03	Alicante/Alacant	031	Benidorm	54321	26627	27694	03031
03	Alicante/Alacant	032	Benifallim	148	68	80	03032
03	Alicante/Alacant	033	Benifato	148	72	76	03033
03	Alicante/Alacant	034	Benijófar	1866	917	949	03034
03	Alicante/Alacant	035	Benilloba	922	467	455	03035
03	Alicante/Alacant	036	Benillup	93	47	46	03036
03	Alicante/Alacant	037	Benimantell	415	200	215	03037
03	Alicante/Alacant	038	Benimarfull	410	190	220	03038
03	Alicante/Alacant	039	Benimassot	173	89	84	03039
03	Alicante/Alacant	040	Benimeli	326	162	164	03040
03	Alicante/Alacant	041	Benissa	10078	4984	5094	03041
03	Alicante/Alacant	042	Benitachell/Poble Nou de Benitatxell (el)	2312	1178	1134	03042
03	Alicante/Alacant	043	Biar	3562	1733	1829	03043
03	Alicante/Alacant	044	Bigastro	4910	2467	2443	03044
03	Alicante/Alacant	045	Bolulla	324	154	170	03045
03	Alicante/Alacant	046	Busot	1717	872	845	03046
03	Alicante/Alacant	047	Calpe/Calp	16733	8392	8341	03047
03	Alicante/Alacant	048	Callosa d'En Sarrià	6488	3239	3249	03048
03	Alicante/Alacant	049	Callosa de Segura	15409	7695	7714	03049
03	Alicante/Alacant	050	Campello (el)	18366	9103	9263	03050
03	Alicante/Alacant	051	Campo de Mirra/Camp de Mirra (el)	397	195	202	03051
03	Alicante/Alacant	052	Cañada	1132	534	598	03052
03	Alicante/Alacant	053	Castalla	7631	3792	3839	03053
03	Alicante/Alacant	054	Castell de Castells	466	228	238	03054
03	Alicante/Alacant	055	Catral	5012	2496	2516	03055
03	Alicante/Alacant	056	Cocentaina	10468	5123	5345	03056
03	Alicante/Alacant	057	Confrides	325	185	140	03057
03	Alicante/Alacant	058	Cox	5825	2967	2858	03058
03	Alicante/Alacant	059	Crevillente	24690	12415	12275	03059
03	Alicante/Alacant	060	Quatretondeta	179	91	88	03060
03	Alicante/Alacant	061	Daya Nueva	1193	621	572	03061
03	Alicante/Alacant	062	Daya Vieja	190	98	92	03062
03	Alicante/Alacant	063	Dénia	30693	15013	15680	03063
03	Alicante/Alacant	064	Dolores	6276	3209	3067	03064
03	Alicante/Alacant	065	Elche/Elx	195791	96779	99012	03065
03	Alicante/Alacant	066	Elda	51501	25085	26416	03066
03	Alicante/Alacant	067	Facheca	134	68	66	03067
03	Alicante/Alacant	068	Famorca	63	30	33	03068
03	Alicante/Alacant	069	Finestrat	2169	1080	1089	03069
03	Alicante/Alacant	070	Formentera del Segura	2093	1018	1075	03070
03	Alicante/Alacant	071	Gata de Gorgos	5032	2501	2531	03071
03	Alicante/Alacant	072	Gaianes	298	134	164	03072
03	Alicante/Alacant	073	Gorga	265	137	128	03073
03	Alicante/Alacant	074	Granja de Rocamora	1963	979	984	03074
03	Alicante/Alacant	075	Guadalest	181	92	89	03075
03	Alicante/Alacant	076	Guardamar del Segura	9326	4636	4690	03076
03	Alicante/Alacant	077	Hondón de las Nieves	1611	794	817	03077
03	Alicante/Alacant	078	Hondón de los Frailes	563	288	275	03078
03	Alicante/Alacant	079	Ibi	21293	10552	10741	03079
03	Alicante/Alacant	080	Jacarilla	1556	780	776	03080
03	Alicante/Alacant	081	Jalón/Xaló	2086	1031	1055	03081
03	Alicante/Alacant	082	Jávea/Xàbia	23133	11454	11679	03082
03	Alicante/Alacant	083	Jijona/Xixona	7337	3440	3897	03083
03	Alicante/Alacant	084	Lorcha/Orxa (l')	788	396	392	03084
03	Alicante/Alacant	085	Llíber	550	276	274	03085
03	Alicante/Alacant	086	Millena	182	88	94	03086
03	Alicante/Alacant	088	Monforte del Cid	5260	2708	2552	03088
03	Alicante/Alacant	089	Monóvar/Monòver	11922	5853	6069	03089
03	Alicante/Alacant	090	Mutxamel	14693	7320	7373	03090
03	Alicante/Alacant	091	Murla	333	138	195	03091
03	Alicante/Alacant	092	Muro de Alcoy	7252	3572	3680	03092
03	Alicante/Alacant	093	Novelda	23830	11768	12062	03093
03	Alicante/Alacant	094	Nucia (la)	8616	4282	4334	03094
03	Alicante/Alacant	095	Ondara	5310	2661	2649	03095
03	Alicante/Alacant	096	Onil	6829	3405	3424	03096
03	Alicante/Alacant	097	Orba	1659	807	852	03097
03	Alicante/Alacant	098	Orxeta	427	214	213	03098
03	Alicante/Alacant	099	Orihuela	53478	26516	26962	03099
03	Alicante/Alacant	100	Parcent	857	426	431	03100
03	Alicante/Alacant	101	Pedreguer	5952	2917	3035	03101
03	Alicante/Alacant	102	Pego	10103	5146	4957	03102
03	Alicante/Alacant	103	Penàguila	391	192	199	03103
03	Alicante/Alacant	104	Petrer	28765	14359	14406	03104
03	Alicante/Alacant	105	Pinoso	6186	3058	3128	03105
03	Alicante/Alacant	106	Planes	815	404	411	03106
03	Alicante/Alacant	107	Polop	2136	1037	1099	03107
03	Alicante/Alacant	109	Rafal	3201	1590	1611	03109
03	Alicante/Alacant	110	"Ràfol d'Almúnia	 el"	402	198	204	03110
03	Alicante/Alacant	111	Redován	5450	2798	2652	03111
03	Alicante/Alacant	112	Relleu	795	396	399	03112
03	Alicante/Alacant	113	Rojales	7321	3585	3736	03113
03	Alicante/Alacant	114	Romana (la)	1995	1000	995	03114
03	Alicante/Alacant	115	Sagra	399	197	202	03115
03	Alicante/Alacant	116	Salinas	1215	615	600	03116
03	Alicante/Alacant	117	Sanet y Negrals	547	249	298	03117
03	Alicante/Alacant	118	San Fulgencio	3706	1858	1848	03118
03	Alicante/Alacant	119	San Juan de Alicante	16895	8257	8638	03119
03	Alicante/Alacant	120	San Miguel de Salinas	3893	1981	1912	03120
03	Alicante/Alacant	121	Santa Pola	18922	9416	9506	03121
03	Alicante/Alacant	122	San Vicente del Raspeig/Sant Vicent del Raspeig	37883	18836	19047	03122
03	Alicante/Alacant	123	Sax	8625	4331	4294	03123
03	Alicante/Alacant	124	Sella	591	298	293	03124
03	Alicante/Alacant	125	Senija	509	261	248	03125
03	Alicante/Alacant	127	Tárbena	693	347	346	03127
03	Alicante/Alacant	128	Teulada	9328	4616	4712	03128
03	Alicante/Alacant	129	Tibi	1205	625	580	03129
03	Alicante/Alacant	130	Tollos	42	26	16	03130
03	Alicante/Alacant	131	Tormos	303	146	157	03131
03	Alicante/Alacant	132	Torremanzanas/Torre de les Maçanes (la)	720	363	357	03132
03	Alicante/Alacant	133	Torrevieja	50189	24782	25407	03133
03	Alicante/Alacant	134	Vall d'Alcalà (la)	181	92	89	03134
03	Alicante/Alacant	135	Vall de Ebo	355	176	179	03135
03	Alicante/Alacant	136	Vall de Gallinera	578	304	274	03136
03	Alicante/Alacant	137	Vall de Laguart	912	427	485	03137
03	Alicante/Alacant	138	Verger (el)	3642	1753	1889	03138
03	Alicante/Alacant	139	Villajoyosa/Vila Joiosa (la)	23704	11688	12016	03139
03	Alicante/Alacant	140	Villena	31760	15680	16080	03140
03	Alicante/Alacant	901	Poblets (els)	1688	813	875	03901
03	Alicante/Alacant	902	Pilar de la Horadada	11495	6136	5359	03902
03	Alicante/Alacant	903	Montesinos (Los)	2617	1328	1289	03903
03	Alicante/Alacant	904	San Isidro	1274	658	616	03904
04	Almería	001	Abla	1516	743	773	04001
04	Almería	002	Abrucena	1455	716	739	04002
04	Almería	003	Adra	21505	10784	10721	04003
04	Almería	004	Albánchez	586	292	294	04004
04	Almería	005	Alboloduy	812	386	426	04005
04	Almería	006	Albox	9599	4801	4798	04006
04	Almería	007	Alcolea	903	455	448	04007
04	Almería	008	Alcóntar	656	341	315	04008
04	Almería	009	Alcudia de Monteagud	209	102	107	04009
04	Almería	010	Alhabia	672	327	345	04010
04	Almería	011	Alhama de Almería	3165	1580	1585	04011
04	Almería	012	Alicún	236	114	122	04012
04	Almería	013	Almería	168945	81981	86964	04013
04	Almería	014	Almócita	175	90	85	04014
04	Almería	015	Alsodux	104	53	51	04015
04	Almería	016	Antas	2729	1352	1377	04016
04	Almería	017	Arboleas	1540	767	773	04017
04	Almería	018	Armuña de Almanzora	322	159	163	04018
04	Almería	019	Bacares	291	151	140	04019
04	Almería	020	Bayárcal	320	171	149	04020
04	Almería	021	Bayarque	238	115	123	04021
04	Almería	022	Bédar	572	300	272	04022
04	Almería	023	Beires	142	69	73	04023
04	Almería	024	Benahadux	2814	1348	1466	04024
04	Almería	026	Benitagla	92	50	42	04026
04	Almería	027	Benizalón	304	158	146	04027
04	Almería	028	Bentarique	317	167	150	04028
04	Almería	029	Berja	13279	6409	6870	04029
04	Almería	030	Canjáyar	1667	851	816	04030
04	Almería	031	Cantoria	3147	1576	1571	04031
04	Almería	032	Carboneras	6530	3340	3190	04032
04	Almería	033	Castro de Filabres	170	83	87	04033
04	Almería	034	Cóbdar	227	115	112	04034
04	Almería	035	Cuevas del Almanzora	9645	4834	4811	04035
04	Almería	036	Chercos	300	160	140	04036
04	Almería	037	Chirivel	1792	890	902	04037
04	Almería	038	Dalías	3634	1789	1845	04038
04	Almería	041	Enix	289	154	135	04041
04	Almería	043	Felix	571	290	281	04043
04	Almería	044	Fines	1741	891	850	04044
04	Almería	045	Fiñana	2537	1242	1295	04045
04	Almería	046	Fondón	943	486	457	04046
04	Almería	047	Gádor	2593	1299	1294	04047
04	Almería	048	Gallardos (Los)	1798	914	884	04048
04	Almería	049	Garrucha	5292	2702	2590	04049
04	Almería	050	Gérgal	1059	531	528	04050
04	Almería	051	Huécija	558	280	278	04051
04	Almería	052	Huércal de Almería	6766	3411	3355	04052
04	Almería	053	Huércal-Overa	13999	6878	7121	04053
04	Almería	054	Illar	474	229	245	04054
04	Almería	055	Instinción	538	259	279	04055
04	Almería	056	Laroya	107	55	52	04056
04	Almería	057	Láujar de Andarax	1833	896	937	04057
04	Almería	058	Líjar	509	255	254	04058
04	Almería	059	Lubrín	1707	812	895	04059
04	Almería	060	Lucainena de las Torres	656	330	326	04060
04	Almería	061	Lúcar	767	375	392	04061
04	Almería	062	Macael	5767	2920	2847	04062
04	Almería	063	María	1654	850	804	04063
04	Almería	064	Mojácar	4825	2389	2436	04064
04	Almería	065	Nacimiento	515	258	257	04065
04	Almería	066	Níjar	16269	8549	7720	04066
04	Almería	067	Ohanes	765	384	381	04067
04	Almería	068	Olula de Castro	192	100	92	04068
04	Almería	069	Olula del Río	5927	2941	2986	04069
04	Almería	070	Oria	2129	1082	1047	04070
04	Almería	071	Padules	481	243	238	04071
04	Almería	072	Partaloa	384	188	196	04072
04	Almería	073	Paterna del Río	393	203	190	04073
04	Almería	074	Pechina	2763	1410	1353	04074
04	Almería	075	Pulpí	5477	2693	2784	04075
04	Almería	076	Purchena	1600	783	817	04076
04	Almería	077	Rágol	390	174	216	04077
04	Almería	078	Rioja	1191	590	601	04078
04	Almería	079	Roquetas de Mar	44370	22866	21504	04079
04	Almería	080	Santa Cruz de Marchena	208	93	115	04080
04	Almería	081	Santa Fe de Mondújar	473	235	238	04081
04	Almería	082	Senés	325	165	160	04082
04	Almería	083	Serón	2555	1241	1314	04083
04	Almería	084	Sierro	471	233	238	04084
04	Almería	085	Somontín	509	247	262	04085
04	Almería	086	Sorbas	2693	1364	1329	04086
04	Almería	087	Suflí	256	133	123	04087
04	Almería	088	Tabernas	3210	1618	1592	04088
04	Almería	089	Taberno	974	478	496	04089
04	Almería	090	Tahal	407	215	192	04090
04	Almería	091	Terque	430	218	212	04091
04	Almería	092	Tíjola	3757	1845	1912	04092
04	Almería	093	Turre	2331	1149	1182	04093
04	Almería	094	Turrillas	250	131	119	04094
04	Almería	095	Uleila del Campo	977	502	475	04095
04	Almería	096	Urrácal	349	168	181	04096
04	Almería	097	Velefique	314	160	154	04097
04	Almería	098	Vélez-Blanco	2061	1060	1001	04098
04	Almería	099	Vélez-Rubio	6519	3141	3378	04099
04	Almería	100	Vera	6930	3475	3455	04100
04	Almería	101	Viator	3567	1749	1818	04101
04	Almería	102	Vícar	15940	8490	7450	04102
04	Almería	103	Zurgena	2079	1015	1064	04103
04	Almería	901	Tres Villas (Las)	607	317	290	04901
04	Almería	902	Ejido (El)	53008	27910	25098	04902
04	Almería	903	Mojonera (La)	6590	3501	3089	04903
05	Ávila	001	Adanero	341	189	152	05001
05	Ávila	002	Adrada (La)	1958	1009	949	05002
05	Ávila	005	Albornos	247	138	109	05005
05	Ávila	007	Aldeanueva de Santa Cruz	193	101	92	05007
05	Ávila	008	Aldeaseca	337	170	167	05008
05	Ávila	010	Aldehuela (La)	275	136	139	05010
05	Ávila	012	Amavida	198	102	96	05012
05	Ávila	013	Arenal (El)	1056	510	546	05013
05	Ávila	014	Arenas de San Pedro	6464	3186	3278	05014
05	Ávila	015	Arevalillo	135	66	69	05015
05	Ávila	016	Arévalo	7446	3594	3852	05016
05	Ávila	017	Aveinte	134	72	62	05017
05	Ávila	018	Avellaneda	37	18	19	05018
05	Ávila	019	Ávila	47843	22996	24847	05019
05	Ávila	021	Barco de Ávila (El)	2606	1276	1330	05021
05	Ávila	022	Barraco (El)	2047	1033	1014	05022
05	Ávila	023	Barromán	257	144	113	05023
05	Ávila	024	Becedas	416	218	198	05024
05	Ávila	025	Becedillas	159	84	75	05025
05	Ávila	026	Bercial de Zapardiel	321	153	168	05026
05	Ávila	027	Berlanas (Las)	336	172	164	05027
05	Ávila	029	Bernuy-Zapardiel	223	127	96	05029
05	Ávila	030	Berrocalejo de Aragona	48	28	20	05030
05	Ávila	033	Blascomillán	289	139	150	05033
05	Ávila	034	Blasconuño de Matacabras	18	10	8	05034
05	Ávila	035	Blascosancho	161	79	82	05035
05	Ávila	036	Bohodón (El)	199	102	97	05036
05	Ávila	037	Bohoyo	452	227	225	05037
05	Ávila	038	Bonilla de la Sierra	195	106	89	05038
05	Ávila	039	Brabos	71	40	31	05039
05	Ávila	040	Bularros	115	63	52	05040
05	Ávila	041	Burgohondo	1200	615	585	05041
05	Ávila	042	Cabezas de Alambre	221	116	105	05042
05	Ávila	043	Cabezas del Pozo	159	83	76	05043
05	Ávila	044	Cabezas del Villar	497	255	242	05044
05	Ávila	045	Cabizuela	150	76	74	05045
05	Ávila	046	Canales	64	34	30	05046
05	Ávila	047	Candeleda	5115	2632	2483	05047
05	Ávila	048	Cantiveros	188	95	93	05048
05	Ávila	049	Cardeñosa	567	301	266	05049
05	Ávila	051	Carrera (La)	283	138	145	05051
05	Ávila	052	Casas del Puerto de Villatoro	102	54	48	05052
05	Ávila	053	Casasola	161	84	77	05053
05	Ávila	054	Casavieja	1582	827	755	05054
05	Ávila	055	Casillas	817	422	395	05055
05	Ávila	056	Castellanos de Zapardiel	150	82	68	05056
05	Ávila	057	Cebreros	3260	1614	1646	05057
05	Ávila	058	Cepeda la Mora	148	78	70	05058
05	Ávila	059	Cillán	146	77	69	05059
05	Ávila	060	Cisla	191	93	98	05060
05	Ávila	061	Colilla (La)	222	111	111	05061
05	Ávila	062	Collado de Contreras	269	145	124	05062
05	Ávila	063	Collado del Mirón	86	46	40	05063
05	Ávila	064	Constanzana	188	104	84	05064
05	Ávila	065	Crespos	723	372	351	05065
05	Ávila	066	Cuevas del Valle	640	346	294	05066
05	Ávila	067	Chamartín	114	66	48	05067
05	Ávila	069	Donjimeno	138	73	65	05069
05	Ávila	070	Donvidas	68	33	35	05070
05	Ávila	072	Espinosa de los Caballeros	110	63	47	05072
05	Ávila	073	Flores de Ávila	434	226	208	05073
05	Ávila	074	Fontiveros	1032	525	507	05074
05	Ávila	075	Fresnedilla	101	43	58	05075
05	Ávila	076	Fresno (El)	492	250	242	05076
05	Ávila	077	Fuente el Saúz	306	160	146	05077
05	Ávila	078	Fuentes de Año	194	102	92	05078
05	Ávila	079	Gallegos de Altamiros	97	52	45	05079
05	Ávila	080	Gallegos de Sobrinos	108	52	56	05080
05	Ávila	081	Garganta del Villar	76	42	34	05081
05	Ávila	082	Gavilanes	728	412	316	05082
05	Ávila	083	Gemuño	218	105	113	05083
05	Ávila	084	Gilbuena	135	76	59	05084
05	Ávila	085	Gil García	63	29	34	05085
05	Ávila	086	Gimialcón	115	64	51	05086
05	Ávila	087	Gotarrendura	174	63	111	05087
05	Ávila	088	Grandes y San Martín	49	24	25	05088
05	Ávila	089	Guisando	644	345	299	05089
05	Ávila	090	Gutierre-Muñoz	132	64	68	05090
05	Ávila	092	Hernansancho	230	121	109	05092
05	Ávila	093	Herradón de Pinares	504	254	250	05093
05	Ávila	094	Herreros de Suso	224	108	116	05094
05	Ávila	095	Higuera de las Dueñas	327	183	144	05095
05	Ávila	096	Hija de Dios (La)	111	61	50	05096
05	Ávila	097	Horcajada (La)	799	390	409	05097
05	Ávila	099	Horcajo de las Torres	794	427	367	05099
05	Ávila	100	Hornillo (El)	411	212	199	05100
05	Ávila	101	Hoyocasero	366	190	176	05101
05	Ávila	102	Hoyo de Pinares (El)	2359	1208	1151	05102
05	Ávila	103	Hoyorredondo	122	66	56	05103
05	Ávila	104	Hoyos del Collado	49	31	18	05104
05	Ávila	105	Hoyos del Espino	439	241	198	05105
05	Ávila	106	Hoyos de Miguel Muñoz	54	28	26	05106
05	Ávila	107	Hurtumpascual	114	64	50	05107
05	Ávila	108	Junciana	101	55	46	05108
05	Ávila	109	Langa	577	299	278	05109
05	Ávila	110	Lanzahíta	909	469	440	05110
05	Ávila	112	Losar del Barco (El)	139	72	67	05112
05	Ávila	113	Llanos de Tormes (Los)	128	66	62	05113
05	Ávila	114	Madrigal de las Altas Torres	1985	1015	970	05114
05	Ávila	115	Maello	645	319	326	05115
05	Ávila	116	Malpartida de Corneja	205	102	103	05116
05	Ávila	117	Mamblas	281	157	124	05117
05	Ávila	118	Mancera de Arriba	148	76	72	05118
05	Ávila	119	Manjabálago	70	36	34	05119
05	Ávila	120	Marlín	48	26	22	05120
05	Ávila	121	Martiherrero	201	105	96	05121
05	Ávila	122	Martínez	234	124	110	05122
05	Ávila	123	Mediana de Voltoya	108	59	49	05123
05	Ávila	124	Medinilla	210	104	106	05124
05	Ávila	125	Mengamuñoz	73	33	40	05125
05	Ávila	126	Mesegar de Corneja	119	62	57	05126
05	Ávila	127	Mijares	981	500	481	05127
05	Ávila	128	Mingorría	522	260	262	05128
05	Ávila	129	Mirón (El)	248	145	103	05129
05	Ávila	130	Mironcillo	138	73	65	05130
05	Ávila	131	Mirueña de los Infanzones	189	94	95	05131
05	Ávila	132	Mombeltrán	1169	610	559	05132
05	Ávila	133	Monsalupe	97	45	52	05133
05	Ávila	134	Moraleja de Matacabras	77	38	39	05134
05	Ávila	135	Muñana	576	297	279	05135
05	Ávila	136	Muñico	139	71	68	05136
05	Ávila	138	Muñogalindo	445	247	198	05138
05	Ávila	139	Muñogrande	107	56	51	05139
05	Ávila	140	Muñomer del Peco	132	71	61	05140
05	Ávila	141	Muñopepe	106	61	45	05141
05	Ávila	142	Muñosancho	167	76	91	05142
05	Ávila	143	Muñotello	128	66	62	05143
05	Ávila	144	Narrillos del Álamo	164	84	80	05144
05	Ávila	145	Narrillos del Rebollar	75	38	37	05145
05	Ávila	147	Narros del Castillo	240	132	108	05147
05	Ávila	148	Narros del Puerto	49	27	22	05148
05	Ávila	149	Narros de Saldueña	171	96	75	05149
05	Ávila	151	Navacepedilla de Corneja	144	80	64	05151
05	Ávila	152	Nava de Arévalo	986	517	469	05152
05	Ávila	153	Nava del Barco	172	88	84	05153
05	Ávila	154	Navadijos	60	37	23	05154
05	Ávila	155	Navaescurial	84	48	36	05155
05	Ávila	156	Navahondilla	140	81	59	05156
05	Ávila	157	Navalacruz	313	152	161	05157
05	Ávila	158	Navalmoral	594	304	290	05158
05	Ávila	159	Navalonguilla	442	226	216	05159
05	Ávila	160	Navalosa	484	254	230	05160
05	Ávila	161	Navalperal de Pinares	842	411	431	05161
05	Ávila	162	Navalperal de Tormes	143	80	63	05162
05	Ávila	163	Navaluenga	2015	1017	998	05163
05	Ávila	164	Navaquesera	62	23	39	05164
05	Ávila	165	Navarredonda de Gredos	493	252	241	05165
05	Ávila	166	Navarredondilla	320	158	162	05166
05	Ávila	167	Navarrevisca	381	192	189	05167
05	Ávila	168	Navas del Marqués (Las)	4272	2145	2127	05168
05	Ávila	169	Navatalgordo	423	214	209	05169
05	Ávila	170	Navatejares	96	41	55	05170
05	Ávila	171	Neila de San Miguel	118	64	54	05171
05	Ávila	172	Niharra	198	101	97	05172
05	Ávila	173	Ojos-Albos	65	35	30	05173
05	Ávila	174	Orbita	106	54	52	05174
05	Ávila	175	Oso (El)	226	128	98	05175
05	Ávila	176	Padiernos	242	127	115	05176
05	Ávila	177	Pajares de Adaja	196	99	97	05177
05	Ávila	178	Palacios de Goda	510	253	257	05178
05	Ávila	179	Papatrigo	347	178	169	05179
05	Ávila	180	Parral (El)	132	71	61	05180
05	Ávila	181	Pascualcobo	54	32	22	05181
05	Ávila	182	Pedro Bernardo	1289	666	623	05182
05	Ávila	183	Pedro-Rodríguez	221	104	117	05183
05	Ávila	184	Peguerinos	309	163	146	05184
05	Ávila	185	Peñalba de Ávila	131	74	57	05185
05	Ávila	186	Piedrahíta	2169	1042	1127	05186
05	Ávila	187	Piedralaves	2102	1061	1041	05187
05	Ávila	188	Poveda	84	48	36	05188
05	Ávila	189	Poyales del Hoyo	698	355	343	05189
05	Ávila	190	Pozanco	56	31	25	05190
05	Ávila	191	Pradosegar	171	89	82	05191
05	Ávila	192	Puerto Castilla	145	86	59	05192
05	Ávila	193	Rasueros	340	180	160	05193
05	Ávila	194	Riocabado	205	112	93	05194
05	Ávila	195	Riofrío	315	174	141	05195
05	Ávila	196	Rivilla de Barajas	79	40	39	05196
05	Ávila	197	Salobral	127	64	63	05197
05	Ávila	198	Salvadiós	123	62	61	05198
05	Ávila	199	San Bartolomé de Béjar	76	35	41	05199
05	Ávila	200	San Bartolomé de Corneja	106	56	50	05200
05	Ávila	201	San Bartolomé de Pinares	741	391	350	05201
05	Ávila	204	Sanchidrián	791	403	388	05204
05	Ávila	205	Sanchorreja	141	73	68	05205
05	Ávila	206	San Esteban de los Patos	46	24	22	05206
05	Ávila	207	San Esteban del Valle	872	449	423	05207
05	Ávila	208	San Esteban de Zapardiel	70	36	34	05208
05	Ávila	209	San García de Ingelmos	167	90	77	05209
05	Ávila	210	San Juan de la Encinilla	131	61	70	05210
05	Ávila	211	San Juan de la Nava	695	359	336	05211
05	Ávila	212	San Juan del Molinillo	347	197	150	05212
05	Ávila	213	San Juan del Olmo	174	100	74	05213
05	Ávila	214	San Lorenzo de Tormes	62	32	30	05214
05	Ávila	215	San Martín de la Vega del Alberche	297	168	129	05215
05	Ávila	216	San Martín del Pimpollar	328	176	152	05216
05	Ávila	217	San Miguel de Corneja	106	46	60	05217
05	Ávila	218	San Miguel de Serrezuela	209	114	95	05218
05	Ávila	219	San Pascual	56	35	21	05219
05	Ávila	220	San Pedro del Arroyo	493	253	240	05220
05	Ávila	221	Santa Cruz del Valle	623	322	301	05221
05	Ávila	222	Santa Cruz de Pinares	218	117	101	05222
05	Ávila	224	Santa María del Arroyo	131	66	65	05224
05	Ávila	225	Santa María del Berrocal	543	257	286	05225
05	Ávila	226	Santa María de los Caballeros	148	74	74	05226
05	Ávila	227	Santa María del Tiétar	402	212	190	05227
05	Ávila	228	Santiago del Collado	279	171	108	05228
05	Ávila	229	Santo Domingo de las Posadas	84	39	45	05229
05	Ávila	230	Santo Tomé de Zabarcos	119	65	54	05230
05	Ávila	231	San Vicente de Arévalo	228	114	114	05231
05	Ávila	232	Serrada (La)	151	77	74	05232
05	Ávila	233	Serranillos	415	215	200	05233
05	Ávila	234	Sigeres	77	38	39	05234
05	Ávila	235	Sinlabajos	241	125	116	05235
05	Ávila	236	Solana de Ávila	207	109	98	05236
05	Ávila	237	Solana de Rioalmar	298	159	139	05237
05	Ávila	238	Solosancho	1047	546	501	05238
05	Ávila	239	Sotalbo	267	142	125	05239
05	Ávila	240	Sotillo de la Adrada	3575	1773	1802	05240
05	Ávila	241	Tiemblo (El)	3658	1839	1819	05241
05	Ávila	242	Tiñosillos	770	412	358	05242
05	Ávila	243	Tolbaños	136	66	70	05243
05	Ávila	244	Tormellas	106	56	50	05244
05	Ávila	245	Tornadizos de Ávila	354	173	181	05245
05	Ávila	246	Tórtoles	126	64	62	05246
05	Ávila	247	Torre (La)	427	234	193	05247
05	Ávila	249	Umbrías	167	87	80	05249
05	Ávila	251	Vadillo de la Sierra	153	82	71	05251
05	Ávila	252	Valdecasa	114	61	53	05252
05	Ávila	253	Vega de Santa María	143	79	64	05253
05	Ávila	254	Velayos	260	126	134	05254
05	Ávila	256	Villaflor	167	87	80	05256
05	Ávila	257	Villafranca de la Sierra	218	115	103	05257
05	Ávila	258	Villanueva de Gómez	150	71	79	05258
05	Ávila	259	Villanueva del Aceral	186	83	103	05259
05	Ávila	260	Villanueva del Campillo	201	102	99	05260
05	Ávila	261	Villar de Corneja	77	37	40	05261
05	Ávila	262	Villarejo del Valle	514	270	244	05262
05	Ávila	263	Villatoro	235	133	102	05263
05	Ávila	264	Viñegra de Moraña	90	48	42	05264
05	Ávila	265	Vita	124	76	48	05265
05	Ávila	266	Zapardiel de la Cañada	186	92	94	05266
05	Ávila	267	Zapardiel de la Ribera	139	70	69	05267
05	Ávila	901	San Juan de Gredos	399	208	191	05901
05	Ávila	902	Santa María del Cubillo	394	225	169	05902
05	Ávila	903	Diego del Carpio	311	162	149	05903
05	Ávila	904	Santiago del Tormes	266	139	127	05904
05	Ávila	905	Villanueva de Ávila	497	254	243	05905
06	Badajoz	001	Acedera	969	506	463	06001
06	Badajoz	002	Aceuchal	5304	2626	2678	06002
06	Badajoz	003	Ahillones	1200	588	612	06003
06	Badajoz	004	Alange	2057	1054	1003	06004
06	Badajoz	005	Albuera (La)	1804	919	885	06005
06	Badajoz	006	Alburquerque	5645	2831	2814	06006
06	Badajoz	007	Alconchel	2106	1047	1059	06007
06	Badajoz	008	Alconera	721	357	364	06008
06	Badajoz	009	Aljucén	255	142	113	06009
06	Badajoz	010	Almendral	1478	731	747	06010
06	Badajoz	011	Almendralejo	27610	13507	14103	06011
06	Badajoz	012	Arroyo de San Serván	3970	2040	1930	06012
06	Badajoz	013	Atalaya	369	174	195	06013
06	Badajoz	014	Azuaga	8735	4431	4304	06014
06	Badajoz	015	Badajoz	136136	66030	70106	06015
06	Badajoz	016	Barcarrota	3742	1908	1834	06016
06	Badajoz	017	Baterno	403	208	195	06017
06	Badajoz	018	Benquerencia de la Serena	1033	522	511	06018
06	Badajoz	019	Berlanga	2694	1313	1381	06019
06	Badajoz	020	Bienvenida	2364	1221	1143	06020
06	Badajoz	021	Bodonal de la Sierra	1265	649	616	06021
06	Badajoz	022	Burguillos del Cerro	3321	1606	1715	06022
06	Badajoz	023	Cabeza del Buey	5982	2941	3041	06023
06	Badajoz	024	Cabeza la Vaca	1646	821	825	06024
06	Badajoz	025	Calamonte	6002	3003	2999	06025
06	Badajoz	026	Calera de León	1112	568	544	06026
06	Badajoz	027	Calzadilla de los Barros	848	423	425	06027
06	Badajoz	028	Campanario	5675	2763	2912	06028
06	Badajoz	029	Campillo de Llerena	1745	859	886	06029
06	Badajoz	030	Capilla	225	111	114	06030
06	Badajoz	031	Carmonita	652	337	315	06031
06	Badajoz	032	Carrascalejo (El)	73	41	32	06032
06	Badajoz	033	Casas de Don Pedro	1737	853	884	06033
06	Badajoz	034	Casas de Reina	249	118	131	06034
06	Badajoz	035	Castilblanco	1385	685	700	06035
06	Badajoz	036	Castuera	7215	3561	3654	06036
06	Badajoz	037	Codosera (La)	2397	1264	1133	06037
06	Badajoz	038	Cordobilla de Lácara	1038	524	514	06038
06	Badajoz	039	Coronada (La)	2447	1219	1228	06039
06	Badajoz	040	Corte de Peleas	1289	643	646	06040
06	Badajoz	041	Cristina	555	294	261	06041
06	Badajoz	042	Cheles	1326	660	666	06042
06	Badajoz	043	Don Álvaro	677	331	346	06043
06	Badajoz	044	Don Benito	31454	15536	15918	06044
06	Badajoz	045	Entrín Bajo	670	327	343	06045
06	Badajoz	046	Esparragalejo	1536	753	783	06046
06	Badajoz	047	Esparragosa de la Serena	1127	557	570	06047
06	Badajoz	048	Esparragosa de Lares	1167	559	608	06048
06	Badajoz	049	Feria	1435	707	728	06049
06	Badajoz	050	Fregenal de la Sierra	5379	2588	2791	06050
06	Badajoz	051	Fuenlabrada de los Montes	2078	1026	1052	06051
06	Badajoz	052	Fuente de Cantos	5039	2535	2504	06052
06	Badajoz	053	Fuente del Arco	825	418	407	06053
06	Badajoz	054	Fuente del Maestre	6818	3375	3443	06054
06	Badajoz	055	Fuentes de León	2742	1348	1394	06055
06	Badajoz	056	Garbayuela	583	310	273	06056
06	Badajoz	057	Garlitos	799	406	393	06057
06	Badajoz	058	Garrovilla (La)	2637	1350	1287	06058
06	Badajoz	059	Granja de Torrehermosa	2578	1271	1307	06059
06	Badajoz	060	Guareña	7474	3765	3709	06060
06	Badajoz	061	Haba (La)	1467	744	723	06061
06	Badajoz	062	Helechosa de los Montes	766	423	343	06062
06	Badajoz	063	Herrera del Duque	3913	1987	1926	06063
06	Badajoz	064	Higuera de la Serena	1224	622	602	06064
06	Badajoz	065	Higuera de Llerena	449	221	228	06065
06	Badajoz	066	Higuera de Vargas	2221	1108	1113	06066
06	Badajoz	067	Higuera la Real	2584	1294	1290	06067
06	Badajoz	068	Hinojosa del Valle	610	311	299	06068
06	Badajoz	069	Hornachos	3861	1988	1873	06069
06	Badajoz	070	Jerez de los Caballeros	9594	4792	4802	06070
06	Badajoz	071	Lapa (La)	328	168	160	06071
06	Badajoz	072	Lobón	2725	1393	1332	06072
06	Badajoz	073	Llera	969	498	471	06073
06	Badajoz	074	Llerena	5621	2721	2900	06074
06	Badajoz	075	Magacela	709	371	338	06075
06	Badajoz	076	Maguilla	1151	569	582	06076
06	Badajoz	077	Malcocinado	546	292	254	06077
06	Badajoz	078	Malpartida de la Serena	782	401	381	06078
06	Badajoz	079	Manchita	770	383	387	06079
06	Badajoz	080	Medellín	2400	1210	1190	06080
06	Badajoz	081	Medina de las Torres	1512	743	769	06081
06	Badajoz	082	Mengabril	462	236	226	06082
06	Badajoz	083	Mérida	50478	24600	25878	06083
06	Badajoz	084	Mirandilla	1364	688	676	06084
06	Badajoz	085	Monesterio	4679	2340	2339	06085
06	Badajoz	086	Montemolín	1696	874	822	06086
06	Badajoz	087	Monterrubio de la Serena	3093	1509	1584	06087
06	Badajoz	088	Montijo	15314	7567	7747	06088
06	Badajoz	089	Morera (La)	783	385	398	06089
06	Badajoz	090	Nava de Santiago (La)	1179	588	591	06090
06	Badajoz	091	Navalvillar de Pela	4923	2481	2442	06091
06	Badajoz	092	Nogales	788	394	394	06092
06	Badajoz	093	Oliva de la Frontera	5925	2948	2977	06093
06	Badajoz	094	Oliva de Mérida	1999	988	1011	06094
06	Badajoz	095	Olivenza	10709	5277	5432	06095
06	Badajoz	096	Orellana de la Sierra	377	195	182	06096
06	Badajoz	097	Orellana la Vieja	3397	1703	1694	06097
06	Badajoz	098	Palomas	698	370	328	06098
06	Badajoz	099	Parra (La)	1403	725	678	06099
06	Badajoz	100	Peñalsordo	1517	725	792	06100
06	Badajoz	101	Peraleda del Zaucejo	664	340	324	06101
06	Badajoz	102	Puebla de Alcocer	1476	715	761	06102
06	Badajoz	103	Puebla de la Calzada	5525	2739	2786	06103
06	Badajoz	104	Puebla de la Reina	885	449	436	06104
06	Badajoz	105	Puebla del Maestre	938	462	476	06105
06	Badajoz	106	Puebla del Prior	574	288	286	06106
06	Badajoz	107	Puebla de Obando	2043	1041	1002	06107
06	Badajoz	108	Puebla de Sancho Pérez	2875	1448	1427	06108
06	Badajoz	109	Quintana de la Serena	5134	2581	2553	06109
06	Badajoz	110	Reina	226	120	106	06110
06	Badajoz	111	Rena	669	330	339	06111
06	Badajoz	112	Retamal de Llerena	556	289	267	06112
06	Badajoz	113	Ribera del Fresno	3423	1670	1753	06113
06	Badajoz	114	Risco	216	106	110	06114
06	Badajoz	115	Roca de la Sierra (La)	1633	811	822	06115
06	Badajoz	116	Salvaleón	2214	1117	1097	06116
06	Badajoz	117	Salvatierra de los Barros	1973	961	1012	06117
06	Badajoz	118	Sancti-Spíritus	309	146	163	06118
06	Badajoz	119	San Pedro de Mérida	816	414	402	06119
06	Badajoz	120	Santa Amalia	4332	2172	2160	06120
06	Badajoz	121	Santa Marta	4102	2014	2088	06121
06	Badajoz	122	Santos de Maimona (Los)	7924	3955	3969	06122
06	Badajoz	123	San Vicente de Alcántara	5908	2917	2991	06123
06	Badajoz	124	Segura de León	2296	1144	1152	06124
06	Badajoz	125	Siruela	2463	1221	1242	06125
06	Badajoz	126	Solana de los Barros	2768	1389	1379	06126
06	Badajoz	127	Talarrubias	3658	1806	1852	06127
06	Badajoz	128	Talavera la Real	5317	2683	2634	06128
06	Badajoz	129	Táliga	766	392	374	06129
06	Badajoz	130	Tamurejo	272	134	138	06130
06	Badajoz	131	Torre de Miguel Sesmero	1273	638	635	06131
06	Badajoz	132	Torremayor	1067	517	550	06132
06	Badajoz	133	Torremejía	2045	1038	1007	06133
06	Badajoz	134	Trasierra	712	379	333	06134
06	Badajoz	135	Trujillanos	1358	718	640	06135
06	Badajoz	136	Usagre	2089	1054	1035	06136
06	Badajoz	137	Valdecaballeros	1423	716	707	06137
06	Badajoz	138	Valdetorres	1382	703	679	06138
06	Badajoz	139	Valencia de las Torres	855	436	419	06139
06	Badajoz	140	Valencia del Mombuey	817	398	419	06140
06	Badajoz	141	Valencia del Ventoso	2355	1162	1193	06141
06	Badajoz	142	Valverde de Burguillos	375	189	186	06142
06	Badajoz	143	Valverde de Leganés	3767	1903	1864	06143
06	Badajoz	144	Valverde de Llerena	829	394	435	06144
06	Badajoz	145	Valverde de Mérida	1150	574	576	06145
06	Badajoz	146	Valle de la Serena	1588	779	809	06146
06	Badajoz	147	Valle de Matamoros	505	248	257	06147
06	Badajoz	148	Valle de Santa Ana	1221	619	602	06148
06	Badajoz	149	Villafranca de los Barros	12537	6226	6311	06149
06	Badajoz	150	Villagarcía de la Torre	1012	505	507	06150
06	Badajoz	151	Villagonzalo	1446	707	739	06151
06	Badajoz	152	Villalba de los Barros	1745	890	855	06152
06	Badajoz	153	Villanueva de la Serena	23875	11783	12092	06153
06	Badajoz	154	Villanueva del Fresno	3489	1744	1745	06154
06	Badajoz	155	Villar del Rey	2313	1186	1127	06155
06	Badajoz	156	Villar de Rena	1696	890	806	06156
06	Badajoz	157	Villarta de los Montes	680	339	341	06157
06	Badajoz	158	Zafra	15158	7290	7868	06158
06	Badajoz	159	Zahínos	3043	1537	1506	06159
06	Badajoz	160	Zalamea de la Serena	4647	2285	2362	06160
06	Badajoz	161	Zarza-Capilla	516	269	247	06161
06	Badajoz	162	Zarza (La)	3586	1801	1785	06162
06	Badajoz	901	Valdelacalzada	2582	1335	1247	06901
07	Balears (Illes)	001	Alaró	4032	1950	2082	07001
07	Balears (Illes)	002	Alaior	7390	3679	3711	07002
07	Balears (Illes)	003	Alcúdia	12152	6136	6016	07003
07	Balears (Illes)	004	Algaida	3753	1896	1857	07004
07	Balears (Illes)	005	Andratx	8655	4346	4309	07005
07	Balears (Illes)	006	Artà	6140	3071	3069	07006
07	Balears (Illes)	007	Banyalbufar	520	282	238	07007
07	Balears (Illes)	008	Binissalem	5193	2503	2690	07008
07	Balears (Illes)	009	Búger	932	472	460	07009
07	Balears (Illes)	010	Bunyola	4745	2340	2405	07010
07	Balears (Illes)	011	Calvià	37419	18777	18642	07011
07	Balears (Illes)	012	Campanet	2346	1161	1185	07012
07	Balears (Illes)	013	Campos	7074	3568	3506	07013
07	Balears (Illes)	014	Capdepera	8008	4029	3979	07014
07	Balears (Illes)	015	Ciutadella de Menorca	22925	11433	11492	07015
07	Balears (Illes)	016	Consell	2327	1157	1170	07016
07	Balears (Illes)	017	Costitx	903	442	461	07017
07	Balears (Illes)	018	Deyá	652	328	324	07018
07	Balears (Illes)	019	Escorca	318	168	150	07019
07	Balears (Illes)	020	Esporles	3993	1982	2011	07020
07	Balears (Illes)	021	Estellencs	357	181	176	07021
07	Balears (Illes)	022	Felanitx	15238	7625	7613	07022
07	Balears (Illes)	023	Ferreries	4061	2124	1937	07023
07	Balears (Illes)	024	Formentera	6289	3196	3093	07024
07	Balears (Illes)	025	Fornalutx	627	312	315	07025
07	Balears (Illes)	026	Eivissa	33223	16590	16633	07026
07	Balears (Illes)	027	Inca	22402	11107	11295	07027
07	Balears (Illes)	028	Lloret de Vista Alegre	933	457	476	07028
07	Balears (Illes)	029	Lloseta	4630	2308	2322	07029
07	Balears (Illes)	030	Llubí	1909	949	960	07030
07	Balears (Illes)	031	Llucmajor	23723	11866	11857	07031
07	Balears (Illes)	032	Mahón	23189	11314	11875	07032
07	Balears (Illes)	033	Manacor	30923	15386	15537	07033
07	Balears (Illes)	034	Mancor de la Vall	914	448	466	07034
07	Balears (Illes)	035	Maria de la Salut	1819	897	922	07035
07	Balears (Illes)	036	Marratxí	20924	10531	10393	07036
07	Balears (Illes)	037	Mercadal (Es)	3104	1571	1533	07037
07	Balears (Illes)	038	Montuïri	2317	1149	1168	07038
07	Balears (Illes)	039	Muro	6340	3175	3165	07039
07	Balears (Illes)	040	Palma de Mallorca	333925	162727	171198	07040
07	Balears (Illes)	041	Petra	2600	1278	1322	07041
07	Balears (Illes)	042	Pollença	14358	7158	7200	07042
07	Balears (Illes)	043	Porreres	4283	2168	2115	07043
07	Balears (Illes)	044	Pobla (Sa)	10347	5335	5012	07044
07	Balears (Illes)	045	Puigpunyent	1249	626	623	07045
07	Balears (Illes)	046	Sant Antoni de Portmany	15775	8028	7747	07046
07	Balears (Illes)	047	Sencelles	2125	1097	1028	07047
07	Balears (Illes)	048	San José	14428	7372	7056	07048
07	Balears (Illes)	049	Sant Joan	1686	833	853	07049
07	Balears (Illes)	050	Sant Joan de Labritja	4194	2119	2075	07050
07	Balears (Illes)	051	Sant Llorenç des Cardassar	6211	3121	3090	07051
07	Balears (Illes)	052	Sant Lluís	4395	2220	2175	07052
07	Balears (Illes)	053	Santa Eugènia	1228	610	618	07053
07	Balears (Illes)	054	Santa Eulalia del Río	21991	11274	10717	07054
07	Balears (Illes)	055	Santa Margalida	7943	3953	3990	07055
07	Balears (Illes)	056	Santa María del Camí	4740	2342	2398	07056
07	Balears (Illes)	057	Santanyí	8957	4527	4430	07057
07	Balears (Illes)	058	Selva	2983	1457	1526	07058
07	Balears (Illes)	059	Salines (Ses)	3528	1804	1724	07059
07	Balears (Illes)	060	Sineu	2724	1336	1388	07060
07	Balears (Illes)	061	Sóller	11521	5727	5794	07061
07	Balears (Illes)	062	Son Servera	9562	4832	4730	07062
07	Balears (Illes)	063	Valldemosa	1670	810	860	07063
07	Balears (Illes)	064	Castell (Es)	6504	3286	3218	07064
07	Balears (Illes)	065	Vilafranca de Bonany	2366	1162	1204	07065
07	Balears (Illes)	901	Ariany	790	397	393	07901
07	Balears (Illes)	902	Migjorn Gran (Es)	1148	590	558	07902
08	Barcelona	001	Abrera	8177	4203	3974	08001
08	Barcelona	002	Aguilar de Segarra	213	106	107	08002
08	Barcelona	003	Alella	8413	4180	4233	08003
08	Barcelona	004	Alpens	264	140	124	08004
08	Barcelona	005	Ametlla del Vallès (L')	5697	2823	2874	08005
08	Barcelona	006	Arenys de Mar	12610	6046	6564	08006
08	Barcelona	007	Arenys de Munt	6242	3097	3145	08007
08	Barcelona	008	Argençola	196	105	91	08008
08	Barcelona	009	Argentona	9482	4706	4776	08009
08	Barcelona	010	Artés	4368	2173	2195	08010
08	Barcelona	011	Avià	1845	930	915	08011
08	Barcelona	012	Avinyó	1999	977	1022	08012
08	Barcelona	013	Avinyonet del Penedès	1167	619	548	08013
08	Barcelona	014	Aiguafreda	2147	1054	1093	08014
08	Barcelona	015	Badalona	208944	103124	105820	08015
08	Barcelona	016	Bagà	2078	1004	1074	08016
08	Barcelona	017	Balenyà	3125	1560	1565	08017
08	Barcelona	018	Balsareny	3230	1590	1640	08018
08	Barcelona	019	Barcelona	1496266	699645	796621	08019
08	Barcelona	020	Begues	4189	2108	2081	08020
08	Barcelona	021	Bellprat	95	55	40	08021
08	Barcelona	022	Berga	14305	6929	7376	08022
08	Barcelona	023	Bigues i Riells	5436	2848	2588	08023
08	Barcelona	024	Borredà	485	243	242	08024
08	Barcelona	025	Bruc (El)	1029	544	485	08025
08	Barcelona	026	Brull (El)	197	109	88	08026
08	Barcelona	027	Cabanyes (Les)	544	290	254	08027
08	Barcelona	028	Cabrera d'Igualada	528	291	237	08028
08	Barcelona	029	Cabrera de Mar	3716	1899	1817	08029
08	Barcelona	030	Cabrils	4693	2293	2400	08030
08	Barcelona	031	Calaf	3016	1500	1516	08031
08	Barcelona	032	Caldes d'Estrac	1973	951	1022	08032
08	Barcelona	033	Caldes de Montbui	12464	6149	6315	08033
08	Barcelona	034	Calders	763	395	368	08034
08	Barcelona	035	Calella	13055	6319	6736	08035
08	Barcelona	036	Calonge de Segarra	196	101	95	08036
08	Barcelona	037	Calldetenes	2006	1036	970	08037
08	Barcelona	038	Callús	1329	661	668	08038
08	Barcelona	039	Campins	292	150	142	08039
08	Barcelona	040	Canet de Mar	10138	4946	5192	08040
08	Barcelona	041	Canovelles	13016	6566	6450	08041
08	Barcelona	042	Cànoves i Samalús	1870	968	902	08042
08	Barcelona	043	Canyelles	1838	983	855	08043
08	Barcelona	044	Capellades	4881	2390	2491	08044
08	Barcelona	045	Capolat	63	38	25	08045
08	Barcelona	046	Cardedeu	12078	6005	6073	08046
08	Barcelona	047	Cardona	5567	2707	2860	08047
08	Barcelona	048	Carme	686	350	336	08048
08	Barcelona	049	Casserres	1634	778	856	08049
08	Barcelona	050	Castellar del Riu	114	66	48	08050
08	Barcelona	051	Castellar del Vallès	17444	8714	8730	08051
08	Barcelona	052	Castellar de n'Hug	188	97	91	08052
08	Barcelona	053	Castellbell i el Vilar	2753	1379	1374	08053
08	Barcelona	054	Castellbisbal	7887	4073	3814	08054
08	Barcelona	055	Castellcir	366	204	162	08055
08	Barcelona	056	Castelldefels	45091	22538	22553	08056
08	Barcelona	057	Castell de l'Areny	48	30	18	08057
08	Barcelona	058	Castellet i la Gornal	1404	705	699	08058
08	Barcelona	059	Castellfollit del Boix	384	186	198	08059
08	Barcelona	060	Castellfollit de Riubregós	233	117	116	08060
08	Barcelona	061	Castellgalí	928	477	451	08061
08	Barcelona	062	Castellnou de Bages	526	276	250	08062
08	Barcelona	063	Castellolí	427	219	208	08063
08	Barcelona	064	Castellterçol	2000	983	1017	08064
08	Barcelona	065	Castellví de la Marca	1445	730	715	08065
08	Barcelona	066	Castellví de Rosanes	1096	563	533	08066
08	Barcelona	067	Centelles	5793	2851	2942	08067
08	Barcelona	068	Cervelló	6064	3033	3031	08068
08	Barcelona	069	Collbató	2099	1124	975	08069
08	Barcelona	070	Collsuspina	254	137	117	08070
08	Barcelona	071	Copons	271	128	143	08071
08	Barcelona	072	Corbera de Llobregat	9090	4636	4454	08072
08	Barcelona	073	Cornellà de Llobregat	80998	39716	41282	08073
08	Barcelona	074	Cubelles	6497	3321	3176	08074
08	Barcelona	075	Dosrius	2846	1453	1393	08075
08	Barcelona	076	Esparreguera	17060	8643	8417	08076
08	Barcelona	077	Esplugues de Llobregat	45668	22474	23194	08077
08	Barcelona	078	Espunyola (L')	276	138	138	08078
08	Barcelona	079	Estany (L')	398	189	209	08079
08	Barcelona	080	Fígols	50	29	21	08080
08	Barcelona	081	Fogars de Montclús	350	182	168	08081
08	Barcelona	082	Fogars de la Selva	692	359	333	08082
08	Barcelona	083	Folgueroles	1598	797	801	08083
08	Barcelona	084	Fonollosa	941	476	465	08084
08	Barcelona	085	Font-rubí	1200	622	578	08085
08	Barcelona	086	Franqueses del Vallès (Les)	12300	6139	6161	08086
08	Barcelona	087	Gallifa	156	82	74	08087
08	Barcelona	088	Garriga (La)	11547	5593	5954	08088
08	Barcelona	089	Gavà	39220	19524	19696	08089
08	Barcelona	090	Gaià	168	88	80	08090
08	Barcelona	091	Gelida	4354	2174	2180	08091
08	Barcelona	092	Gironella	4867	2349	2518	08092
08	Barcelona	093	Gisclareny	26	14	12	08093
08	Barcelona	094	Granada (La)	1329	645	684	08094
08	Barcelona	095	Granera	59	40	19	08095
08	Barcelona	096	Granollers	52423	25564	26859	08096
08	Barcelona	097	Gualba	783	409	374	08097
08	Barcelona	098	Sant Salvador de Guardiola	1994	1015	979	08098
08	Barcelona	099	Guardiola de Berguedà	1013	508	505	08099
08	Barcelona	100	Gurb	1898	967	931	08100
08	Barcelona	101	Hospitalet de Llobregat (L')	241782	118140	123642	08101
08	Barcelona	102	Igualada	32516	15815	16701	08102
08	Barcelona	103	Jorba	572	273	299	08103
08	Barcelona	104	Llacuna (La)	849	441	408	08104
08	Barcelona	105	Llagosta (La)	11933	5968	5965	08105
08	Barcelona	106	Llinars del Vallès	6877	3469	3408	08106
08	Barcelona	107	Lliçà d'Amunt	9595	4954	4641	08107
08	Barcelona	108	Lliçà de Vall	5070	2610	2460	08108
08	Barcelona	109	Lluçà	288	158	130	08109
08	Barcelona	110	Malgrat de Mar	13686	6827	6859	08110
08	Barcelona	111	Malla	255	115	140	08111
08	Barcelona	112	Manlleu	17520	8722	8798	08112
08	Barcelona	113	Manresa	63742	30608	33134	08113
08	Barcelona	114	Martorell	21314	10727	10587	08114
08	Barcelona	115	Martorelles	4895	2450	2445	08115
08	Barcelona	116	Masies de Roda (Les)	655	327	328	08116
08	Barcelona	117	Masies de Voltregà (Les)	2703	1309	1394	08117
08	Barcelona	118	Masnou (El)	21076	10207	10869	08118
08	Barcelona	119	Masquefa	4582	2331	2251	08119
08	Barcelona	120	Matadepera	6924	3474	3450	08120
08	Barcelona	121	Mataró	104659	51324	53335	08121
08	Barcelona	122	Mediona	1446	745	701	08122
08	Barcelona	123	Molins de Rei	19723	9664	10059	08123
08	Barcelona	124	Mollet del Vallès	46204	23079	23125	08124
08	Barcelona	125	Montcada i Reixac	27952	13793	14159	08125
08	Barcelona	126	Montgat	8305	4092	4213	08126
08	Barcelona	127	Monistrol de Montserrat	2490	1261	1229	08127
08	Barcelona	128	Monistrol de Calders	597	296	301	08128
08	Barcelona	129	Muntanyola	311	168	143	08129
08	Barcelona	130	Montclar	117	61	56	08130
08	Barcelona	131	Montesquiu	844	412	432	08131
08	Barcelona	132	Montmajor	473	244	229	08132
08	Barcelona	133	Montmaneu	194	102	92	08133
08	Barcelona	134	Figaró-Montmany	825	436	389	08134
08	Barcelona	135	Montmeló	8437	4207	4230	08135
08	Barcelona	136	Montornès del Vallès	12426	6254	6172	08136
08	Barcelona	137	Montseny	301	155	146	08137
08	Barcelona	138	Moià	3988	1961	2027	08138
08	Barcelona	139	Mura	217	118	99	08139
08	Barcelona	140	Navarcles	5318	2641	2677	08140
08	Barcelona	141	Navàs	5722	2830	2892	08141
08	Barcelona	142	Nou de Berguedà (La)	153	83	70	08142
08	Barcelona	143	Òdena	2681	1337	1344	08143
08	Barcelona	144	Olvan	899	433	466	08144
08	Barcelona	145	Olèrdola	2232	1141	1091	08145
08	Barcelona	146	Olesa de Bonesvalls	942	512	430	08146
08	Barcelona	147	Olesa de Montserrat	17151	8640	8511	08147
08	Barcelona	148	Olivella	1319	702	617	08148
08	Barcelona	149	Olost	1160	568	592	08149
08	Barcelona	150	Orís	226	114	112	08150
08	Barcelona	151	Oristà	645	314	331	08151
08	Barcelona	152	Orpí	147	78	69	08152
08	Barcelona	153	Òrrius	420	220	200	08153
08	Barcelona	154	Pacs del Penedès	653	325	328	08154
08	Barcelona	155	Palafolls	5235	2627	2608	08155
08	Barcelona	156	Palau de Plegamans	11089	5653	5436	08156
08	Barcelona	157	Pallejà	7258	3661	3597	08157
08	Barcelona	158	Papiol (El)	3464	1721	1743	08158
08	Barcelona	159	Parets del Vallès	14478	7335	7143	08159
08	Barcelona	160	Perafita	368	181	187	08160
08	Barcelona	161	Piera	8540	4361	4179	08161
08	Barcelona	162	Hostalets de Pierola (Els)	1239	642	597	08162
08	Barcelona	163	Pineda de Mar	20057	10014	10043	08163
08	Barcelona	164	Pla del Penedès (El)	923	461	462	08164
08	Barcelona	165	Pobla de Claramunt (La)	1656	846	810	08165
08	Barcelona	166	Pobla de Lillet (La)	1455	715	740	08166
08	Barcelona	167	Polinyà	4657	2396	2261	08167
08	Barcelona	168	Pontons	363	193	170	08168
08	Barcelona	169	Prat de Llobregat (El)	62956	31518	31438	08169
08	Barcelona	170	Prats de Rei (Els)	537	267	270	08170
08	Barcelona	171	Prats de Lluçanès	2750	1342	1408	08171
08	Barcelona	172	Premià de Mar	26130	13005	13125	08172
08	Barcelona	174	Puigdàlber	333	150	183	08174
08	Barcelona	175	Puig-reig	4319	2087	2232	08175
08	Barcelona	176	Pujalt	178	92	86	08176
08	Barcelona	177	Quar (La)	79	41	38	08177
08	Barcelona	178	Rajadell	456	234	222	08178
08	Barcelona	179	Rellinars	378	194	184	08179
08	Barcelona	180	Ripollet	29877	14935	14942	08180
08	Barcelona	181	Roca del Vallès (La)	7380	3714	3666	08181
08	Barcelona	182	Pont de Vilomara i Rocafort (El)	2614	1345	1269	08182
08	Barcelona	183	Roda de Ter	5148	2483	2665	08183
08	Barcelona	184	Rubí	58646	29391	29255	08184
08	Barcelona	185	Rubió	120	68	52	08185
08	Barcelona	187	Sabadell	183727	89079	94648	08187
08	Barcelona	188	Sagàs	155	80	75	08188
08	Barcelona	189	Sant Pere Sallavinera	155	78	77	08189
08	Barcelona	190	Saldes	328	183	145	08190
08	Barcelona	191	Sallent	7159	3449	3710	08191
08	Barcelona	192	Santpedor	5352	2611	2741	08192
08	Barcelona	193	Sant Iscle de Vallalta	839	435	404	08193
08	Barcelona	194	Sant Adrià de Besòs	32452	15946	16506	08194
08	Barcelona	195	Sant Agustí de Lluçanès	121	65	56	08195
08	Barcelona	196	Sant Andreu de la Barca	20140	10277	9863	08196
08	Barcelona	197	Sant Andreu de Llavaneres	7161	3579	3582	08197
08	Barcelona	198	Sant Antoni de Vilamajor	3293	1655	1638	08198
08	Barcelona	199	Sant Bartomeu del Grau	1150	603	547	08199
08	Barcelona	200	Sant Boi de Llobregat	79337	39419	39918	08200
08	Barcelona	201	Sant Boi de Lluçanès	540	273	267	08201
08	Barcelona	202	Sant Celoni	12734	6302	6432	08202
08	Barcelona	203	Sant Cebrià de Vallalta	1757	945	812	08203
08	Barcelona	204	Sant Climent de Llobregat	2950	1473	1477	08204
08	Barcelona	205	Sant Cugat del Vallès	52654	25939	26715	08205
08	Barcelona	206	Sant Cugat Sesgarrigues	731	375	356	08206
08	Barcelona	207	Sant Esteve de Palautordera	1461	737	724	08207
08	Barcelona	208	Sant Esteve Sesrovires	5161	2702	2459	08208
08	Barcelona	209	Sant Fost de Campsentelles	6312	3206	3106	08209
08	Barcelona	210	Sant Feliu de Codines	4290	2135	2155	08210
08	Barcelona	211	Sant Feliu de Llobregat	38435	18972	19463	08211
08	Barcelona	212	Sant Feliu Sasserra	657	321	336	08212
08	Barcelona	213	Sant Fruitós de Bages	5542	2772	2770	08213
08	Barcelona	214	Vilassar de Dalt	7484	3717	3767	08214
08	Barcelona	215	Sant Hipòlit de Voltregà	3005	1485	1520	08215
08	Barcelona	216	Sant Jaume de Frontanyà	28	15	13	08216
08	Barcelona	217	Sant Joan Despí	27627	13638	13989	08217
08	Barcelona	218	Sant Joan de Vilatorrada	9145	4570	4575	08218
08	Barcelona	219	Vilassar de Mar	17000	8327	8673	08219
08	Barcelona	220	Sant Julià de Vilatorta	2269	1106	1163	08220
08	Barcelona	221	Sant Just Desvern	14030	6763	7267	08221
08	Barcelona	222	Sant Llorenç d'Hortons	1547	775	772	08222
08	Barcelona	223	Sant Llorenç Savall	1983	988	995	08223
08	Barcelona	224	Sant Martí de Centelles	729	378	351	08224
08	Barcelona	225	Sant Martí d'Albars	132	64	68	08225
08	Barcelona	226	Sant Martí de Tous	982	494	488	08226
08	Barcelona	227	Sant Martí Sarroca	2478	1229	1249	08227
08	Barcelona	228	Sant Martí Sesgueioles	342	170	172	08228
08	Barcelona	229	Sant Mateu de Bages	491	252	239	08229
08	Barcelona	230	Premià de Dalt	8869	4443	4426	08230
08	Barcelona	231	Sant Pere de Ribes	21976	11111	10865	08231
08	Barcelona	232	Sant Pere de Riudebitlles	2076	1023	1053	08232
08	Barcelona	233	Sant Pere de Torelló	2160	1054	1106	08233
08	Barcelona	234	Sant Pere de Vilamajor	2547	1329	1218	08234
08	Barcelona	235	Sant Pol de Mar	3594	1863	1731	08235
08	Barcelona	236	Sant Quintí de Mediona	1679	826	853	08236
08	Barcelona	237	Sant Quirze de Besora	1978	970	1008	08237
08	Barcelona	238	Sant Quirze del Vallès	12706	6358	6348	08238
08	Barcelona	239	Sant Quirze Safaja	369	197	172	08239
08	Barcelona	240	Sant Sadurní d'Anoia	9539	4734	4805	08240
08	Barcelona	241	Sant Sadurní d'Osormort	76	41	35	08241
08	Barcelona	242	Marganell	243	108	135	08242
08	Barcelona	243	Santa Cecília de Voltregà	202	112	90	08243
08	Barcelona	244	Santa Coloma de Cervelló	4691	2351	2340	08244
08	Barcelona	245	Santa Coloma de Gramenet	117127	58139	58988	08245
08	Barcelona	246	Santa Eugènia de Berga	1946	987	959	08246
08	Barcelona	247	Santa Eulàlia de Riuprimer	864	449	415	08247
08	Barcelona	248	Santa Eulàlia de Ronçana	4536	2291	2245	08248
08	Barcelona	249	Santa Fe del Penedès	293	145	148	08249
08	Barcelona	250	Santa Margarida de Montbui	9123	4541	4582	08250
08	Barcelona	251	Santa Margarida i els Monjos	4661	2370	2291	08251
08	Barcelona	252	Barberà del Vallès	26681	13393	13288	08252
08	Barcelona	253	Santa Maria de Besora	183	93	90	08253
08	Barcelona	254	Santa Maria de Corcó	2088	1042	1046	08254
08	Barcelona	255	Santa Maria de Merlès	168	88	80	08255
08	Barcelona	256	Santa Maria de Martorelles	700	340	360	08256
08	Barcelona	257	Santa Maria de Miralles	88	44	44	08257
08	Barcelona	258	Santa Maria d'Oló	1006	519	487	08258
08	Barcelona	259	Santa Maria de Palautordera	6306	3193	3113	08259
08	Barcelona	260	Santa Perpètua de Mogoda	19084	9630	9454	08260
08	Barcelona	261	Santa Susanna	1908	987	921	08261
08	Barcelona	262	Sant Vicenç de Castellet	7212	3457	3755	08262
08	Barcelona	263	Sant Vicenç dels Horts	24438	12273	12165	08263
08	Barcelona	264	Sant Vicenç de Montalt	3334	1701	1633	08264
08	Barcelona	265	Sant Vicenç de Torelló	1786	863	923	08265
08	Barcelona	266	Cerdanyola del Vallès	52778	26403	26375	08266
08	Barcelona	267	Sentmenat	5675	2823	2852	08267
08	Barcelona	268	Cercs	1454	727	727	08268
08	Barcelona	269	Seva	2510	1284	1226	08269
08	Barcelona	270	Sitges	19448	5458	13990	08270
08	Barcelona	271	Sobremunt	87	41	46	08271
08	Barcelona	272	Sora	189	103	86	08272
08	Barcelona	273	Subirats	2529	1273	1256	08273
08	Barcelona	274	Súria	6157	3026	3131	08274
08	Barcelona	275	Tavèrnoles	272	132	140	08275
08	Barcelona	276	Tagamanent	195	107	88	08276
08	Barcelona	277	Talamanca	107	61	46	08277
08	Barcelona	278	Taradell	5000	2484	2516	08278
08	Barcelona	279	Terrassa	171794	83957	87837	08279
08	Barcelona	280	Tavertet	140	75	65	08280
08	Barcelona	281	Teià	5280	2657	2623	08281
08	Barcelona	282	Tiana	5663	2804	2859	08282
08	Barcelona	283	Tona	5868	2914	2954	08283
08	Barcelona	284	Tordera	9798	4961	4837	08284
08	Barcelona	285	Torelló	12150	5913	6237	08285
08	Barcelona	286	Torre de Claramunt (La)	2371	1228	1143	08286
08	Barcelona	287	Torrelavit	1172	597	575	08287
08	Barcelona	288	Torrelles de Foix	1684	896	788	08288
08	Barcelona	289	Torrelles de Llobregat	3574	1820	1754	08289
08	Barcelona	290	Ullastrell	1114	571	543	08290
08	Barcelona	291	Vacarisses	2687	1419	1268	08291
08	Barcelona	292	Vallbona d'Anoia	1089	558	531	08292
08	Barcelona	293	Vallcebre	269	142	127	08293
08	Barcelona	294	Vallgorguina	1325	698	627	08294
08	Barcelona	295	Vallirana	9004	4564	4440	08295
08	Barcelona	296	Vallromanes	1374	711	663	08296
08	Barcelona	297	Veciana	154	83	71	08297
08	Barcelona	298	Vic	31533	15191	16342	08298
08	Barcelona	299	Vilada	522	266	256	08299
08	Barcelona	300	Viladecavalls	5755	2904	2851	08300
08	Barcelona	301	Viladecans	56112	28262	27850	08301
08	Barcelona	302	Vilanova del Camí	10203	5127	5076	08302
08	Barcelona	303	Vilanova de Sau	320	150	170	08303
08	Barcelona	304	Vilobí del Penedès	874	450	424	08304
08	Barcelona	305	Vilafranca del Penedès	30024	14744	15280	08305
08	Barcelona	306	Vilalba Sasserra	454	245	209	08306
08	Barcelona	307	Vilanova i la Geltrú	52389	25734	26655	08307
08	Barcelona	308	Viver i Serrateix	188	96	92	08308
08	Barcelona	901	Rupit i Pruit	354	178	176	08901
08	Barcelona	902	Vilanova del Vallès	2314	1174	1140	08902
08	Barcelona	903	Sant Julià de Cerdanyola	227	122	105	08903
08	Barcelona	904	Badia del Vallès	15533	7825	7708	08904
08	Barcelona	905	Palma de Cervelló (La)	2607	1319	1288	08905
09	Burgos	001	Abajas	48	26	22	09001
09	Burgos	003	Adrada de Haza	286	157	129	09003
09	Burgos	006	Aguas Cándidas	93	55	38	09006
09	Burgos	007	Aguilar de Bureba	86	44	42	09007
09	Burgos	009	Albillos	158	88	70	09009
09	Burgos	010	Alcocero de Mola	54	33	21	09010
09	Burgos	011	Alfoz de Bricia	149	76	73	09011
09	Burgos	012	Alfoz de Santa Gadea	179	85	94	09012
09	Burgos	013	Altable	58	36	22	09013
09	Burgos	014	Altos (Los)	230	136	94	09014
09	Burgos	016	Ameyugo	77	40	37	09016
09	Burgos	017	Anguix	150	74	76	09017
09	Burgos	018	Aranda de Duero	29762	14842	14920	09018
09	Burgos	019	Arandilla	206	123	83	09019
09	Burgos	020	Arauzo de Miel	395	216	179	09020
09	Burgos	021	Arauzo de Salce	75	41	34	09021
09	Burgos	022	Arauzo de Torre	109	62	47	09022
09	Burgos	023	Arcos	276	149	127	09023
09	Burgos	024	Arenillas de Riopisuerga	238	127	111	09024
09	Burgos	025	Arija	221	110	111	09025
09	Burgos	026	Arlanzón	404	219	185	09026
09	Burgos	027	Arraya de Oca	54	27	27	09027
09	Burgos	029	Atapuerca	202	104	98	09029
09	Burgos	030	Ausines (Los)	144	79	65	09030
09	Burgos	032	Avellanosa de Muñó	162	85	77	09032
09	Burgos	033	Bahabón de Esgueva	139	81	58	09033
09	Burgos	034	Balbases (Los)	368	191	177	09034
09	Burgos	035	Baños de Valdearados	464	254	210	09035
09	Burgos	036	Bañuelos de Bureba	45	28	17	09036
09	Burgos	037	Barbadillo de Herreros	151	85	66	09037
09	Burgos	038	Barbadillo del Mercado	167	94	73	09038
09	Burgos	039	Barbadillo del Pez	107	58	49	09039
09	Burgos	041	Barrio de Muñó	36	21	15	09041
09	Burgos	043	Barrios de Bureba (Los)	266	144	122	09043
09	Burgos	044	Barrios de Colina	76	42	34	09044
09	Burgos	045	Basconcillos del Tozo	373	204	169	09045
09	Burgos	046	Bascuñana	66	36	30	09046
09	Burgos	047	Belbimbre	75	41	34	09047
09	Burgos	048	Belorado	2093	1057	1036	09048
09	Burgos	050	Berberana	89	43	46	09050
09	Burgos	051	Berlangas de Roa	264	137	127	09051
09	Burgos	052	Berzosa de Bureba	53	32	21	09052
09	Burgos	054	Bozoó	115	61	54	09054
09	Burgos	055	Brazacorta	100	56	44	09055
09	Burgos	056	Briviesca	6235	3102	3133	09056
09	Burgos	057	Bugedo	100	73	27	09057
09	Burgos	058	Buniel	188	107	81	09058
09	Burgos	059	Burgos	163358	78740	84618	09059
09	Burgos	060	Busto de Bureba	229	122	107	09060
09	Burgos	061	Cabañes de Esgueva	268	143	125	09061
09	Burgos	062	Cabezón de la Sierra	73	32	41	09062
09	Burgos	063	Cabia	244	136	108	09063
09	Burgos	064	Caleruega	401	213	188	09064
09	Burgos	065	Campillo de Aranda	188	102	86	09065
09	Burgos	066	Campolara	97	53	44	09066
09	Burgos	067	Canicosa de la Sierra	645	338	307	09067
09	Burgos	068	Cantabrana	52	28	24	09068
09	Burgos	070	Carazo	48	28	20	09070
09	Burgos	071	Carcedo de Bureba	49	27	22	09071
09	Burgos	072	Carcedo de Burgos	152	90	62	09072
09	Burgos	073	Cardeñadijo	531	277	254	09073
09	Burgos	074	Cardeñajimeno	444	239	205	09074
09	Burgos	075	Cardeñuela Riopico	89	47	42	09075
09	Burgos	076	Carrias	50	34	16	09076
09	Burgos	077	Cascajares de Bureba	62	35	27	09077
09	Burgos	078	Cascajares de la Sierra	28	11	17	09078
09	Burgos	079	Castellanos de Castro	68	38	30	09079
09	Burgos	082	Castildelgado	82	40	42	09082
09	Burgos	083	Castil de Peones	33	16	17	09083
09	Burgos	084	Castrillo de la Reina	285	173	112	09084
09	Burgos	085	Castrillo de la Vega	592	313	279	09085
09	Burgos	086	Castrillo del Val	411	235	176	09086
09	Burgos	088	Castrillo de Riopisuerga	88	46	42	09088
09	Burgos	090	Castrillo Matajudíos	78	37	41	09090
09	Burgos	091	Castrojeriz	996	507	489	09091
09	Burgos	093	Cayuela	118	69	49	09093
09	Burgos	094	Cebrecos	80	46	34	09094
09	Burgos	095	Celada del Camino	99	45	54	09095
09	Burgos	098	Cerezo de Río Tirón	771	411	360	09098
09	Burgos	100	Cerratón de Juarros	81	45	36	09100
09	Burgos	101	Ciadoncha	124	71	53	09101
09	Burgos	102	Cillaperlata	64	34	30	09102
09	Burgos	103	Cilleruelo de Abajo	325	181	144	09103
09	Burgos	104	Cilleruelo de Arriba	82	45	37	09104
09	Burgos	105	Ciruelos de Cervera	166	90	76	09105
09	Burgos	108	Cogollos	242	131	111	09108
09	Burgos	109	Condado de Treviño	929	520	409	09109
09	Burgos	110	Contreras	119	75	44	09110
09	Burgos	112	Coruña del Conde	173	98	75	09112
09	Burgos	113	Covarrubias	629	333	296	09113
09	Burgos	114	Cubillo del Campo	72	38	34	09114
09	Burgos	115	Cubo de Bureba	113	56	57	09115
09	Burgos	117	Cueva de Roa (La)	120	64	56	09117
09	Burgos	119	Cuevas de San Clemente	58	27	31	09119
09	Burgos	120	Encío	67	35	32	09120
09	Burgos	122	Espinosa de Cervera	110	66	44	09122
09	Burgos	123	Espinosa del Camino	45	24	21	09123
09	Burgos	124	Espinosa de los Monteros	2173	1110	1063	09124
09	Burgos	125	Estépar	857	467	390	09125
09	Burgos	127	Fontioso	82	45	37	09127
09	Burgos	128	Frandovínez	91	48	43	09128
09	Burgos	129	Fresneda de la Sierra Tirón	100	55	45	09129
09	Burgos	130	Fresneña	117	61	56	09130
09	Burgos	131	Fresnillo de las Dueñas	313	161	152	09131
09	Burgos	132	Fresno de Río Tirón	266	151	115	09132
09	Burgos	133	Fresno de Rodilla	52	29	23	09133
09	Burgos	134	Frías	276	144	132	09134
09	Burgos	135	Fuentebureba	82	41	41	09135
09	Burgos	136	Fuentecén	276	155	121	09136
09	Burgos	137	Fuentelcésped	191	92	99	09137
09	Burgos	138	Fuentelisendo	125	65	60	09138
09	Burgos	139	Fuentemolinos	123	71	52	09139
09	Burgos	140	Fuentenebro	199	106	93	09140
09	Burgos	141	Fuentespina	577	311	266	09141
09	Burgos	143	Galbarros	34	23	11	09143
09	Burgos	144	Gallega (La)	90	49	41	09144
09	Burgos	148	Grijalba	133	65	68	09148
09	Burgos	149	Grisaleña	47	30	17	09149
09	Burgos	151	Gumiel de Izán	610	326	284	09151
09	Burgos	152	Gumiel de Mercado	370	203	167	09152
09	Burgos	154	Hacinas	209	115	94	09154
09	Burgos	155	Haza	41	21	20	09155
09	Burgos	159	Hontanas	69	39	30	09159
09	Burgos	160	Hontangas	152	88	64	09160
09	Burgos	162	Hontoria de la Cantera	127	62	65	09162
09	Burgos	163	Hontoria del Pinar	890	479	411	09163
09	Burgos	164	Hontoria de Valdearados	221	139	82	09164
09	Burgos	166	Hormazas (Las)	147	81	66	09166
09	Burgos	167	Hornillos del Camino	74	40	34	09167
09	Burgos	168	Horra (La)	452	237	215	09168
09	Burgos	169	Hortigüela	132	84	48	09169
09	Burgos	170	Hoyales de Roa	299	145	154	09170
09	Burgos	172	Huérmeces	157	86	71	09172
09	Burgos	173	Huerta de Arriba	194	101	93	09173
09	Burgos	174	Huerta de Rey	1173	607	566	09174
09	Burgos	175	Humada	233	138	95	09175
09	Burgos	176	Hurones	58	37	21	09176
09	Burgos	177	Ibeas de Juarros	998	549	449	09177
09	Burgos	178	Ibrillos	99	58	41	09178
09	Burgos	179	Iglesiarrubia	63	34	29	09179
09	Burgos	180	Iglesias	187	105	82	09180
09	Burgos	181	Isar	423	196	227	09181
09	Burgos	182	Itero del Castillo	124	66	58	09182
09	Burgos	183	Jaramillo de la Fuente	36	21	15	09183
09	Burgos	184	Jaramillo Quemado	15	10	5	09184
09	Burgos	189	Junta de Traslaloma	190	102	88	09189
09	Burgos	190	Junta de Villalba de Losa	97	47	50	09190
09	Burgos	191	Jurisdicción de Lara	66	37	29	09191
09	Burgos	192	Jurisdicción de San Zadornil	91	40	51	09192
09	Burgos	194	Lerma	2518	1254	1264	09194
09	Burgos	195	Llano de Bureba	57	35	22	09195
09	Burgos	196	Madrigal del Monte	211	114	97	09196
09	Burgos	197	Madrigalejo del Monte	160	90	70	09197
09	Burgos	198	Mahamud	168	83	85	09198
09	Burgos	199	Mambrilla de Castrejón	152	79	73	09199
09	Burgos	200	Mambrillas de Lara	78	39	39	09200
09	Burgos	201	Mamolar	72	37	35	09201
09	Burgos	202	Manciles	47	25	22	09202
09	Burgos	206	Mazuela	88	46	42	09206
09	Burgos	208	Mecerreyes	325	168	157	09208
09	Burgos	209	Medina de Pomar	5166	2618	2548	09209
09	Burgos	211	Melgar de Fernamental	2021	1036	985	09211
09	Burgos	213	Merindad de Cuesta-Urria	516	289	227	09213
09	Burgos	214	Merindad de Montija	949	507	442	09214
09	Burgos	215	Merindad de Sotoscueva	593	326	267	09215
09	Burgos	216	Merindad de Valdeporres	565	291	274	09216
09	Burgos	217	Merindad de Valdivielso	546	286	260	09217
09	Burgos	218	Milagros	456	245	211	09218
09	Burgos	219	Miranda de Ebro	35631	17587	18044	09219
09	Burgos	220	Miraveche	119	70	49	09220
09	Burgos	221	Modúbar de la Emparedada	256	139	117	09221
09	Burgos	223	Monasterio de la Sierra	40	23	17	09223
09	Burgos	224	Monasterio de Rodilla	219	118	101	09224
09	Burgos	225	Moncalvillo	126	74	52	09225
09	Burgos	226	Monterrubio de la Demanda	87	50	37	09226
09	Burgos	227	Montorio	166	86	80	09227
09	Burgos	228	Moradillo de Roa	231	124	107	09228
09	Burgos	229	Nava de Roa	270	142	128	09229
09	Burgos	230	Navas de Bureba	51	26	25	09230
09	Burgos	231	Nebreda	107	68	39	09231
09	Burgos	232	Neila	233	117	116	09232
09	Burgos	235	Olmedillo de Roa	206	109	97	09235
09	Burgos	236	Olmillos de Muñó	46	24	22	09236
09	Burgos	238	Oña	1620	822	798	09238
09	Burgos	239	Oquillas	77	43	34	09239
09	Burgos	241	Orbaneja Riopico	160	93	67	09241
09	Burgos	242	Padilla de Abajo	107	64	43	09242
09	Burgos	243	Padilla de Arriba	132	70	62	09243
09	Burgos	244	Padrones de Bureba	73	40	33	09244
09	Burgos	246	Palacios de la Sierra	880	452	428	09246
09	Burgos	247	Palacios de Riopisuerga	33	17	16	09247
09	Burgos	248	Palazuelos de la Sierra	70	39	31	09248
09	Burgos	249	Palazuelos de Muñó	66	39	27	09249
09	Burgos	250	Pampliega	412	209	203	09250
09	Burgos	251	Pancorbo	491	258	233	09251
09	Burgos	253	Pardilla	121	64	57	09253
09	Burgos	255	Partido de la Sierra en Tobalina	77	48	29	09255
09	Burgos	256	Pedrosa de Duero	558	289	269	09256
09	Burgos	257	Pedrosa del Páramo	119	67	52	09257
09	Burgos	258	Pedrosa del Príncipe	245	128	117	09258
09	Burgos	259	Pedrosa de Río Úrbel	282	158	124	09259
09	Burgos	261	Peñaranda de Duero	601	323	278	09261
09	Burgos	262	Peral de Arlanza	243	128	115	09262
09	Burgos	265	Piérnigas	41	30	11	09265
09	Burgos	266	Pineda de la Sierra	126	70	56	09266
09	Burgos	267	Pineda Trasmonte	190	101	89	09267
09	Burgos	268	Pinilla de los Barruecos	141	75	66	09268
09	Burgos	269	Pinilla de los Moros	51	33	18	09269
09	Burgos	270	Pinilla Trasmonte	224	124	100	09270
09	Burgos	272	Poza de la Sal	384	193	191	09272
09	Burgos	273	Prádanos de Bureba	57	33	24	09273
09	Burgos	274	Pradoluengo	1713	839	874	09274
09	Burgos	275	Presencio	273	147	126	09275
09	Burgos	276	Puebla de Arganzón (La)	383	213	170	09276
09	Burgos	277	Puentedura	137	78	59	09277
09	Burgos	279	Quemada	245	139	106	09279
09	Burgos	280	Quintanabureba	46	24	22	09280
09	Burgos	281	Quintana del Pidio	200	106	94	09281
09	Burgos	283	Quintanaélez	98	46	52	09283
09	Burgos	287	Quintanaortuño	144	75	69	09287
09	Burgos	288	Quintanapalla	115	62	53	09288
09	Burgos	289	Quintanar de la Sierra	2078	1066	1012	09289
09	Burgos	292	Quintanavides	85	41	44	09292
09	Burgos	294	Quintanilla de la Mata	169	90	79	09294
09	Burgos	295	Quintanilla del Coco	120	61	59	09295
09	Burgos	297	Quintanillas (Las)	345	184	161	09297
09	Burgos	298	Quintanilla San García	104	50	54	09298
09	Burgos	301	Quintanilla Vivar	470	230	240	09301
09	Burgos	302	Rabanera del Pinar	141	75	66	09302
09	Burgos	303	Rábanos	89	55	34	09303
09	Burgos	304	Rabé de las Calzadas	172	92	80	09304
09	Burgos	306	Rebolledo de la Torre	180	100	80	09306
09	Burgos	307	Redecilla del Camino	150	87	63	09307
09	Burgos	308	Redecilla del Campo	88	46	42	09308
09	Burgos	309	Regumiel de la Sierra	480	240	240	09309
09	Burgos	310	Reinoso	24	16	8	09310
09	Burgos	311	Retuerta	72	41	31	09311
09	Burgos	312	Revilla y Ahedo (La)	121	66	55	09312
09	Burgos	314	Revilla del Campo	129	68	61	09314
09	Burgos	315	Revillarruz	152	79	73	09315
09	Burgos	316	Revilla Vallejera	130	73	57	09316
09	Burgos	317	Rezmondo	24	12	12	09317
09	Burgos	318	Riocavado de la Sierra	71	40	31	09318
09	Burgos	321	Roa	2249	1145	1104	09321
09	Burgos	323	Rojas	93	56	37	09323
09	Burgos	325	Royuela de Río Franco	338	189	149	09325
09	Burgos	326	Rubena	168	88	80	09326
09	Burgos	327	Rublacedo de Abajo	38	20	18	09327
09	Burgos	328	Rucandio	120	59	61	09328
09	Burgos	329	Salas de Bureba	151	81	70	09329
09	Burgos	330	Salas de los Infantes	2030	1026	1004	09330
09	Burgos	332	Saldaña de Burgos	127	69	58	09332
09	Burgos	334	Salinillas de Bureba	63	36	27	09334
09	Burgos	335	San Adrián de Juarros	54	31	23	09335
09	Burgos	337	San Juan del Monte	168	88	80	09337
09	Burgos	338	San Mamés de Burgos	207	119	88	09338
09	Burgos	339	San Martín de Rubiales	262	134	128	09339
09	Burgos	340	San Millán de Lara	77	50	27	09340
09	Burgos	343	Santa Cecilia	135	74	61	09343
09	Burgos	345	Santa Cruz de la Salceda	192	110	82	09345
09	Burgos	346	Santa Cruz del Valle Urbión	127	74	53	09346
09	Burgos	347	Santa Gadea del Cid	185	99	86	09347
09	Burgos	348	Santa Inés	203	111	92	09348
09	Burgos	350	Santa María del Campo	727	375	352	09350
09	Burgos	351	Santa María del Invierno	61	39	22	09351
09	Burgos	352	Santa María del Mercadillo	189	108	81	09352
09	Burgos	353	Santa María Rivarredonda	131	71	60	09353
09	Burgos	354	Santa Olalla de Bureba	37	15	22	09354
09	Burgos	355	Santibáñez de Esgueva	159	76	83	09355
09	Burgos	356	Santibáñez del Val	63	40	23	09356
09	Burgos	358	Santo Domingo de Silos	316	199	117	09358
09	Burgos	360	San Vicente del Valle	37	24	13	09360
09	Burgos	361	Sargentes de la Lora	171	92	79	09361
09	Burgos	362	Sarracín	213	116	97	09362
09	Burgos	363	Sasamón	1511	813	698	09363
09	Burgos	365	Sequera de Haza (La)	63	36	27	09365
09	Burgos	366	Solarana	111	64	47	09366
09	Burgos	368	Sordillos	39	23	16	09368
09	Burgos	369	Sotillo de la Ribera	611	340	271	09369
09	Burgos	372	Sotragero	173	90	83	09372
09	Burgos	373	Sotresgudo	730	396	334	09373
09	Burgos	374	Susinos del Páramo	110	52	58	09374
09	Burgos	375	Tamarón	53	32	21	09375
09	Burgos	377	Tardajos	642	344	298	09377
09	Burgos	378	Tejada	55	32	23	09378
09	Burgos	380	Terradillos de Esgueva	129	65	64	09380
09	Burgos	381	Tinieblas de la Sierra	53	24	29	09381
09	Burgos	382	Tobar	52	30	22	09382
09	Burgos	384	Tordómar	402	227	175	09384
09	Burgos	386	Torrecilla del Monte	76	41	35	09386
09	Burgos	387	Torregalindo	143	81	62	09387
09	Burgos	388	Torrelara	26	13	13	09388
09	Burgos	389	Torrepadre	123	67	56	09389
09	Burgos	390	Torresandino	838	451	387	09390
09	Burgos	391	Tórtoles de Esgueva	524	297	227	09391
09	Burgos	392	Tosantos	62	32	30	09392
09	Burgos	394	Trespaderne	1057	550	507	09394
09	Burgos	395	Tubilla del Agua	209	129	80	09395
09	Burgos	396	Tubilla del Lago	194	105	89	09396
09	Burgos	398	Úrbel del Castillo	93	54	39	09398
09	Burgos	400	Vadocondes	437	228	209	09400
09	Burgos	403	Valdeande	146	86	60	09403
09	Burgos	405	Valdezate	194	102	92	09405
09	Burgos	406	Valdorros	119	64	55	09406
09	Burgos	407	Valmala	32	15	17	09407
09	Burgos	408	Vallarta de Bureba	70	40	30	09408
09	Burgos	409	Valle de Manzanedo	133	71	62	09409
09	Burgos	410	Valle de Mena	3376	1720	1656	09410
09	Burgos	411	Valle de Oca	216	107	109	09411
09	Burgos	412	Valle de Tobalina	1096	567	529	09412
09	Burgos	413	Valle de Valdebezana	760	409	351	09413
09	Burgos	414	Valle de Valdelaguna	238	132	106	09414
09	Burgos	415	Valle de Valdelucio	375	206	169	09415
09	Burgos	416	Valle de Zamanzas	79	49	30	09416
09	Burgos	417	Vallejera	64	37	27	09417
09	Burgos	418	Valles de Palenzuela	107	55	52	09418
09	Burgos	419	Valluércanes	120	65	55	09419
09	Burgos	421	Vid y Barrios (La)	334	188	146	09421
09	Burgos	422	Vid de Bureba (La)	44	22	22	09422
09	Burgos	423	Vileña	37	24	13	09423
09	Burgos	424	Viloria de Rioja	71	40	31	09424
09	Burgos	425	Vilviestre del Pinar	772	398	374	09425
09	Burgos	427	Villadiego	1988	1081	907	09427
09	Burgos	428	Villaescusa de Roa	176	102	74	09428
09	Burgos	429	Villaescusa la Sombría	57	34	23	09429
09	Burgos	430	Villaespasa	30	17	13	09430
09	Burgos	431	Villafranca Montes de Oca	206	106	100	09431
09	Burgos	432	Villafruela	291	163	128	09432
09	Burgos	433	Villagalijo	70	45	25	09433
09	Burgos	434	Villagonzalo Pedernales	777	387	390	09434
09	Burgos	437	Villahoz	401	203	198	09437
09	Burgos	438	Villalba de Duero	595	314	281	09438
09	Burgos	439	Villalbilla de Burgos	692	372	320	09439
09	Burgos	440	Villalbilla de Gumiel	132	76	56	09440
09	Burgos	441	Villaldemiro	84	45	39	09441
09	Burgos	442	Villalmanzo	494	269	225	09442
09	Burgos	443	Villamayor de los Montes	251	119	132	09443
09	Burgos	444	Villamayor de Treviño	112	64	48	09444
09	Burgos	445	Villambistia	70	42	28	09445
09	Burgos	446	Villamedianilla	29	13	16	09446
09	Burgos	447	Villamiel de la Sierra	43	24	19	09447
09	Burgos	448	Villangómez	335	182	153	09448
09	Burgos	449	Villanueva de Argaño	124	64	60	09449
09	Burgos	450	Villanueva de Carazo	26	14	12	09450
09	Burgos	451	Villanueva de Gumiel	304	158	146	09451
09	Burgos	454	Villanueva de Teba	69	37	32	09454
09	Burgos	455	Villaquirán de la Puebla	64	36	28	09455
09	Burgos	456	Villaquirán de los Infantes	197	96	101	09456
09	Burgos	458	Villariezo	214	116	98	09458
09	Burgos	460	Villasandino	261	134	127	09460
09	Burgos	463	Villasur de Herreros	303	168	135	09463
09	Burgos	464	Villatuelda	70	37	33	09464
09	Burgos	466	Villaverde del Monte	199	108	91	09466
09	Burgos	467	Villaverde-Mogina	115	70	45	09467
09	Burgos	471	Villayerno Morquillas	132	64	68	09471
09	Burgos	472	Villazopeque	88	50	38	09472
09	Burgos	473	Villegas	128	73	55	09473
09	Burgos	476	Villoruebo	56	35	21	09476
09	Burgos	478	Vizcaínos	67	35	32	09478
09	Burgos	480	Zael	141	73	68	09480
09	Burgos	482	Zarzosa de Río Pisuerga	56	34	22	09482
09	Burgos	483	Zazuar	262	136	126	09483
09	Burgos	485	Zuñeda	84	44	40	09485
09	Burgos	901	Quintanilla del Agua y Tordueles	583	302	281	09901
09	Burgos	902	Valle de Santibáñez	626	323	303	09902
09	Burgos	903	Villarcayo de Merindad de Castilla la Vieja	3807	1911	1896	09903
09	Burgos	904	Valle de las Navas	636	354	282	09904
09	Burgos	905	Valle de Sedano	539	293	246	09905
09	Burgos	906	Merindad de Río Ubierna	1305	676	629	09906
09	Burgos	907	Alfoz de Quintanadueñas	671	358	313	09907
09	Burgos	908	Valle de Losa	670	378	292	09908
10	Cáceres	001	Abadía	276	158	118	10001
10	Cáceres	002	Abertura	511	272	239	10002
10	Cáceres	003	Acebo	806	432	374	10003
10	Cáceres	004	Acehuche	944	474	470	10004
10	Cáceres	005	Aceituna	709	363	346	10005
10	Cáceres	006	Ahigal	1564	807	757	10006
10	Cáceres	007	Albalá del Caudillo	850	414	436	10007
10	Cáceres	008	Alcántara	1650	828	822	10008
10	Cáceres	009	Alcollarín	348	164	184	10009
10	Cáceres	010	Alcuéscar	3131	1629	1502	10010
10	Cáceres	011	Aldeacentenera	927	469	458	10011
10	Cáceres	012	Aldea del Cano	801	388	413	10012
10	Cáceres	013	Aldea del Obispo (La)	395	208	187	10013
10	Cáceres	014	Aldeanueva de la Vera	2462	1220	1242	10014
10	Cáceres	015	Aldeanueva del Camino	785	404	381	10015
10	Cáceres	016	Aldehuela de Jerte	380	217	163	10016
10	Cáceres	017	Alía	1373	687	686	10017
10	Cáceres	018	Aliseda	2265	1125	1140	10018
10	Cáceres	019	Almaraz	1557	803	754	10019
10	Cáceres	020	Almoharín	2141	1072	1069	10020
10	Cáceres	021	Arroyo de la Luz	6515	3257	3258	10021
10	Cáceres	022	Arroyomolinos de la Vera	583	290	293	10022
10	Cáceres	023	Arroyomolinos	1184	595	589	10023
10	Cáceres	024	Baños de Montemayor	695	328	367	10024
10	Cáceres	025	Barrado	527	269	258	10025
10	Cáceres	026	Belvís de Monroy	604	309	295	10026
10	Cáceres	027	Benquerencia	106	63	43	10027
10	Cáceres	028	Berrocalejo	120	53	67	10028
10	Cáceres	029	Berzocana	607	307	300	10029
10	Cáceres	030	Bohonal de Ibor	580	294	286	10030
10	Cáceres	031	Botija	178	79	99	10031
10	Cáceres	032	Brozas	2328	1157	1171	10032
10	Cáceres	033	Cabañas del Castillo	550	279	271	10033
10	Cáceres	034	Cabezabellosa	523	262	261	10034
10	Cáceres	035	Cabezuela del Valle	2382	1234	1148	10035
10	Cáceres	036	Cabrero	445	233	212	10036
10	Cáceres	037	Cáceres	82235	39590	42645	10037
10	Cáceres	038	Cachorrilla	105	48	57	10038
10	Cáceres	039	Cadalso	585	300	285	10039
10	Cáceres	040	Calzadilla	593	304	289	10040
10	Cáceres	041	Caminomorisco	1228	646	582	10041
10	Cáceres	042	Campillo de Deleitosa	132	64	68	10042
10	Cáceres	043	Campo Lugar	1232	615	617	10043
10	Cáceres	044	Cañamero	1981	1012	969	10044
10	Cáceres	045	Cañaveral	1449	715	734	10045
10	Cáceres	046	Carbajo	280	145	135	10046
10	Cáceres	047	Carcaboso	1098	625	473	10047
10	Cáceres	048	Carrascalejo	423	214	209	10048
10	Cáceres	049	Casar de Cáceres	4716	2371	2345	10049
10	Cáceres	050	Casar de Palomero	1338	671	667	10050
10	Cáceres	051	Casares de las Hurdes	728	361	367	10051
10	Cáceres	052	Casas de Don Antonio	238	116	122	10052
10	Cáceres	053	Casas de Don Gómez	343	179	164	10053
10	Cáceres	054	Casas del Castañar	693	344	349	10054
10	Cáceres	055	Casas del Monte	891	468	423	10055
10	Cáceres	056	Casas de Millán	809	416	393	10056
10	Cáceres	057	Casas de Miravete	182	97	85	10057
10	Cáceres	058	Casatejada	1319	670	649	10058
10	Cáceres	059	Casillas de Coria	540	256	284	10059
10	Cáceres	060	Castañar de Ibor	1354	692	662	10060
10	Cáceres	061	Ceclavín	2228	1133	1095	10061
10	Cáceres	062	Cedillo	543	282	261	10062
10	Cáceres	063	Cerezo	228	108	120	10063
10	Cáceres	064	Cilleros	2156	1090	1066	10064
10	Cáceres	065	Collado	231	122	109	10065
10	Cáceres	066	Conquista de la Sierra	193	92	101	10066
10	Cáceres	067	Coria	12540	6291	6249	10067
10	Cáceres	068	Cuacos de Yuste	957	502	455	10068
10	Cáceres	069	Cumbre (La)	1161	587	574	10069
10	Cáceres	070	Deleitosa	898	447	451	10070
10	Cáceres	071	Descargamaría	288	151	137	10071
10	Cáceres	072	Eljas	1230	625	605	10072
10	Cáceres	073	Escurial	914	460	454	10073
10	Cáceres	075	Fresnedoso de Ibor	366	179	187	10075
10	Cáceres	076	Galisteo	1985	1007	978	10076
10	Cáceres	077	Garciaz	1038	533	505	10077
10	Cáceres	078	Garganta (La)	601	316	285	10078
10	Cáceres	079	Garganta la Olla	1040	545	495	10079
10	Cáceres	080	Gargantilla	495	262	233	10080
10	Cáceres	081	Gargüera	193	100	93	10081
10	Cáceres	082	Garrovillas	2509	1234	1275	10082
10	Cáceres	083	Garvín	127	70	57	10083
10	Cáceres	084	Gata	1893	955	938	10084
10	Cáceres	085	Gordo (El)	312	153	159	10085
10	Cáceres	086	Granja (La)	415	229	186	10086
10	Cáceres	087	Guadalupe	2365	1170	1195	10087
10	Cáceres	088	Guijo de Coria	291	154	137	10088
10	Cáceres	089	Guijo de Galisteo	1830	932	898	10089
10	Cáceres	090	Guijo de Granadilla	731	365	366	10090
10	Cáceres	091	Guijo de Santa Bárbara	489	243	246	10091
10	Cáceres	092	Herguijuela	436	214	222	10092
10	Cáceres	093	Hernán-Pérez	497	258	239	10093
10	Cáceres	094	Herrera de Alcántara	309	154	155	10094
10	Cáceres	095	Herreruela	470	247	223	10095
10	Cáceres	096	Hervás	3839	1863	1976	10096
10	Cáceres	097	Higuera	111	59	52	10097
10	Cáceres	098	Hinojal	425	201	224	10098
10	Cáceres	099	Holguera	813	412	401	10099
10	Cáceres	100	Hoyos	978	504	474	10100
10	Cáceres	101	Huélaga	208	107	101	10101
10	Cáceres	102	Ibahernando	727	353	374	10102
10	Cáceres	103	Jaraicejo	724	353	371	10103
10	Cáceres	104	Jaraíz de la Vera	6479	3290	3189	10104
10	Cáceres	105	Jarandilla de la Vera	3103	1546	1557	10105
10	Cáceres	106	Jarilla	190	95	95	10106
10	Cáceres	107	Jerte	1302	682	620	10107
10	Cáceres	108	Ladrillar	314	168	146	10108
10	Cáceres	109	Logrosán	2492	1270	1222	10109
10	Cáceres	110	Losar de la Vera	3094	1618	1476	10110
10	Cáceres	111	Madrigal de la Vera	1677	878	799	10111
10	Cáceres	112	Madrigalejo	2237	1101	1136	10112
10	Cáceres	113	Madroñera	3127	1565	1562	10113
10	Cáceres	114	Majadas	1255	692	563	10114
10	Cáceres	115	Malpartida de Cáceres	4338	2177	2161	10115
10	Cáceres	116	Malpartida de Plasencia	4119	2006	2113	10116
10	Cáceres	117	Marchagaz	322	161	161	10117
10	Cáceres	118	Mata de Alcántara	387	200	187	10118
10	Cáceres	119	Membrío	873	414	459	10119
10	Cáceres	120	Mesas de Ibor	211	110	101	10120
10	Cáceres	121	Miajadas	9315	4653	4662	10121
10	Cáceres	122	Millanes	196	109	87	10122
10	Cáceres	123	Mirabel	812	404	408	10123
10	Cáceres	124	Mohedas de Granadilla	1122	562	560	10124
10	Cáceres	125	Monroy	1059	555	504	10125
10	Cáceres	126	Montánchez	2157	1064	1093	10126
10	Cáceres	127	Montehermoso	5356	2647	2709	10127
10	Cáceres	128	Moraleja	7958	3942	4016	10128
10	Cáceres	129	Morcillo	484	238	246	10129
10	Cáceres	130	Navaconcejo	2035	1031	1004	10130
10	Cáceres	131	Navalmoral de la Mata	14838	7422	7416	10131
10	Cáceres	132	Navalvillar de Ibor	515	269	246	10132
10	Cáceres	133	Navas del Madroño	1536	770	766	10133
10	Cáceres	134	Navezuelas	731	383	348	10134
10	Cáceres	135	Nuñomoral	1760	929	831	10135
10	Cáceres	136	Oliva de Plasencia	302	157	145	10136
10	Cáceres	137	Palomero	540	269	271	10137
10	Cáceres	138	Pasarón de la Vera	701	345	356	10138
10	Cáceres	139	Pedroso de Acim	140	74	66	10139
10	Cáceres	140	Peraleda de la Mata	1372	686	686	10140
10	Cáceres	141	Peraleda de San Román	412	197	215	10141
10	Cáceres	142	Perales del Puerto	993	490	503	10142
10	Cáceres	143	Pescueza	205	95	110	10143
10	Cáceres	144	Pesga (La)	1217	662	555	10144
10	Cáceres	145	Piedras Albas	210	100	110	10145
10	Cáceres	146	Pinofranqueado	1693	926	767	10146
10	Cáceres	147	Piornal	1566	769	797	10147
10	Cáceres	148	Plasencia	37018	18098	18920	10148
10	Cáceres	149	Plasenzuela	551	258	293	10149
10	Cáceres	150	Portaje	407	197	210	10150
10	Cáceres	151	Portezuelo	312	151	161	10151
10	Cáceres	152	Pozuelo de Zarzón	624	301	323	10152
10	Cáceres	153	Puerto de Santa Cruz	427	209	218	10153
10	Cáceres	154	Rebollar	246	126	120	10154
10	Cáceres	155	Riolobos	1506	797	709	10155
10	Cáceres	156	Robledillo de Gata	175	93	82	10156
10	Cáceres	157	Robledillo de la Vera	327	162	165	10157
10	Cáceres	158	Robledillo de Trujillo	498	259	239	10158
10	Cáceres	159	Robledollano	430	232	198	10159
10	Cáceres	160	Romangordo	185	86	99	10160
10	Cáceres	161	Ruanes	108	58	50	10161
10	Cáceres	162	Salorino	796	398	398	10162
10	Cáceres	163	Salvatierra de Santiago	423	218	205	10163
10	Cáceres	164	San Martín de Trevejo	998	494	504	10164
10	Cáceres	165	Santa Ana	336	171	165	10165
10	Cáceres	166	Santa Cruz de la Sierra	366	188	178	10166
10	Cáceres	167	Santa Cruz de Paniagua	450	242	208	10167
10	Cáceres	168	Santa Marta de Magasca	373	187	186	10168
10	Cáceres	169	Santiago de Alcántara	751	372	379	10169
10	Cáceres	170	Santiago del Campo	314	157	157	10170
10	Cáceres	171	Santibáñez el Alto	563	293	270	10171
10	Cáceres	172	Santibáñez el Bajo	1027	528	499	10172
10	Cáceres	173	Saucedilla	614	316	298	10173
10	Cáceres	174	Segura de Toro	205	110	95	10174
10	Cáceres	175	Serradilla	1919	983	936	10175
10	Cáceres	176	Serrejón	496	254	242	10176
10	Cáceres	177	Sierra de Fuentes	1656	849	807	10177
10	Cáceres	178	Talaván	1012	503	509	10178
10	Cáceres	179	Talaveruela de la Vera	458	216	242	10179
10	Cáceres	180	Talayuela	9444	5715	3729	10180
10	Cáceres	181	Tejeda de Tiétar	1026	544	482	10181
10	Cáceres	182	Toril	198	126	72	10182
10	Cáceres	183	Tornavacas	1328	712	616	10183
10	Cáceres	184	Torno (El)	941	478	463	10184
10	Cáceres	185	Torrecilla de los Ángeles	733	375	358	10185
10	Cáceres	186	Torrecillas de la Tiesa	1185	598	587	10186
10	Cáceres	187	Torre de Don Miguel	671	335	336	10187
10	Cáceres	188	Torre de Santa María	739	370	369	10188
10	Cáceres	189	Torrejoncillo	3557	1728	1829	10189
10	Cáceres	190	Torrejón el Rubio	704	364	340	10190
10	Cáceres	191	Torremenga	543	277	266	10191
10	Cáceres	192	Torremocha	1277	616	661	10192
10	Cáceres	193	Torreorgaz	1665	833	832	10193
10	Cáceres	194	Torrequemada	586	278	308	10194
10	Cáceres	195	Trujillo	8713	4199	4514	10195
10	Cáceres	196	Valdastillas	401	200	201	10196
10	Cáceres	197	Valdecañas de Tajo	284	151	133	10197
10	Cáceres	198	Valdefuentes	1555	781	774	10198
10	Cáceres	199	Valdehúncar	214	106	108	10199
10	Cáceres	200	Valdelacasa de Tajo	539	252	287	10200
10	Cáceres	201	Valdemorales	273	134	139	10201
10	Cáceres	202	Valdeobispo	800	393	407	10202
10	Cáceres	203	Valencia de Alcántara	6240	3056	3184	10203
10	Cáceres	204	Valverde de la Vera	560	289	271	10204
10	Cáceres	205	Valverde del Fresno	2651	1340	1311	10205
10	Cáceres	206	Viandar de la Vera	323	154	169	10206
10	Cáceres	207	Villa del Campo	679	333	346	10207
10	Cáceres	208	Villa del Rey	181	95	86	10208
10	Cáceres	209	Villamesías	370	183	187	10209
10	Cáceres	210	Villamiel	691	396	295	10210
10	Cáceres	211	Villanueva de la Sierra	616	297	319	10211
10	Cáceres	212	Villanueva de la Vera	2006	1008	998	10212
10	Cáceres	213	Villar del Pedroso	813	407	406	10213
10	Cáceres	214	Villar de Plasencia	275	139	136	10214
10	Cáceres	215	Villasbuenas de Gata	504	262	242	10215
10	Cáceres	216	Zarza de Granadilla	1784	914	870	10216
10	Cáceres	217	Zarza de Montánchez	618	306	312	10217
10	Cáceres	218	Zarza la Mayor	1712	866	846	10218
10	Cáceres	219	Zorita	1987	994	993	10219
10	Cáceres	901	Rosalejo	1766	991	775	10901
11	Cádiz	001	Alcalá de los Gazules	5563	2880	2683	11001
11	Cádiz	002	Alcalá del Valle	5271	2983	2288	11002
11	Cádiz	003	Algar	1778	950	828	11003
11	Cádiz	004	Algeciras	104087	51166	52921	11004
11	Cádiz	005	Algodonales	5617	2883	2734	11005
11	Cádiz	006	Arcos de la Frontera	27979	14027	13952	11006
11	Cádiz	007	Barbate	22020	11041	10979	11007
11	Cádiz	008	Barrios (Los)	16825	8447	8378	11008
11	Cádiz	009	Benaocaz	659	342	317	11009
11	Cádiz	010	Bornos	7897	3916	3981	11010
11	Cádiz	011	Bosque (El)	1875	959	916	11011
11	Cádiz	012	Cádiz	140061	67180	72881	11012
11	Cádiz	013	Castellar de la Frontera	2531	1295	1236	11013
11	Cádiz	014	Conil de la Frontera	17773	9016	8757	11014
11	Cádiz	015	Chiclana de la Frontera	59857	30411	29446	11015
11	Cádiz	016	Chipiona	16539	8352	8187	11016
11	Cádiz	017	Espera	3971	2071	1900	11017
11	Cádiz	018	Gastor (El)	1953	1023	930	11018
11	Cádiz	019	Grazalema	2240	1179	1061	11019
11	Cádiz	020	Jerez de la Frontera	183677	89617	94060	11020
11	Cádiz	021	Jimena de la Frontera	9109	4645	4464	11021
11	Cádiz	022	Línea de la Concepción (La)	59993	29349	30644	11022
11	Cádiz	023	Medina-Sidonia	10793	5581	5212	11023
11	Cádiz	024	Olvera	8685	4352	4333	11024
11	Cádiz	025	Paterna de Rivera	5179	2687	2492	11025
11	Cádiz	026	Prado del Rey	5856	2928	2928	11026
11	Cádiz	027	Puerto de Santa María (El)	75478	37592	37886	11027
11	Cádiz	028	Puerto Real	35182	17696	17486	11028
11	Cádiz	029	Puerto Serrano	6758	3446	3312	11029
11	Cádiz	030	Rota	25560	12917	12643	11030
11	Cádiz	031	San Fernando	88179	43567	44612	11031
11	Cádiz	032	Sanlúcar de Barrameda	61966	31010	30956	11032
11	Cádiz	033	San Roque	22990	11574	11416	11033
11	Cádiz	034	Setenil de las Bodegas	3067	1573	1494	11034
11	Cádiz	035	Tarifa	15481	7852	7629	11035
11	Cádiz	036	Torre Alháquime	931	468	463	11036
11	Cádiz	037	Trebujena	6937	3591	3346	11037
11	Cádiz	038	Ubrique	17586	8717	8869	11038
11	Cádiz	039	Vejer de la Frontera	12674	6392	6282	11039
11	Cádiz	040	Villaluenga del Rosario	440	236	204	11040
11	Cádiz	041	Villamartín	11969	5892	6077	11041
11	Cádiz	042	Zahara	1560	819	741	11042
11	Cádiz	901	Benalup-Casas Viejas	6305	3207	3098	11901
11	Cádiz	902	San José del Valle	4254	2134	2120	11902
12	Castellón/Castelló	001	Atzeneta del Maestrat	1438	728	710	12001
12	Castellón/Castelló	002	Aín	167	82	85	12002
12	Castellón/Castelló	003	Albocàsser	1344	645	699	12003
12	Castellón/Castelló	004	Alcalà de Xivert	5456	2757	2699	12004
12	Castellón/Castelló	005	Alcora (l')	9106	4636	4470	12005
12	Castellón/Castelló	006	Alcudia de Veo	220	110	110	12006
12	Castellón/Castelló	007	Alfondeguilla	908	448	460	12007
12	Castellón/Castelló	008	Algimia de Almonacid	278	161	117	12008
12	Castellón/Castelló	009	Almazora/Almassora	16897	8400	8497	12009
12	Castellón/Castelló	010	Almedíjar	275	133	142	12010
12	Castellón/Castelló	011	Almenara	4912	2419	2493	12011
12	Castellón/Castelló	012	Altura	3137	1573	1564	12012
12	Castellón/Castelló	013	Arañuel	181	91	90	12013
12	Castellón/Castelló	014	Ares del Maestre	254	126	128	12014
12	Castellón/Castelló	015	Argelita	136	70	66	12015
12	Castellón/Castelló	016	Artana	1840	909	931	12016
12	Castellón/Castelló	017	Ayódar	236	133	103	12017
12	Castellón/Castelló	018	Azuébar	347	171	176	12018
12	Castellón/Castelló	020	Barracas	159	85	74	12020
12	Castellón/Castelló	021	Betxí	5356	2718	2638	12021
12	Castellón/Castelló	022	Bejís	383	218	165	12022
12	Castellón/Castelló	024	Benafer	151	83	68	12024
12	Castellón/Castelló	025	Benafigos	206	109	97	12025
12	Castellón/Castelló	026	Benasal	1388	672	716	12026
12	Castellón/Castelló	027	Benicarló	19908	9889	10019	12027
12	Castellón/Castelló	028	Benicasim/Benicàssim	11874	6017	5857	12028
12	Castellón/Castelló	029	Benlloch	842	427	415	12029
12	Castellón/Castelló	031	Borriol	3576	1808	1768	12031
12	Castellón/Castelló	032	Burriana	26499	12952	13547	12032
12	Castellón/Castelló	033	Cabanes	2359	1183	1176	12033
12	Castellón/Castelló	034	Càlig	1744	858	886	12034
12	Castellón/Castelló	036	Canet lo Roig	879	420	459	12036
12	Castellón/Castelló	037	Castell de Cabres	22	10	12	12037
12	Castellón/Castelló	038	Castellfort	236	123	113	12038
12	Castellón/Castelló	039	Castellnovo	1020	476	544	12039
12	Castellón/Castelló	040	Castellón de la Plana/Castelló de la Plana	142285	69360	72925	12040
12	Castellón/Castelló	041	Castillo de Villamalefa	115	58	57	12041
12	Castellón/Castelló	042	Catí	869	448	421	12042
12	Castellón/Castelló	043	Caudiel	695	339	356	12043
12	Castellón/Castelló	044	Cervera del Maestre	711	333	378	12044
12	Castellón/Castelló	045	Cinctorres	520	246	274	12045
12	Castellón/Castelló	046	Cirat	282	151	131	12046
12	Castellón/Castelló	048	Cortes de Arenoso	406	215	191	12048
12	Castellón/Castelló	049	Costur	463	230	233	12049
12	Castellón/Castelló	050	Coves de Vinromà (les)	1810	915	895	12050
12	Castellón/Castelló	051	Culla	771	395	376	12051
12	Castellón/Castelló	052	Chert/Xert	894	433	461	12052
12	Castellón/Castelló	053	Chilches	2299	1179	1120	12053
12	Castellón/Castelló	055	Chodos/Xodos	160	87	73	12055
12	Castellón/Castelló	056	Chóvar	378	193	185	12056
12	Castellón/Castelló	057	Eslida	769	361	408	12057
12	Castellón/Castelló	058	Espadilla	73	35	38	12058
12	Castellón/Castelló	059	Fanzara	250	116	134	12059
12	Castellón/Castelló	060	Figueroles	581	287	294	12060
12	Castellón/Castelló	061	Forcall	571	270	301	12061
12	Castellón/Castelló	063	Fuente la Reina	29	15	14	12063
12	Castellón/Castelló	064	Fuentes de Ayódar	110	60	50	12064
12	Castellón/Castelló	065	Gaibiel	203	111	92	12065
12	Castellón/Castelló	067	Geldo	689	344	345	12067
12	Castellón/Castelló	068	Herbés	103	54	49	12068
12	Castellón/Castelló	069	Higueras	39	22	17	12069
12	Castellón/Castelló	070	Jana (la)	812	411	401	12070
12	Castellón/Castelló	071	Jérica	1554	779	775	12071
12	Castellón/Castelló	072	Lucena del Cid	1538	774	764	12072
12	Castellón/Castelló	073	Ludiente	225	117	108	12073
12	Castellón/Castelló	074	Llosa (la)	918	461	457	12074
12	Castellón/Castelló	075	Mata de Morella (la)	180	90	90	12075
12	Castellón/Castelló	076	Matet	140	71	69	12076
12	Castellón/Castelló	077	Moncofa	3905	1997	1908	12077
12	Castellón/Castelló	078	Montán	347	179	168	12078
12	Castellón/Castelló	079	Montanejos	415	209	206	12079
12	Castellón/Castelló	080	Morella	2711	1309	1402	12080
12	Castellón/Castelló	081	Navajas	541	275	266	12081
12	Castellón/Castelló	082	Nules	11453	5698	5755	12082
12	Castellón/Castelló	083	Olocau del Rey	144	78	66	12083
12	Castellón/Castelló	084	Onda	19303	9774	9529	12084
12	Castellón/Castelló	085	Oropesa del Mar/Orpesa	3734	1912	1822	12085
12	Castellón/Castelló	087	Palanques	21	13	8	12087
12	Castellón/Castelló	088	Pavías	61	37	24	12088
12	Castellón/Castelló	089	Peñíscola	4548	2293	2255	12089
12	Castellón/Castelló	090	Pina de Montalgrao	167	89	78	12090
12	Castellón/Castelló	091	Portell de Morella	262	127	135	12091
12	Castellón/Castelló	092	Puebla de Arenoso	164	82	82	12092
12	Castellón/Castelló	093	Pobla de Benifassà (la)	269	132	137	12093
12	Castellón/Castelló	094	Pobla Tornesa (la)	558	273	285	12094
12	Castellón/Castelló	095	Ribesalbes	1284	647	637	12095
12	Castellón/Castelló	096	Rossell	1119	572	547	12096
12	Castellón/Castelló	097	Sacañet	84	52	32	12097
12	Castellón/Castelló	098	Salzadella (la)	814	405	409	12098
12	Castellón/Castelló	099	San Jorge	581	288	293	12099
12	Castellón/Castelló	100	Sant Mateu	1806	891	915	12100
12	Castellón/Castelló	101	San Rafael del Río	455	242	213	12101
12	Castellón/Castelló	102	Santa Magdalena de Pulpis	723	374	349	12102
12	Castellón/Castelló	103	Sarratella	87	47	40	12103
12	Castellón/Castelló	104	Segorbe	7839	3819	4020	12104
12	Castellón/Castelló	105	Sierra Engarcerán	1098	577	521	12105
12	Castellón/Castelló	106	Soneja	1379	696	683	12106
12	Castellón/Castelló	107	Sot de Ferrer	422	215	207	12107
12	Castellón/Castelló	108	Sueras/Suera	547	270	277	12108
12	Castellón/Castelló	109	Tales	763	369	394	12109
12	Castellón/Castelló	110	Teresa	345	175	170	12110
12	Castellón/Castelló	111	Tírig	551	276	275	12111
12	Castellón/Castelló	112	Todolella	144	82	62	12112
12	Castellón/Castelló	113	Toga	103	54	49	12113
12	Castellón/Castelló	114	Torás	258	132	126	12114
12	Castellón/Castelló	115	Toro (El)	336	177	159	12115
12	Castellón/Castelló	116	Torralba del Pinar	75	35	40	12116
12	Castellón/Castelló	117	Torreblanca	4614	2294	2320	12117
12	Castellón/Castelló	118	Torrechiva	76	49	27	12118
12	Castellón/Castelló	119	Torre d'En Besora (la)	210	107	103	12119
12	Castellón/Castelló	120	Torre Endoménech	235	118	117	12120
12	Castellón/Castelló	121	Traiguera	1588	823	765	12121
12	Castellón/Castelló	122	Useras/Useres (les)	986	503	483	12122
12	Castellón/Castelló	123	Vallat	57	27	30	12123
12	Castellón/Castelló	124	Vall d'Alba	1948	976	972	12124
12	Castellón/Castelló	125	Vall de Almonacid	293	154	139	12125
12	Castellón/Castelló	126	Vall d'Uixó (la)	29152	14503	14649	12126
12	Castellón/Castelló	127	Vallibona	93	53	40	12127
12	Castellón/Castelló	128	Vilafamés	1471	780	691	12128
12	Castellón/Castelló	129	Villafranca del Cid	2635	1284	1351	12129
12	Castellón/Castelló	130	Villahermosa del Río	452	247	205	12130
12	Castellón/Castelló	131	Villamalur	141	79	62	12131
12	Castellón/Castelló	132	Vilanova d'Alcolea	639	328	311	12132
12	Castellón/Castelló	133	Villanueva de Viver	79	40	39	12133
12	Castellón/Castelló	134	Vilar de Canes	183	94	89	12134
12	Castellón/Castelló	135	Villarreal/Vila-real	41531	20683	20848	12135
12	Castellón/Castelló	136	Villavieja	3366	1684	1682	12136
12	Castellón/Castelló	137	Villores	63	32	31	12137
12	Castellón/Castelló	138	Vinaròs	22552	11025	11527	12138
12	Castellón/Castelló	139	Vistabella del Maestrazgo	453	228	225	12139
12	Castellón/Castelló	140	Viver	1297	656	641	12140
12	Castellón/Castelló	141	Zorita del Maestrazgo	138	68	70	12141
12	Castellón/Castelló	142	Zucaina	215	121	94	12142
12	Castellón/Castelló	901	Alquerías del Niño Perdido	3543	1722	1821	12901
12	Castellón/Castelló	902	Sant Joan de Moró	1783	920	863	12902
13	Ciudad Real	001	Abenójar	1762	878	884	13001
13	Ciudad Real	002	Agudo	2097	1065	1032	13002
13	Ciudad Real	003	Alamillo	723	367	356	13003
13	Ciudad Real	004	Albaladejo	1641	829	812	13004
13	Ciudad Real	005	Alcázar de San Juan	26150	12738	13412	13005
13	Ciudad Real	006	Alcoba	769	400	369	13006
13	Ciudad Real	007	Alcolea de Calatrava	1656	834	822	13007
13	Ciudad Real	008	Alcubillas	680	327	353	13008
13	Ciudad Real	009	Aldea del Rey	2186	1067	1119	13009
13	Ciudad Real	010	Alhambra	1259	637	622	13010
13	Ciudad Real	011	Almadén	7152	3416	3736	13011
13	Ciudad Real	012	Almadenejos	579	301	278	13012
13	Ciudad Real	013	Almagro	8262	4017	4245	13013
13	Ciudad Real	014	Almedina	760	387	373	13014
13	Ciudad Real	015	Almodóvar del Campo	7452	3665	3787	13015
13	Ciudad Real	016	Almuradiel	978	454	524	13016
13	Ciudad Real	017	Anchuras	450	257	193	13017
13	Ciudad Real	018	Arenas de San Juan	1083	547	536	13018
13	Ciudad Real	019	Argamasilla de Alba	6710	3321	3389	13019
13	Ciudad Real	020	Argamasilla de Calatrava	5369	2713	2656	13020
13	Ciudad Real	021	Arroba de los Montes	627	321	306	13021
13	Ciudad Real	022	Ballesteros de Calatrava	575	281	294	13022
13	Ciudad Real	023	Bolaños de Calatrava	10679	5329	5350	13023
13	Ciudad Real	024	Brazatortas	1241	620	621	13024
13	Ciudad Real	025	Cabezarados	387	199	188	13025
13	Ciudad Real	026	Cabezarrubias del Puerto	636	328	308	13026
13	Ciudad Real	027	Calzada de Calatrava	4687	2299	2388	13027
13	Ciudad Real	028	Campo de Criptana	13042	6401	6641	13028
13	Ciudad Real	029	Cañada de Calatrava	82	46	36	13029
13	Ciudad Real	030	Caracuel de Calatrava	176	96	80	13030
13	Ciudad Real	031	Carrión de Calatrava	2633	1288	1345	13031
13	Ciudad Real	032	Carrizosa	1692	845	847	13032
13	Ciudad Real	033	Castellar de Santiago	2220	1078	1142	13033
13	Ciudad Real	034	Ciudad Real	60243	28480	31763	13034
13	Ciudad Real	035	Corral de Calatrava	1306	668	638	13035
13	Ciudad Real	036	Cortijos (Los)	1090	538	552	13036
13	Ciudad Real	037	Cózar	1296	623	673	13037
13	Ciudad Real	038	Chillón	2347	1134	1213	13038
13	Ciudad Real	039	Daimiel	17276	8488	8788	13039
13	Ciudad Real	040	Fernancaballero	1042	499	543	13040
13	Ciudad Real	041	Fontanarejo	363	194	169	13041
13	Ciudad Real	042	Fuencaliente	1304	679	625	13042
13	Ciudad Real	043	Fuenllana	328	155	173	13043
13	Ciudad Real	044	Fuente el Fresno	3508	1737	1771	13044
13	Ciudad Real	045	Granátula de Calatrava	1002	479	523	13045
13	Ciudad Real	046	Guadalmez	1075	545	530	13046
13	Ciudad Real	047	Herencia	7023	3519	3504	13047
13	Ciudad Real	048	Hinojosas de Calatrava	762	374	388	13048
13	Ciudad Real	049	Horcajo de los Montes	1097	549	548	13049
13	Ciudad Real	050	Labores (Las)	704	343	361	13050
13	Ciudad Real	051	Luciana	444	224	220	13051
13	Ciudad Real	052	Malagón	7955	3928	4027	13052
13	Ciudad Real	053	Manzanares	17216	8422	8794	13053
13	Ciudad Real	054	Membrilla	6609	3308	3301	13054
13	Ciudad Real	055	Mestanza	917	444	473	13055
13	Ciudad Real	056	Miguelturra	9863	4928	4935	13056
13	Ciudad Real	057	Montiel	1673	845	828	13057
13	Ciudad Real	058	Moral de Calatrava	5218	2553	2665	13058
13	Ciudad Real	059	Navalpino	311	149	162	13059
13	Ciudad Real	060	Navas de Estena	410	221	189	13060
13	Ciudad Real	061	Pedro Muñoz	7186	3586	3600	13061
13	Ciudad Real	062	Picón	661	352	309	13062
13	Ciudad Real	063	Piedrabuena	4888	2485	2403	13063
13	Ciudad Real	064	Poblete	806	407	399	13064
13	Ciudad Real	065	Porzuna	3919	1990	1929	13065
13	Ciudad Real	066	Pozuelo de Calatrava	2545	1257	1288	13066
13	Ciudad Real	067	Pozuelos de Calatrava (Los)	572	292	280	13067
13	Ciudad Real	068	Puebla de Don Rodrigo	1318	693	625	13068
13	Ciudad Real	069	Puebla del Príncipe	1080	535	545	13069
13	Ciudad Real	070	Puerto Lápice	1037	524	513	13070
13	Ciudad Real	071	Puertollano	50212	24364	25848	13071
13	Ciudad Real	072	Retuerta del Bullaque	1019	535	484	13072
13	Ciudad Real	073	Saceruela	774	411	363	13073
13	Ciudad Real	074	San Carlos del Valle	1241	618	623	13074
13	Ciudad Real	075	San Lorenzo de Calatrava	321	168	153	13075
13	Ciudad Real	076	Santa Cruz de los Cáñamos	654	328	326	13076
13	Ciudad Real	077	Santa Cruz de Mudela	4830	2374	2456	13077
13	Ciudad Real	078	Socuéllamos	11228	5522	5706	13078
13	Ciudad Real	079	Solana (La)	15066	7538	7528	13079
13	Ciudad Real	080	Solana del Pino	554	276	278	13080
13	Ciudad Real	081	Terrinches	970	480	490	13081
13	Ciudad Real	082	Tomelloso	29284	14314	14970	13082
13	Ciudad Real	083	Torralba de Calatrava	2899	1432	1467	13083
13	Ciudad Real	084	Torre de Juan Abad	1406	680	726	13084
13	Ciudad Real	085	Torrenueva	3271	1653	1618	13085
13	Ciudad Real	086	Valdemanco del Esteras	310	155	155	13086
13	Ciudad Real	087	Valdepeñas	26395	12685	13710	13087
13	Ciudad Real	088	Valenzuela de Calatrava	798	385	413	13088
13	Ciudad Real	089	Villahermosa	2628	1230	1398	13089
13	Ciudad Real	090	Villamanrique	1672	817	855	13090
13	Ciudad Real	091	Villamayor de Calatrava	639	320	319	13091
13	Ciudad Real	092	Villanueva de la Fuente	2648	1304	1344	13092
13	Ciudad Real	093	Villanueva de los Infantes	5805	2798	3007	13093
13	Ciudad Real	094	Villanueva de San Carlos	460	227	233	13094
13	Ciudad Real	095	Villar del Pozo	106	57	49	13095
13	Ciudad Real	096	Villarrubia de los Ojos	9583	4761	4822	13096
13	Ciudad Real	097	Villarta de San Juan	2970	1496	1474	13097
13	Ciudad Real	098	Viso del Marqués	3041	1516	1525	13098
13	Ciudad Real	901	Robledo (El)	1119	586	533	13901
13	Ciudad Real	902	Ruidera	594	312	282	13902
13	Ciudad Real	903	Arenales de San Gregorio	629	325	304	13903
13	Ciudad Real	904	Llanos del Caudillo	718	373	345	13904
14	Córdoba	001	Adamuz	4465	2271	2194	14001
14	Córdoba	002	Aguilar de la Frontera	13393	6616	6777	14002
14	Córdoba	003	Alcaracejos	1469	726	743	14003
14	Córdoba	004	Almedinilla	2527	1240	1287	14004
14	Córdoba	005	Almodóvar del Río	7013	3467	3546	14005
14	Córdoba	006	Añora	1618	797	821	14006
14	Córdoba	007	Baena	19725	9758	9967	14007
14	Córdoba	008	Belalcázar	3768	1835	1933	14008
14	Córdoba	009	Belmez	3924	1873	2051	14009
14	Córdoba	010	Benamejí	4788	2422	2366	14010
14	Córdoba	011	Blázquez (Los)	714	364	350	14011
14	Córdoba	012	Bujalance	8051	3943	4108	14012
14	Córdoba	013	Cabra	20711	10083	10628	14013
14	Córdoba	014	Cañete de las Torres	3328	1663	1665	14014
14	Córdoba	015	Carcabuey	2868	1442	1426	14015
14	Córdoba	016	Cardeña	1907	971	936	14016
14	Córdoba	017	Carlota (La)	10471	5245	5226	14017
14	Córdoba	018	Carpio (El)	4465	2178	2287	14018
14	Córdoba	019	Castro del Río	8040	3939	4101	14019
14	Córdoba	020	Conquista	501	253	248	14020
14	Córdoba	021	Córdoba	313463	151060	162403	14021
14	Córdoba	022	Doña Mencía	4946	2470	2476	14022
14	Córdoba	023	Dos Torres	2586	1270	1316	14023
14	Córdoba	024	Encinas Reales	2401	1175	1226	14024
14	Córdoba	025	Espejo	3963	1977	1986	14025
14	Córdoba	026	Espiel	2441	1212	1229	14026
14	Córdoba	027	Fernán-Núñez	9497	4742	4755	14027
14	Córdoba	028	Fuente la Lancha	411	201	210	14028
14	Córdoba	029	Fuente Obejuna	5890	2994	2896	14029
14	Córdoba	030	Fuente Palmera	9897	4998	4899	14030
14	Córdoba	031	Fuente-Tójar	817	389	428	14031
14	Córdoba	032	Granjuela (La)	496	265	231	14032
14	Córdoba	033	Guadalcázar	1168	589	579	14033
14	Córdoba	034	Guijo (El)	394	195	199	14034
14	Córdoba	035	Hinojosa del Duque	7928	3815	4113	14035
14	Córdoba	036	Hornachuelos	4860	2433	2427	14036
14	Córdoba	037	Iznájar	5077	2555	2522	14037
14	Córdoba	038	Lucena	36445	18081	18364	14038
14	Córdoba	039	Luque	3363	1673	1690	14039
14	Córdoba	040	Montalbán de Córdoba	4558	2288	2270	14040
14	Córdoba	041	Montemayor	3813	1912	1901	14041
14	Córdoba	042	Montilla	22973	11331	11642	14042
14	Córdoba	043	Montoro	9457	4630	4827	14043
14	Córdoba	044	Monturque	1962	982	980	14044
14	Córdoba	045	Moriles	3797	1888	1909	14045
14	Córdoba	046	Nueva Carteya	5583	2808	2775	14046
14	Córdoba	047	Obejo	1509	759	750	14047
14	Córdoba	048	Palenciana	1571	784	787	14048
14	Córdoba	049	Palma del Río	19266	9580	9686	14049
14	Córdoba	050	Pedro Abad	2893	1439	1454	14050
14	Córdoba	051	Pedroche	1843	903	940	14051
14	Córdoba	052	Peñarroya-Pueblonuevo	13024	6210	6814	14052
14	Córdoba	053	Posadas	7101	3522	3579	14053
14	Córdoba	054	Pozoblanco	16282	7855	8427	14054
14	Córdoba	055	Priego de Córdoba	22053	10759	11294	14055
14	Córdoba	056	Puente Genil	27909	13739	14170	14056
14	Córdoba	057	Rambla (La)	7299	3639	3660	14057
14	Córdoba	058	Rute	9923	4911	5012	14058
14	Córdoba	059	San Sebastián de los Ballesteros	852	435	417	14059
14	Córdoba	060	Santaella	5878	2957	2921	14060
14	Córdoba	061	Santa Eufemia	1148	580	568	14061
14	Córdoba	062	Torrecampo	1416	687	729	14062
14	Córdoba	063	Valenzuela	1440	706	734	14063
14	Córdoba	064	Valsequillo	450	216	234	14064
14	Córdoba	065	Victoria (La)	1786	892	894	14065
14	Córdoba	066	Villa del Río	7171	3621	3550	14066
14	Córdoba	067	Villafranca de Córdoba	3625	1874	1751	14067
14	Córdoba	068	Villaharta	642	322	320	14068
14	Córdoba	069	Villanueva de Córdoba	9807	4768	5039	14069
14	Córdoba	070	Villanueva del Duque	1808	843	965	14070
14	Córdoba	071	Villanueva del Rey	1258	640	618	14071
14	Córdoba	072	Villaralto	1526	732	794	14072
14	Córdoba	073	Villaviciosa de Córdoba	3854	1973	1881	14073
14	Córdoba	074	Viso (El)	3071	1492	1579	14074
14	Córdoba	075	Zuheros	900	451	449	14075
15	Coruña (A)	001	Abegondo	5594	2806	2788	15001
15	Coruña (A)	002	Ames	16549	8048	8501	15002
15	Coruña (A)	003	Aranga	2423	1212	1211	15003
15	Coruña (A)	004	Ares	4744	2349	2395	15004
15	Coruña (A)	005	Arteixo	22153	11120	11033	15005
15	Coruña (A)	006	Arzúa	6886	3367	3519	15006
15	Coruña (A)	007	Baña (A)	5324	2559	2765	15007
15	Coruña (A)	008	Bergondo	6119	2984	3135	15008
15	Coruña (A)	009	Betanzos	12361	5851	6510	15009
15	Coruña (A)	010	Boimorto	2598	1303	1295	15010
15	Coruña (A)	011	Boiro	18038	8751	9287	15011
15	Coruña (A)	012	Boqueixón	4291	2104	2187	15012
15	Coruña (A)	013	Brión	6239	3009	3230	15013
15	Coruña (A)	014	Cabana de Bergantiños	5733	2843	2890	15014
15	Coruña (A)	015	Cabanas	3262	1577	1685	15015
15	Coruña (A)	016	Camariñas	6813	3357	3456	15016
15	Coruña (A)	017	Cambre	17805	8738	9067	15017
15	Coruña (A)	018	Capela (A)	1595	784	811	15018
15	Coruña (A)	019	Carballo	28271	13749	14522	15019
15	Coruña (A)	020	Carnota	5645	2716	2929	15020
15	Coruña (A)	021	Carral	5275	2554	2721	15021
15	Coruña (A)	022	Cedeira	7528	3686	3842	15022
15	Coruña (A)	023	Cee	7364	3554	3810	15023
15	Coruña (A)	024	Cerceda	5573	2725	2848	15024
15	Coruña (A)	025	Cerdido	1668	806	862	15025
15	Coruña (A)	026	Cesuras	2646	1316	1330	15026
15	Coruña (A)	027	Coirós	1552	763	789	15027
15	Coruña (A)	028	Corcubión	1945	934	1011	15028
15	Coruña (A)	029	Coristanco	8146	4016	4130	15029
15	Coruña (A)	030	Coruña (A)	241769	112264	129505	15030
15	Coruña (A)	031	Culleredo	20890	10247	10643	15031
15	Coruña (A)	032	Curtis	4468	2191	2277	15032
15	Coruña (A)	033	Dodro	3280	1591	1689	15033
15	Coruña (A)	034	Dumbría	4529	2186	2343	15034
15	Coruña (A)	035	Fene	14848	7291	7557	15035
15	Coruña (A)	036	Ferrol	81255	37887	43368	15036
15	Coruña (A)	037	Fisterra	5224	2618	2606	15037
15	Coruña (A)	038	Frades	3083	1538	1545	15038
15	Coruña (A)	039	Irixoa	1719	848	871	15039
15	Coruña (A)	040	Laxe	3551	1764	1787	15040
15	Coruña (A)	041	Laracha	10701	5215	5486	15041
15	Coruña (A)	042	Lousame	4199	2009	2190	15042
15	Coruña (A)	043	Malpica de Bergantiños	7262	3561	3701	15043
15	Coruña (A)	044	Mañón	1932	938	994	15044
15	Coruña (A)	045	Mazaricos	6185	2978	3207	15045
15	Coruña (A)	046	Melide	8441	4169	4272	15046
15	Coruña (A)	047	Mesía	3409	1692	1717	15047
15	Coruña (A)	048	Miño	4870	2302	2568	15048
15	Coruña (A)	049	Moeche	1561	743	818	15049
15	Coruña (A)	050	Monfero	2695	1383	1312	15050
15	Coruña (A)	051	Mugardos	5984	2894	3090	15051
15	Coruña (A)	052	Muxía	6213	3033	3180	15052
15	Coruña (A)	053	Muros	10519	5042	5477	15053
15	Coruña (A)	054	Narón	30328	14679	15649	15054
15	Coruña (A)	055	Neda	6166	2994	3172	15055
15	Coruña (A)	056	Negreira	6588	3160	3428	15056
15	Coruña (A)	057	Noia	14404	6883	7521	15057
15	Coruña (A)	058	Oleiros	26016	12642	13374	15058
15	Coruña (A)	059	Ordes	11942	5789	6153	15059
15	Coruña (A)	060	Oroso	5236	2595	2641	15060
15	Coruña (A)	061	Ortigueira	8533	4057	4476	15061
15	Coruña (A)	062	Outes	8634	4127	4507	15062
15	Coruña (A)	063	Oza dos Ríos	3208	1553	1655	15063
15	Coruña (A)	064	Paderne	2753	1318	1435	15064
15	Coruña (A)	065	Padrón	9260	4453	4807	15065
15	Coruña (A)	066	Pino (O)	4934	2452	2482	15066
15	Coruña (A)	067	Pobra do Caramiñal (A)	9955	4764	5191	15067
15	Coruña (A)	068	Ponteceso	7155	3579	3576	15068
15	Coruña (A)	069	Pontedeume	8936	4291	4645	15069
15	Coruña (A)	070	Pontes de García Rodríguez (As)	12488	6297	6191	15070
15	Coruña (A)	071	Porto do Son	10298	5023	5275	15071
15	Coruña (A)	072	Rianxo	11882	5797	6085	15072
15	Coruña (A)	073	Ribeira	26478	13036	13442	15073
15	Coruña (A)	074	Rois	5216	2485	2731	15074
15	Coruña (A)	075	Sada	11015	5412	5603	15075
15	Coruña (A)	076	San Sadurniño	3431	1670	1761	15076
15	Coruña (A)	077	Santa Comba	10930	5390	5540	15077
15	Coruña (A)	078	Santiago de Compostela	93903	44038	49865	15078
15	Coruña (A)	079	Santiso	2282	1181	1101	15079
15	Coruña (A)	080	Sobrado	2518	1289	1229	15080
15	Coruña (A)	081	Somozas (As)	1473	734	739	15081
15	Coruña (A)	082	Teo	14447	7072	7375	15082
15	Coruña (A)	083	Toques	1626	841	785	15083
15	Coruña (A)	084	Tordoia	5100	2424	2676	15084
15	Coruña (A)	085	Touro	4865	2386	2479	15085
15	Coruña (A)	086	Trazo	3818	1874	1944	15086
15	Coruña (A)	087	Valdoviño	6790	3354	3436	15087
15	Coruña (A)	088	Val do Dubra	4892	2390	2502	15088
15	Coruña (A)	089	Vedra	5083	2429	2654	15089
15	Coruña (A)	090	Vilasantar	1678	858	820	15090
15	Coruña (A)	091	Vilarmaior	1417	724	693	15091
15	Coruña (A)	092	Vimianzo	8766	4263	4503	15092
15	Coruña (A)	093	Zas	6212	3019	3193	15093
15	Coruña (A)	901	Cariño	5036	2457	2579	15901
16	Cuenca	001	Abia de la Obispalía	85	46	39	16001
16	Cuenca	002	Acebrón (El)	284	142	142	16002
16	Cuenca	003	Alarcón	208	97	111	16003
16	Cuenca	004	Albaladejo del Cuende	411	214	197	16004
16	Cuenca	005	Albalate de las Nogueras	378	201	177	16005
16	Cuenca	006	Albendea	178	90	88	16006
16	Cuenca	007	Alberca de Záncara (La)	1741	857	884	16007
16	Cuenca	008	Alcalá de la Vega	176	94	82	16008
16	Cuenca	009	Alcantud	120	65	55	16009
16	Cuenca	010	Alcázar del Rey	252	124	128	16010
16	Cuenca	011	Alcohujate	68	38	30	16011
16	Cuenca	012	Alconchel de la Estrella	223	115	108	16012
16	Cuenca	013	Algarra	34	17	17	16013
16	Cuenca	014	Aliaguilla	852	449	403	16014
16	Cuenca	015	Almarcha (La)	618	315	303	16015
16	Cuenca	016	Almendros	340	172	168	16016
16	Cuenca	017	Almodóvar del Pinar	520	264	256	16017
16	Cuenca	018	Almonacid del Marquesado	556	287	269	16018
16	Cuenca	019	Altarejos	318	163	155	16019
16	Cuenca	020	Arandilla del Arroyo	45	22	23	16020
16	Cuenca	022	Arcos de la Sierra	126	67	59	16022
16	Cuenca	023	Chillarón de Cuenca	356	192	164	16023
16	Cuenca	024	Arguisuelas	196	102	94	16024
16	Cuenca	025	Arrancacepas	38	20	18	16025
16	Cuenca	026	Atalaya del Cañavate	138	70	68	16026
16	Cuenca	027	Barajas de Melo	732	358	374	16027
16	Cuenca	029	Barchín del Hoyo	131	74	57	16029
16	Cuenca	030	Bascuñana de San Pedro	47	27	20	16030
16	Cuenca	031	Beamud	108	60	48	16031
16	Cuenca	032	Belinchón	362	177	185	16032
16	Cuenca	033	Belmonte	2445	1151	1294	16033
16	Cuenca	034	Belmontejo	268	133	135	16034
16	Cuenca	035	Beteta	427	215	212	16035
16	Cuenca	036	Boniches	200	106	94	16036
16	Cuenca	038	Buciegas	86	41	45	16038
16	Cuenca	039	Buenache de Alarcón	631	326	305	16039
16	Cuenca	040	Buenache de la Sierra	119	71	48	16040
16	Cuenca	041	Buendía	491	238	253	16041
16	Cuenca	042	Campillo de Altobuey	1663	813	850	16042
16	Cuenca	043	Campillos-Paravientos	146	81	65	16043
16	Cuenca	044	Campillos-Sierra	104	57	47	16044
16	Cuenca	045	Canalejas del Arroyo	346	175	171	16045
16	Cuenca	046	Cañada del Hoyo	361	185	176	16046
16	Cuenca	047	Cañada Juncosa	350	187	163	16047
16	Cuenca	048	Cañamares	583	310	273	16048
16	Cuenca	049	Cañavate (El)	251	121	130	16049
16	Cuenca	050	Cañaveras	381	189	192	16050
16	Cuenca	051	Cañaveruelas	240	120	120	16051
16	Cuenca	052	Cañete	892	436	456	16052
16	Cuenca	053	Cañizares	626	331	295	16053
16	Cuenca	055	Carboneras de Guadazaón	1026	540	486	16055
16	Cuenca	056	Cardenete	722	369	353	16056
16	Cuenca	057	Carrascosa	101	63	38	16057
16	Cuenca	058	Carrascosa de Haro	153	77	76	16058
16	Cuenca	060	Casas de Benítez	1116	532	584	16060
16	Cuenca	061	Casas de Fernando Alonso	1431	703	728	16061
16	Cuenca	062	Casas de Garcimolina	36	18	18	16062
16	Cuenca	063	Casas de Guijarro	145	71	74	16063
16	Cuenca	064	Casas de Haro	894	457	437	16064
16	Cuenca	065	Casas de los Pinos	512	254	258	16065
16	Cuenca	066	Casasimarro	3047	1554	1493	16066
16	Cuenca	067	Castejón	226	112	114	16067
16	Cuenca	068	Castillejo de Iniesta	190	103	87	16068
16	Cuenca	070	Castillejo-Sierra	48	24	24	16070
16	Cuenca	071	Castillo-Albaráñez	31	16	15	16071
16	Cuenca	072	Castillo de Garcimuñoz	212	111	101	16072
16	Cuenca	073	Cervera del Llano	341	170	171	16073
16	Cuenca	074	Cierva (La)	60	30	30	16074
16	Cuenca	078	Cuenca	45707	21934	23773	16078
16	Cuenca	079	Cueva del Hierro	52	31	21	16079
16	Cuenca	081	Chumillas	40	26	14	16081
16	Cuenca	082	Enguídanos	573	288	285	16082
16	Cuenca	083	Fresneda de Altarejos	94	53	41	16083
16	Cuenca	084	Fresneda de la Sierra	75	36	39	16084
16	Cuenca	085	Frontera (La)	214	108	106	16085
16	Cuenca	086	Fuente de Pedro Naharro	1218	612	606	16086
16	Cuenca	087	Fuentelespino de Haro	316	168	148	16087
16	Cuenca	088	Fuentelespino de Moya	140	71	69	16088
16	Cuenca	089	Fuentes	506	263	243	16089
16	Cuenca	091	Fuertescusa	112	61	51	16091
16	Cuenca	092	Gabaldón	196	116	80	16092
16	Cuenca	093	Garaballa	146	77	69	16093
16	Cuenca	094	Gascueña	157	73	84	16094
16	Cuenca	095	Graja de Campalbo	134	73	61	16095
16	Cuenca	096	Graja de Iniesta	329	176	153	16096
16	Cuenca	097	Henarejos	265	125	140	16097
16	Cuenca	098	Herrumblar (El)	787	410	377	16098
16	Cuenca	099	Hinojosa (La)	340	166	174	16099
16	Cuenca	100	Hinojosos (Los)	1079	530	549	16100
16	Cuenca	101	Hito (El)	236	118	118	16101
16	Cuenca	102	Honrubia	1632	809	823	16102
16	Cuenca	103	Hontanaya	453	223	230	16103
16	Cuenca	104	Hontecillas	94	43	51	16104
16	Cuenca	106	Horcajo de Santiago	3585	1792	1793	16106
16	Cuenca	107	Huélamo	142	76	66	16107
16	Cuenca	108	Huelves	70	28	42	16108
16	Cuenca	109	Huérguina	130	67	63	16109
16	Cuenca	110	Huerta de la Obispalía	155	88	67	16110
16	Cuenca	111	Huerta del Marquesado	230	134	96	16111
16	Cuenca	112	Huete	2229	1131	1098	16112
16	Cuenca	113	Iniesta	3945	1976	1969	16113
16	Cuenca	115	Laguna del Marquesado	76	41	35	16115
16	Cuenca	116	Lagunaseca	123	55	68	16116
16	Cuenca	117	Landete	1541	767	774	16117
16	Cuenca	118	Ledaña	1902	939	963	16118
16	Cuenca	119	Leganiel	230	115	115	16119
16	Cuenca	121	Majadas (Las)	373	182	191	16121
16	Cuenca	122	Mariana	317	151	166	16122
16	Cuenca	123	Masegosa	127	69	58	16123
16	Cuenca	124	Mesas (Las)	2469	1263	1206	16124
16	Cuenca	125	Minglanilla	2265	1151	1114	16125
16	Cuenca	126	Mira	1185	605	580	16126
16	Cuenca	128	Monreal del Llano	83	42	41	16128
16	Cuenca	129	Montalbanejo	197	91	106	16129
16	Cuenca	130	Montalbo	754	388	366	16130
16	Cuenca	131	Monteagudo de las Salinas	134	80	54	16131
16	Cuenca	132	Mota de Altarejos	61	38	23	16132
16	Cuenca	133	Mota del Cuervo	5540	2746	2794	16133
16	Cuenca	134	Motilla del Palancar	5169	2616	2553	16134
16	Cuenca	135	Moya	317	172	145	16135
16	Cuenca	137	Narboneta	120	56	64	16137
16	Cuenca	139	Olivares de Júcar	561	292	269	16139
16	Cuenca	140	Olmeda de la Cuesta	49	26	23	16140
16	Cuenca	141	Olmeda del Rey	248	119	129	16141
16	Cuenca	142	Olmedilla de Alarcón	179	93	86	16142
16	Cuenca	143	Olmedilla de Eliz	31	17	14	16143
16	Cuenca	145	Osa de la Vega	643	317	326	16145
16	Cuenca	146	Pajarón	140	73	67	16146
16	Cuenca	147	Pajaroncillo	97	49	48	16147
16	Cuenca	148	Palomares del Campo	1007	493	514	16148
16	Cuenca	149	Palomera	165	77	88	16149
16	Cuenca	150	Paracuellos	155	70	85	16150
16	Cuenca	151	Paredes	78	39	39	16151
16	Cuenca	152	Parra de las Vegas (La)	62	34	28	16152
16	Cuenca	153	Pedernoso (El)	1321	660	661	16153
16	Cuenca	154	Pedroñeras (Las)	6460	3303	3157	16154
16	Cuenca	155	Peral (El)	730	369	361	16155
16	Cuenca	156	Peraleja (La)	171	83	88	16156
16	Cuenca	157	Pesquera (La)	282	146	136	16157
16	Cuenca	158	Picazo (El)	709	346	363	16158
16	Cuenca	159	Pinarejo	409	206	203	16159
16	Cuenca	160	Pineda de Gigüela	150	81	69	16160
16	Cuenca	161	Piqueras del Castillo	81	46	35	16161
16	Cuenca	162	Portalrubio de Guadamejud	90	43	47	16162
16	Cuenca	163	Portilla	93	46	47	16163
16	Cuenca	165	Poyatos	115	65	50	16165
16	Cuenca	166	Pozoamargo	328	155	173	16166
16	Cuenca	167	Pozorrubio	501	238	263	16167
16	Cuenca	169	Pozuelo (El)	88	46	42	16169
16	Cuenca	170	Priego	1035	524	511	16170
16	Cuenca	171	Provencio (El)	2555	1276	1279	16171
16	Cuenca	172	Puebla de Almenara	550	284	266	16172
16	Cuenca	173	Puebla de Don Francisco	369	182	187	16173
16	Cuenca	174	Puebla del Salvador	286	153	133	16174
16	Cuenca	175	Quintanar del Rey	6175	3150	3025	16175
16	Cuenca	176	Rada de Haro	62	30	32	16176
16	Cuenca	177	Reíllo	144	72	72	16177
16	Cuenca	181	Rozalén del Monte	120	52	68	16181
16	Cuenca	185	Saceda-Trasierra	98	53	45	16185
16	Cuenca	186	Saelices	672	341	331	16186
16	Cuenca	187	Salinas del Manzano	118	67	51	16187
16	Cuenca	188	Salmeroncillos	184	90	94	16188
16	Cuenca	189	Salvacañete	336	184	152	16189
16	Cuenca	190	San Clemente	6368	3165	3203	16190
16	Cuenca	191	San Lorenzo de la Parrilla	1438	720	718	16191
16	Cuenca	192	San Martín de Boniches	99	49	50	16192
16	Cuenca	193	San Pedro Palmiches	96	49	47	16193
16	Cuenca	194	Santa Cruz de Moya	416	211	205	16194
16	Cuenca	195	Santa María del Campo Rus	764	383	381	16195
16	Cuenca	196	Santa María de los Llanos	845	434	411	16196
16	Cuenca	197	Santa María del Val	122	68	54	16197
16	Cuenca	198	Sisante	1799	899	900	16198
16	Cuenca	199	Solera de Gabaldón	53	26	27	16199
16	Cuenca	202	Talayuelas	1181	613	568	16202
16	Cuenca	203	Tarancón	11490	5672	5818	16203
16	Cuenca	204	Tébar	403	214	189	16204
16	Cuenca	205	Tejadillos	165	84	81	16205
16	Cuenca	206	Tinajas	365	195	170	16206
16	Cuenca	209	Torralba	187	96	91	16209
16	Cuenca	211	Torrejoncillo del Rey	695	327	368	16211
16	Cuenca	212	Torrubia del Campo	357	171	186	16212
16	Cuenca	213	Torrubia del Castillo	41	21	20	16213
16	Cuenca	215	Tragacete	364	199	165	16215
16	Cuenca	216	Tresjuncos	498	254	244	16216
16	Cuenca	217	Tribaldos	144	63	81	16217
16	Cuenca	218	Uclés	313	148	165	16218
16	Cuenca	219	Uña	141	73	68	16219
16	Cuenca	224	Valdemeca	109	57	52	16224
16	Cuenca	225	Valdemorillo de la Sierra	99	54	45	16225
16	Cuenca	227	Valdemoro-Sierra	202	110	92	16227
16	Cuenca	228	Valdeolivas	289	153	136	16228
16	Cuenca	231	Valhermoso de la Fuente	58	28	30	16231
16	Cuenca	234	Valsalobre	64	32	32	16234
16	Cuenca	236	Valverde de Júcar	1407	702	705	16236
16	Cuenca	237	Valverdejo	153	78	75	16237
16	Cuenca	238	Vara de Rey	686	343	343	16238
16	Cuenca	239	Vega del Codorno	229	119	110	16239
16	Cuenca	240	Vellisca	178	88	90	16240
16	Cuenca	242	Villaconejos de Trabaque	513	263	250	16242
16	Cuenca	243	Villaescusa de Haro	595	295	300	16243
16	Cuenca	244	Villagarcía del Llano	967	479	488	16244
16	Cuenca	245	Villalba de la Sierra	547	286	261	16245
16	Cuenca	246	Villalba del Rey	698	353	345	16246
16	Cuenca	247	Villalgordo del Marquesado	126	62	64	16247
16	Cuenca	248	Villalpardo	1120	578	542	16248
16	Cuenca	249	Villamayor de Santiago	2716	1344	1372	16249
16	Cuenca	250	Villanueva de Guadamejud	125	60	65	16250
16	Cuenca	251	Villanueva de la Jara	2483	1256	1227	16251
16	Cuenca	253	Villar de Cañas	446	215	231	16253
16	Cuenca	254	Villar de Domingo García	288	145	143	16254
16	Cuenca	255	Villar de la Encina	237	117	120	16255
16	Cuenca	258	Villar del Humo	466	247	219	16258
16	Cuenca	259	Villar del Infantado	44	25	19	16259
16	Cuenca	263	Villar de Olalla	920	471	449	16263
16	Cuenca	264	Villarejo de Fuentes	809	384	425	16264
16	Cuenca	265	Villarejo de la Peñuela	32	15	17	16265
16	Cuenca	266	Villarejo-Periesteban	545	275	270	16266
16	Cuenca	269	Villares del Saz	698	354	344	16269
16	Cuenca	270	Villarrubio	256	134	122	16270
16	Cuenca	271	Villarta	818	428	390	16271
16	Cuenca	272	Villas de la Ventosa	374	201	173	16272
16	Cuenca	273	Villaverde y Pasaconsol	434	209	225	16273
16	Cuenca	274	Víllora	238	119	119	16274
16	Cuenca	275	Vindel	20	13	7	16275
16	Cuenca	276	Yémeda	32	14	18	16276
16	Cuenca	277	Zafra de Záncara	201	103	98	16277
16	Cuenca	278	Zafrilla	132	60	72	16278
16	Cuenca	279	Zarza de Tajo	270	126	144	16279
16	Cuenca	280	Zarzuela	295	148	147	16280
16	Cuenca	901	Campos del Paraíso	1107	518	589	16901
16	Cuenca	902	Valdetórtola	141	79	62	16902
16	Cuenca	903	Valeras (Las)	1352	668	684	16903
16	Cuenca	904	Fuentenava de Jábaga	390	197	193	16904
16	Cuenca	905	Arcas del Villar	681	347	334	16905
16	Cuenca	906	Valdecolmenas (Los)	121	66	55	16906
16	Cuenca	908	Pozorrubielos de la Mancha	301	152	149	16908
16	Cuenca	909	Sotorribas	1021	506	515	16909
16	Cuenca	910	Villar y Velasco	123	68	55	16910
17	Girona	001	Agullana	655	332	323	17001
17	Girona	002	Aiguaviva	515	261	254	17002
17	Girona	003	Albanyà	128	68	60	17003
17	Girona	004	Albons	572	300	272	17004
17	Girona	005	Far d'Empordà (El)	387	202	185	17005
17	Girona	006	Alp	1194	620	574	17006
17	Girona	007	Amer	2220	1092	1128	17007
17	Girona	008	Anglès	5009	2527	2482	17008
17	Girona	009	Arbúcies	5026	2543	2483	17009
17	Girona	010	Argelaguer	379	206	173	17010
17	Girona	011	Armentera (L')	756	375	381	17011
17	Girona	012	Avinyonet de Puigventós	618	315	303	17012
17	Girona	013	Begur	3411	1729	1682	17013
17	Girona	014	Vajol (La)	96	50	46	17014
17	Girona	015	Banyoles	15084	7410	7674	17015
17	Girona	016	Bàscara	822	422	400	17016
17	Girona	018	Bellcaire d'Empordà	535	274	261	17018
17	Girona	019	Besalú	1996	971	1025	17019
17	Girona	020	Bescanó	3187	1603	1584	17020
17	Girona	021	Beuda	133	73	60	17021
17	Girona	022	Bisbal d'Empordà (La)	8264	4070	4194	17022
17	Girona	023	Blanes	30441	15272	15169	17023
17	Girona	024	Bolvir	284	144	140	17024
17	Girona	025	Bordils	1383	697	686	17025
17	Girona	026	Borrassà	533	268	265	17026
17	Girona	027	Breda	3345	1717	1628	17027
17	Girona	028	Brunyola	383	195	188	17028
17	Girona	029	Boadella d'Empordà	219	110	109	17029
17	Girona	030	Cabanes	798	409	389	17030
17	Girona	031	Cabanelles	226	129	97	17031
17	Girona	032	Cadaqués	2301	1117	1184	17032
17	Girona	033	Caldes de Malavella	4031	2038	1993	17033
17	Girona	034	Calonge	6783	3398	3385	17034
17	Girona	035	Camós	637	327	310	17035
17	Girona	036	Campdevànol	3370	1652	1718	17036
17	Girona	037	Campelles	125	67	58	17037
17	Girona	038	Campllong	307	158	149	17038
17	Girona	039	Camprodon	2319	1138	1181	17039
17	Girona	040	Canet d'Adri	519	270	249	17040
17	Girona	041	Cantallops	267	136	131	17041
17	Girona	042	Capmany	409	203	206	17042
17	Girona	043	Queralbs	201	115	86	17043
17	Girona	044	Cassà de la Selva	7692	3834	3858	17044
17	Girona	046	Castellfollit de la Roca	963	478	485	17046
17	Girona	047	Castelló d'Empúries	6266	3202	3064	17047
17	Girona	048	Castell-Platja d'Aro	6688	3382	3306	17048
17	Girona	049	Celrà	2635	1293	1342	17049
17	Girona	050	Cervià de Ter	607	306	301	17050
17	Girona	051	Cistella	231	115	116	17051
17	Girona	052	Siurana	159	80	79	17052
17	Girona	054	Colera	592	310	282	17054
17	Girona	055	Colomers	196	100	96	17055
17	Girona	056	Cornellà del Terri	1921	963	958	17056
17	Girona	057	Corçà	1153	574	579	17057
17	Girona	058	Crespià	205	102	103	17058
17	Girona	060	Darnius	517	275	242	17060
17	Girona	061	Das	158	85	73	17061
17	Girona	062	Escala (L')	6285	3155	3130	17062
17	Girona	063	Espinelves	179	90	89	17063
17	Girona	064	Espolla	373	187	186	17064
17	Girona	065	Esponellà	402	200	202	17065
17	Girona	066	Figueres	34023	16529	17494	17066
17	Girona	067	Flaçà	845	417	428	17067
17	Girona	068	Foixà	322	155	167	17068
17	Girona	069	Fontanals de Cerdanya	399	197	202	17069
17	Girona	070	Fontanilles	153	83	70	17070
17	Girona	071	Fontcoberta	1110	553	557	17071
17	Girona	073	Fornells de la Selva	1489	723	766	17073
17	Girona	074	Fortià	525	259	266	17074
17	Girona	075	Garrigàs	339	182	157	17075
17	Girona	076	Garrigoles	150	81	69	17076
17	Girona	077	Garriguella	726	369	357	17077
17	Girona	078	Ger	375	200	175	17078
17	Girona	079	Girona	73637	35415	38222	17079
17	Girona	080	Gombrèn	235	113	122	17080
17	Girona	081	Gualta	293	150	143	17081
17	Girona	082	Guils de Cerdanya	334	164	170	17082
17	Girona	083	Hostalric	2901	1420	1481	17083
17	Girona	084	Isòvol	204	113	91	17084
17	Girona	085	Jafre	317	163	154	17085
17	Girona	086	Jonquera (La)	2565	1288	1277	17086
17	Girona	087	Juià	266	123	143	17087
17	Girona	088	Lladó	502	257	245	17088
17	Girona	089	Llagostera	5769	2927	2842	17089
17	Girona	090	Llambilles	472	242	230	17090
17	Girona	091	Llanars	489	249	240	17091
17	Girona	092	Llançà	4063	2007	2056	17092
17	Girona	093	Llers	954	484	470	17093
17	Girona	094	Llívia	1013	535	478	17094
17	Girona	095	Lloret de Mar	20045	10081	9964	17095
17	Girona	096	Llosses (Les)	275	147	128	17096
17	Girona	097	Madremanya	185	83	102	17097
17	Girona	098	Maià de Montcal	321	160	161	17098
17	Girona	099	Meranges	83	49	34	17099
17	Girona	100	Masarac	245	119	126	17100
17	Girona	101	Massanes	542	288	254	17101
17	Girona	102	Maçanet de Cabrenys	664	342	322	17102
17	Girona	103	Maçanet de la Selva	3814	1953	1861	17103
17	Girona	105	Mieres	336	163	173	17105
17	Girona	106	Mollet de Peralada	189	104	85	17106
17	Girona	107	Molló	339	174	165	17107
17	Girona	109	Montagut	792	409	383	17109
17	Girona	110	Mont-ras	1644	871	773	17110
17	Girona	111	Navata	708	349	359	17111
17	Girona	112	Ogassa	242	142	100	17112
17	Girona	114	Olot	27967	13521	14446	17114
17	Girona	115	Ordis	285	151	134	17115
17	Girona	116	Osor	464	250	214	17116
17	Girona	117	Palafrugell	18154	9126	9028	17117
17	Girona	118	Palamós	14959	7386	7573	17118
17	Girona	119	Palau de Santa Eulàlia	90	54	36	17119
17	Girona	120	Palau-saverdera	931	467	464	17120
17	Girona	121	Palau-sator	293	152	141	17121
17	Girona	123	Palol de Revardit	386	201	185	17123
17	Girona	124	Pals	1912	975	937	17124
17	Girona	125	Pardines	143	72	71	17125
17	Girona	126	Parlavà	330	171	159	17126
17	Girona	128	Pau	417	210	207	17128
17	Girona	129	Pedret i Marzà	127	65	62	17129
17	Girona	130	Pera (La)	367	187	180	17130
17	Girona	132	Peralada	1277	651	626	17132
17	Girona	133	Planes d'Hostoles (Les)	1724	855	869	17133
17	Girona	134	Planoles	273	142	131	17134
17	Girona	135	Pont de Molins	430	230	200	17135
17	Girona	136	Pontós	217	121	96	17136
17	Girona	137	Porqueres	3622	1780	1842	17137
17	Girona	138	Portbou	1511	761	750	17138
17	Girona	139	Preses (Les)	1373	668	705	17139
17	Girona	140	Port de la Selva (El)	877	440	437	17140
17	Girona	141	Puigcerdà	6902	3529	3373	17141
17	Girona	142	Quart	2402	1231	1171	17142
17	Girona	143	Rabós	145	69	76	17143
17	Girona	144	Regencós	287	166	121	17144
17	Girona	145	Ribes de Freser	2096	1017	1079	17145
17	Girona	146	Riells i Viabrea	2043	1073	970	17146
17	Girona	147	Ripoll	10733	5180	5553	17147
17	Girona	148	Riudarenes	1302	678	624	17148
17	Girona	149	Riudaura	417	210	207	17149
17	Girona	150	Riudellots de la Selva	1548	796	752	17150
17	Girona	151	Riumors	192	95	97	17151
17	Girona	152	Roses	12857	6502	6355	17152
17	Girona	153	Rupià	190	101	89	17153
17	Girona	154	Sales de Llierca	89	49	40	17154
17	Girona	155	Salt	22017	10935	11082	17155
17	Girona	157	Sant Andreu Salou	138	65	73	17157
17	Girona	158	Sant Climent Sescebes	404	204	200	17158
17	Girona	159	Sant Feliu de Buixalleu	727	387	340	17159
17	Girona	160	Sant Feliu de Guíxols	18403	9031	9372	17160
17	Girona	161	Sant Feliu de Pallerols	1155	564	591	17161
17	Girona	162	Sant Ferriol	196	110	86	17162
17	Girona	163	Sant Gregori	2335	1213	1122	17163
17	Girona	164	Sant Hilari Sacalm	4985	2543	2442	17164
17	Girona	165	Sant Jaume de Llierca	714	352	362	17165
17	Girona	166	Sant Jordi Desvalls	587	302	285	17166
17	Girona	167	Sant Joan de les Abadesses	3672	1810	1862	17167
17	Girona	168	Sant Joan de Mollet	354	171	183	17168
17	Girona	169	Sant Julià de Ramis	2018	1016	1002	17169
17	Girona	170	Vallfogona de Ripollès	219	114	105	17170
17	Girona	171	Sant Llorenç de la Muga	182	86	96	17171
17	Girona	172	Sant Martí de Llémena	478	245	233	17172
17	Girona	173	Sant Martí Vell	161	82	79	17173
17	Girona	174	Sant Miquel de Campmajor	206	116	90	17174
17	Girona	175	Sant Miquel de Fluvià	625	318	307	17175
17	Girona	176	Sant Mori	158	75	83	17176
17	Girona	177	Sant Pau de Segúries	655	333	322	17177
17	Girona	178	Sant Pere Pescador	1428	788	640	17178
17	Girona	180	Santa Coloma de Farners	8867	4510	4357	17180
17	Girona	181	Santa Cristina d'Aro	2902	1518	1384	17181
17	Girona	182	Santa Llogaia d'Àlguema	300	157	143	17182
17	Girona	183	Sant Aniol de Finestres	270	148	122	17183
17	Girona	184	Santa Pau	1484	755	729	17184
17	Girona	185	Sant Joan les Fonts	2756	1364	1392	17185
17	Girona	186	Sarrià de Ter	3457	1711	1746	17186
17	Girona	187	Saus	688	340	348	17187
17	Girona	188	Selva de Mar (La)	190	96	94	17188
17	Girona	189	Cellera de Ter (La)	2019	1002	1017	17189
17	Girona	190	Serinyà	837	436	401	17190
17	Girona	191	Serra de Daró	186	95	91	17191
17	Girona	192	Setcases	163	87	76	17192
17	Girona	193	Sils	3078	1558	1520	17193
17	Girona	194	Susqueda	87	49	38	17194
17	Girona	195	Tallada d'Empordà (La)	332	173	159	17195
17	Girona	196	Terrades	200	95	105	17196
17	Girona	197	Torrent	172	84	88	17197
17	Girona	198	Torroella de Fluvià	319	180	139	17198
17	Girona	199	Torroella de Montgrí	8454	4281	4173	17199
17	Girona	200	Tortellà	717	363	354	17200
17	Girona	201	Toses	151	87	64	17201
17	Girona	202	Tossa de Mar	4195	2083	2112	17202
17	Girona	203	Ultramort	203	114	89	17203
17	Girona	204	Ullà	814	425	389	17204
17	Girona	205	Ullastret	234	122	112	17205
17	Girona	206	Urús	188	101	87	17206
17	Girona	207	Vall d'en Bas (La)	2552	1311	1241	17207
17	Girona	208	Vall de Bianya (La)	1130	569	561	17208
17	Girona	209	Vall-llobrega	377	141	236	17209
17	Girona	210	Ventalló	608	317	291	17210
17	Girona	211	Verges	1134	566	568	17211
17	Girona	212	Vidrà	158	78	80	17212
17	Girona	213	Vidreres	4740	2405	2335	17213
17	Girona	214	Vilabertran	784	397	387	17214
17	Girona	215	Vilablareix	1842	916	926	17215
17	Girona	216	Viladasens	185	96	89	17216
17	Girona	217	Viladamat	417	221	196	17217
17	Girona	218	Vilademuls	720	365	355	17218
17	Girona	220	Viladrau	856	426	430	17220
17	Girona	221	Vilafant	4100	2047	2053	17221
17	Girona	222	Vilaür	125	72	53	17222
17	Girona	223	Vilajuïga	953	474	479	17223
17	Girona	224	Vilallonga de Ter	421	232	189	17224
17	Girona	225	Vilamacolum	261	138	123	17225
17	Girona	226	Vilamalla	761	408	353	17226
17	Girona	227	Vilamaniscle	120	65	55	17227
17	Girona	228	Vilanant	308	155	153	17228
17	Girona	230	Vila-sacra	383	190	193	17230
17	Girona	232	Vilopriu	161	83	78	17232
17	Girona	233	Vilobí d'Onyar	2223	1170	1053	17233
17	Girona	234	Biure	217	107	110	17234
17	Girona	901	"Cruïlles	 Monells i Sant Sadurní de l'Heura"	1096	543	553	17901
17	Girona	902	Forallac	1650	809	841	17902
17	Girona	903	Sant Julià del Llor i Bonmatí	921	467	454	17903
18	Granada	001	Agrón	392	202	190	18001
18	Granada	002	Alamedilla	898	455	443	18002
18	Granada	003	Albolote	13048	6546	6502	18003
18	Granada	004	Albondón	996	495	501	18004
18	Granada	005	Albuñán	474	237	237	18005
18	Granada	006	Albuñol	5462	2733	2729	18006
18	Granada	007	Albuñuelas	1215	632	583	18007
18	Granada	010	Aldeire	785	398	387	18010
18	Granada	011	Alfacar	4300	2179	2121	18011
18	Granada	012	Algarinejo	5269	2701	2568	18012
18	Granada	013	Alhama de Granada	5927	2986	2941	18013
18	Granada	014	Alhendín	4224	2141	2083	18014
18	Granada	015	Alicún de Ortega	672	356	316	18015
18	Granada	016	Almegíjar	427	219	208	18016
18	Granada	017	Almuñécar	21275	10498	10777	18017
18	Granada	018	Alquife	897	451	446	18018
18	Granada	020	Arenas del Rey	1979	1033	946	18020
18	Granada	021	Armilla	14030	6927	7103	18021
18	Granada	022	Atarfe	10975	5430	5545	18022
18	Granada	023	Baza	20818	10261	10557	18023
18	Granada	024	Beas de Granada	968	505	463	18024
18	Granada	025	Beas de Guadix	375	195	180	18025
18	Granada	027	Benalúa	3241	1627	1614	18027
18	Granada	028	Benalúa de las Villas	1450	721	729	18028
18	Granada	029	Benamaurel	2410	1227	1183	18029
18	Granada	030	Bérchules	789	417	372	18030
18	Granada	032	Bubión	378	186	192	18032
18	Granada	033	Busquístar	363	196	167	18033
18	Granada	034	Cacín	796	399	397	18034
18	Granada	035	Cádiar	1588	820	768	18035
18	Granada	036	Cájar	3239	1545	1694	18036
18	Granada	037	Calicasas	586	294	292	18037
18	Granada	038	Campotéjar	1444	738	706	18038
18	Granada	039	Caniles	4886	2404	2482	18039
18	Granada	040	Cáñar	340	162	178	18040
18	Granada	042	Capileira	524	252	272	18042
18	Granada	043	Carataunas	196	101	95	18043
18	Granada	044	Cástaras	291	153	138	18044
18	Granada	045	Castilléjar	1760	855	905	18045
18	Granada	046	Castril	2883	1470	1413	18046
18	Granada	047	Cenes de la Vega	5193	2647	2546	18047
18	Granada	048	Cijuela	1537	762	775	18048
18	Granada	049	Cogollos de Guadix	746	388	358	18049
18	Granada	050	Cogollos de la Vega	1972	1006	966	18050
18	Granada	051	Colomera	1610	819	791	18051
18	Granada	053	Cortes de Baza	2717	1375	1342	18053
18	Granada	054	Cortes y Graena	1073	554	519	18054
18	Granada	056	Cúllar	4836	2403	2433	18056
18	Granada	057	Cúllar Vega	3499	1754	1745	18057
18	Granada	059	Chauchina	4124	2032	2092	18059
18	Granada	061	Chimeneas	1518	772	746	18061
18	Granada	062	Churriana de la Vega	7056	3478	3578	18062
18	Granada	063	Darro	1488	739	749	18063
18	Granada	064	Dehesas de Guadix	641	321	320	18064
18	Granada	066	Deifontes	2369	1181	1188	18066
18	Granada	067	Diezma	907	476	431	18067
18	Granada	068	Dílar	1474	732	742	18068
18	Granada	069	Dólar	613	298	315	18069
18	Granada	070	Dúdar	272	137	135	18070
18	Granada	071	Dúrcal	5571	2736	2835	18071
18	Granada	072	Escúzar	828	419	409	18072
18	Granada	074	Ferreira	361	176	185	18074
18	Granada	076	Fonelas	1187	589	598	18076
18	Granada	078	Freila	962	485	477	18078
18	Granada	079	Fuente Vaqueros	3960	1952	2008	18079
18	Granada	082	Galera	1309	652	657	18082
18	Granada	083	Gobernador	356	174	182	18083
18	Granada	084	Gójar	3584	1851	1733	18084
18	Granada	085	Gor	1158	582	576	18085
18	Granada	086	Gorafe	557	269	288	18086
18	Granada	087	Granada	244486	113780	130706	18087
18	Granada	088	Guadahortuna	2262	1167	1095	18088
18	Granada	089	Guadix	19542	9606	9936	18089
18	Granada	093	Gualchos	2970	1497	1473	18093
18	Granada	094	Güejar Sierra	2702	1385	1317	18094
18	Granada	095	Güevéjar	1549	779	770	18095
18	Granada	096	Huélago	561	292	269	18096
18	Granada	097	Huéneja	1220	606	614	18097
18	Granada	098	Huéscar	8065	3981	4084	18098
18	Granada	099	Huétor de Santillán	1645	852	793	18099
18	Granada	100	Huétor Tájar	8206	4077	4129	18100
18	Granada	101	Huétor Vega	8870	4469	4401	18101
18	Granada	102	Illora	10495	5270	5225	18102
18	Granada	103	Itrabo	1021	496	525	18103
18	Granada	105	Iznalloz	6964	3505	3459	18105
18	Granada	107	Jayena	1342	676	666	18107
18	Granada	108	Jerez del Marquesado	1106	551	555	18108
18	Granada	109	Jete	765	361	404	18109
18	Granada	111	Jun	1779	903	876	18111
18	Granada	112	Juviles	177	90	87	18112
18	Granada	114	Calahorra (La)	888	436	452	18114
18	Granada	115	Láchar	2426	1221	1205	18115
18	Granada	116	Lanjarón	3802	1868	1934	18116
18	Granada	117	Lanteira	599	303	296	18117
18	Granada	119	Lecrín	2293	1132	1161	18119
18	Granada	120	Lentegí	343	162	181	18120
18	Granada	121	Lobras	173	85	88	18121
18	Granada	122	Loja	19701	9777	9924	18122
18	Granada	123	Lugros	406	201	205	18123
18	Granada	124	Lújar	535	284	251	18124
18	Granada	126	Malahá (La)	1658	836	822	18126
18	Granada	127	Maracena	14651	7275	7376	18127
18	Granada	128	Marchal	405	190	215	18128
18	Granada	132	Moclín	4436	2178	2258	18132
18	Granada	133	Molvízar	2722	1335	1387	18133
18	Granada	134	Monachil	5199	2653	2546	18134
18	Granada	135	Montefrío	6794	3400	3394	18135
18	Granada	136	Montejícar	2825	1421	1404	18136
18	Granada	137	Montillana	1378	692	686	18137
18	Granada	138	Moraleda de Zafayona	2736	1402	1334	18138
18	Granada	140	Motril	50172	24742	25430	18140
18	Granada	141	Murtas	797	412	385	18141
18	Granada	143	Nigüelas	1100	557	543	18143
18	Granada	144	Nívar	663	337	326	18144
18	Granada	145	Ogíjares	8798	4452	4346	18145
18	Granada	146	Orce	1440	713	727	18146
18	Granada	147	Órgiva	5035	2512	2523	18147
18	Granada	148	Otívar	1043	524	519	18148
18	Granada	149	Otura	4306	2150	2156	18149
18	Granada	150	Padul	6766	3380	3386	18150
18	Granada	151	Pampaneira	345	176	169	18151
18	Granada	152	Pedro Martínez	1373	683	690	18152
18	Granada	153	Peligros	7401	3700	3701	18153
18	Granada	154	Peza (La)	1433	753	680	18154
18	Granada	157	Pinos Genil	1181	611	570	18157
18	Granada	158	Pinos Puente	13368	6759	6609	18158
18	Granada	159	Píñar	1329	690	639	18159
18	Granada	161	Polícar	296	157	139	18161
18	Granada	162	Polopos	1225	628	597	18162
18	Granada	163	Pórtugos	451	218	233	18163
18	Granada	164	Puebla de Don Fadrique	2478	1233	1245	18164
18	Granada	165	Pulianas	3973	2042	1931	18165
18	Granada	167	Purullena	2427	1190	1237	18167
18	Granada	168	Quéntar	1086	543	543	18168
18	Granada	170	Rubite	389	204	185	18170
18	Granada	171	Salar	2781	1377	1404	18171
18	Granada	173	Salobreña	10168	5051	5117	18173
18	Granada	174	Santa Cruz del Comercio	539	277	262	18174
18	Granada	175	Santa Fe	12730	6297	6433	18175
18	Granada	176	Soportújar	268	143	125	18176
18	Granada	177	Sorvilán	633	325	308	18177
18	Granada	178	Torre-Cardela	1176	583	593	18178
18	Granada	179	Torvizcón	916	463	453	18179
18	Granada	180	Trevélez	762	404	358	18180
18	Granada	181	Turón	359	201	158	18181
18	Granada	182	Ugíjar	2464	1233	1231	18182
18	Granada	183	Válor	921	464	457	18183
18	Granada	184	Vélez de Benaudalla	2467	1210	1257	18184
18	Granada	185	Ventas de Huelma	653	327	326	18185
18	Granada	187	Villanueva de las Torres	903	470	433	18187
18	Granada	188	Villanueva Mesía	1954	963	991	18188
18	Granada	189	Víznar	745	398	347	18189
18	Granada	192	Zafarraya	2176	1138	1038	18192
18	Granada	193	Zubia (La)	12850	6317	6533	18193
18	Granada	194	Zújar	2752	1407	1345	18194
18	Granada	901	Taha (La)	789	396	393	18901
18	Granada	902	Valle (El)	1283	626	657	18902
18	Granada	903	Nevada	1375	698	677	18903
18	Granada	904	Alpujarra de la Sierra	1191	598	593	18904
18	Granada	905	Gabias (Las)	8577	4348	4229	18905
18	Granada	906	Guajares (Los)	1292	673	619	18906
18	Granada	907	Valle del Zalabí	2320	1142	1178	18907
18	Granada	908	Villamena	995	473	522	18908
18	Granada	909	Morelábor	942	490	452	18909
18	Granada	910	Pinar (El)	1198	611	587	18910
18	Granada	911	Vegas del Genil	2893	1452	1441	18911
18	Granada	912	Cuevas del Campo	2161	1066	1095	18912
18	Granada	913	Zagra	1151	572	579	18913
19	Guadalajara	001	Abánades	116	66	50	19001
19	Guadalajara	002	Ablanque	153	77	76	19002
19	Guadalajara	003	Adobes	41	20	21	19003
19	Guadalajara	004	Alaminos	81	38	43	19004
19	Guadalajara	005	Alarilla	136	83	53	19005
19	Guadalajara	006	Albalate de Zorita	910	493	417	19006
19	Guadalajara	007	Albares	484	243	241	19007
19	Guadalajara	008	Albendiego	46	26	20	19008
19	Guadalajara	009	Alcocer	313	157	156	19009
19	Guadalajara	010	Alcolea de las Peñas	29	15	14	19010
19	Guadalajara	011	Alcolea del Pinar	413	208	205	19011
19	Guadalajara	013	Alcoroches	182	102	80	19013
19	Guadalajara	015	Aldeanueva de Guadalajara	104	45	59	19015
19	Guadalajara	016	Algar de Mesa	80	43	37	19016
19	Guadalajara	017	Algora	124	67	57	19017
19	Guadalajara	018	Alhóndiga	225	124	101	19018
19	Guadalajara	019	Alique	40	13	27	19019
19	Guadalajara	020	Almadrones	97	64	33	19020
19	Guadalajara	021	Almoguera	1009	522	487	19021
19	Guadalajara	022	Almonacid de Zorita	870	413	457	19022
19	Guadalajara	023	Alocén	146	67	79	19023
19	Guadalajara	024	Alovera	1864	967	897	19024
19	Guadalajara	027	Alustante	253	139	114	19027
19	Guadalajara	031	Angón	45	25	20	19031
19	Guadalajara	032	Anguita	275	142	133	19032
19	Guadalajara	033	Anquela del Ducado	94	50	44	19033
19	Guadalajara	034	Anquela del Pedregal	24	15	9	19034
19	Guadalajara	036	Aranzueque	378	184	194	19036
19	Guadalajara	037	Arbancón	217	117	100	19037
19	Guadalajara	038	Arbeteta	87	41	46	19038
19	Guadalajara	039	Argecilla	107	64	43	19039
19	Guadalajara	040	Armallones	63	36	27	19040
19	Guadalajara	041	Armuña de Tajuña	108	60	48	19041
19	Guadalajara	042	Arroyo de las Fraguas	42	22	20	19042
19	Guadalajara	043	Atanzón	98	57	41	19043
19	Guadalajara	044	Atienza	465	245	220	19044
19	Guadalajara	045	Auñón	255	134	121	19045
19	Guadalajara	046	Azuqueca de Henares	19491	9898	9593	19046
19	Guadalajara	047	Baides	80	40	40	19047
19	Guadalajara	048	Baños de Tajo	29	18	11	19048
19	Guadalajara	049	Bañuelos	31	18	13	19049
19	Guadalajara	050	Barriopedro	32	13	19	19050
19	Guadalajara	051	Berninches	117	66	51	19051
19	Guadalajara	052	Bodera (La)	56	31	25	19052
19	Guadalajara	053	Brihuega	2895	1491	1404	19053
19	Guadalajara	054	Budia	281	154	127	19054
19	Guadalajara	055	Bujalaro	88	46	42	19055
19	Guadalajara	057	Bustares	95	55	40	19057
19	Guadalajara	058	Cabanillas del Campo	2717	1397	1320	19058
19	Guadalajara	059	Campillo de Dueñas	132	76	56	19059
19	Guadalajara	060	Campillo de Ranas	152	83	69	19060
19	Guadalajara	061	Campisábalos	76	34	42	19061
19	Guadalajara	064	Canredondo	103	51	52	19064
19	Guadalajara	065	Cantalojas	158	83	75	19065
19	Guadalajara	066	Cañizar	104	48	56	19066
19	Guadalajara	067	Cardoso de la Sierra (El)	93	60	33	19067
19	Guadalajara	070	Casa de Uceda	108	55	53	19070
19	Guadalajara	071	Casar (El)	3404	1758	1646	19071
19	Guadalajara	073	Casas de San Galindo	35	21	14	19073
19	Guadalajara	074	Caspueñas	79	47	32	19074
19	Guadalajara	075	Castejón de Henares	107	58	49	19075
19	Guadalajara	076	Castellar de la Muela	55	27	28	19076
19	Guadalajara	078	Castilforte	47	27	20	19078
19	Guadalajara	079	Castilnuevo	11	5	6	19079
19	Guadalajara	080	Cendejas de Enmedio	124	63	61	19080
19	Guadalajara	081	Cendejas de la Torre	89	51	38	19081
19	Guadalajara	082	Centenera	72	39	33	19082
19	Guadalajara	086	Cifuentes	2195	1112	1083	19086
19	Guadalajara	087	Cincovillas	41	21	20	19087
19	Guadalajara	088	Ciruelas	117	64	53	19088
19	Guadalajara	089	Ciruelos del Pinar	58	33	25	19089
19	Guadalajara	090	Cobeta	117	63	54	19090
19	Guadalajara	091	Cogollor	50	27	23	19091
19	Guadalajara	092	Cogolludo	610	341	269	19092
19	Guadalajara	095	Condemios de Abajo	29	17	12	19095
19	Guadalajara	096	Condemios de Arriba	161	80	81	19096
19	Guadalajara	097	Congostrina	45	22	23	19097
19	Guadalajara	098	Copernal	31	17	14	19098
19	Guadalajara	099	Corduente	456	249	207	19099
19	Guadalajara	102	Cubillo de Uceda (El)	131	63	68	19102
19	Guadalajara	103	Checa	410	223	187	19103
19	Guadalajara	104	Chequilla	21	12	9	19104
19	Guadalajara	105	Chiloeches	1040	540	500	19105
19	Guadalajara	106	Chillarón del Rey	123	63	60	19106
19	Guadalajara	107	Driebes	363	190	173	19107
19	Guadalajara	108	Durón	122	60	62	19108
19	Guadalajara	109	Embid	66	36	30	19109
19	Guadalajara	110	Escamilla	127	54	73	19110
19	Guadalajara	111	Escariche	192	101	91	19111
19	Guadalajara	112	Escopete	60	20	40	19112
19	Guadalajara	113	Espinosa de Henares	576	285	291	19113
19	Guadalajara	114	Esplegares	63	38	25	19114
19	Guadalajara	115	Establés	45	24	21	19115
19	Guadalajara	116	Estriégana	25	16	9	19116
19	Guadalajara	117	Fontanar	958	500	458	19117
19	Guadalajara	118	Fuembellida	16	9	7	19118
19	Guadalajara	119	Fuencemillán	107	56	51	19119
19	Guadalajara	120	Fuentelahiguera de Albatages	159	79	80	19120
19	Guadalajara	121	Fuentelencina	181	101	80	19121
19	Guadalajara	122	Fuentelsaz	133	62	71	19122
19	Guadalajara	123	Fuentelviejo	68	36	32	19123
19	Guadalajara	124	Fuentenovilla	226	124	102	19124
19	Guadalajara	125	Gajanejos	79	45	34	19125
19	Guadalajara	126	Galápagos	316	165	151	19126
19	Guadalajara	127	Galve de Sorbe	157	75	82	19127
19	Guadalajara	129	Gascueña de Bornova	48	26	22	19129
19	Guadalajara	130	Guadalajara	66103	32254	33849	19130
19	Guadalajara	132	Henche	89	49	40	19132
19	Guadalajara	133	Heras de Ayuso	116	59	57	19133
19	Guadalajara	134	Herrería	33	17	16	19134
19	Guadalajara	135	Hiendelaencina	135	70	65	19135
19	Guadalajara	136	Hijes	26	14	12	19136
19	Guadalajara	138	Hita	257	144	113	19138
19	Guadalajara	139	Hombrados	43	24	19	19139
19	Guadalajara	142	Hontoba	187	92	95	19142
19	Guadalajara	143	Horche	1463	751	712	19143
19	Guadalajara	145	Hortezuela de Océn	81	44	37	19145
19	Guadalajara	146	Huerce (La)	41	23	18	19146
19	Guadalajara	147	Huérmeces del Cerro	61	39	22	19147
19	Guadalajara	148	Huertahernando	70	43	27	19148
19	Guadalajara	150	Hueva	142	67	75	19150
19	Guadalajara	151	Humanes	1209	614	595	19151
19	Guadalajara	152	Illana	675	351	324	19152
19	Guadalajara	153	Iniéstola	14	8	6	19153
19	Guadalajara	154	Inviernas (Las)	98	55	43	19154
19	Guadalajara	155	Irueste	68	38	30	19155
19	Guadalajara	156	Jadraque	1274	639	635	19156
19	Guadalajara	157	Jirueque	91	50	41	19157
19	Guadalajara	159	Ledanca	134	73	61	19159
19	Guadalajara	160	Loranca de Tajuña	346	194	152	19160
19	Guadalajara	161	Lupiana	262	144	118	19161
19	Guadalajara	162	Luzaga	114	55	59	19162
19	Guadalajara	163	Luzón	82	40	42	19163
19	Guadalajara	165	Majaelrayo	56	32	24	19165
19	Guadalajara	166	Málaga del Fresno	212	111	101	19166
19	Guadalajara	167	Malaguilla	145	84	61	19167
19	Guadalajara	168	Mandayona	430	206	224	19168
19	Guadalajara	169	Mantiel	88	45	43	19169
19	Guadalajara	170	Maranchón	248	139	109	19170
19	Guadalajara	171	Marchamalo	4299	2237	2062	19171
19	Guadalajara	172	Masegoso de Tajuña	105	54	51	19172
19	Guadalajara	173	Matarrubia	51	32	19	19173
19	Guadalajara	174	Matillas	203	106	97	19174
19	Guadalajara	175	Mazarete	71	32	39	19175
19	Guadalajara	176	Mazuecos	367	191	176	19176
19	Guadalajara	177	Medranda	126	61	65	19177
19	Guadalajara	178	Megina	79	40	39	19178
19	Guadalajara	179	Membrillera	99	42	57	19179
19	Guadalajara	181	Miedes de Atienza	99	51	48	19181
19	Guadalajara	182	Mierla (La)	26	14	12	19182
19	Guadalajara	183	Milmarcos	116	58	58	19183
19	Guadalajara	184	Millana	114	59	55	19184
19	Guadalajara	185	Miñosa (La)	47	28	19	19185
19	Guadalajara	186	Mirabueno	120	64	56	19186
19	Guadalajara	187	Miralrío	90	49	41	19187
19	Guadalajara	188	Mochales	114	53	61	19188
19	Guadalajara	189	Mohernando	123	66	57	19189
19	Guadalajara	190	Molina de Aragón	3304	1691	1613	19190
19	Guadalajara	191	Monasterio	17	6	11	19191
19	Guadalajara	192	Mondéjar	2138	1067	1071	19192
19	Guadalajara	193	Montarrón	58	33	25	19193
19	Guadalajara	194	Moratilla de los Meleros	96	51	45	19194
19	Guadalajara	195	Morenilla	55	32	23	19195
19	Guadalajara	196	Muduex	114	58	56	19196
19	Guadalajara	197	Navas de Jadraque (Las)	29	16	13	19197
19	Guadalajara	198	Negredo	21	10	11	19198
19	Guadalajara	199	Ocentejo	53	23	30	19199
19	Guadalajara	200	Olivar (El)	134	62	72	19200
19	Guadalajara	201	Olmeda de Cobeta	72	28	44	19201
19	Guadalajara	202	Olmeda de Jadraque (La)	32	13	19	19202
19	Guadalajara	203	Ordial (El)	51	19	32	19203
19	Guadalajara	204	Orea	289	154	135	19204
19	Guadalajara	208	Pálmaces de Jadraque	69	37	32	19208
19	Guadalajara	209	Pardos	64	33	31	19209
19	Guadalajara	210	Paredes de Sigüenza	55	30	25	19210
19	Guadalajara	211	Pareja	504	258	246	19211
19	Guadalajara	212	Pastrana	1128	567	561	19212
19	Guadalajara	213	Pedregal (El)	106	57	49	19213
19	Guadalajara	214	Peñalén	138	77	61	19214
19	Guadalajara	215	Peñalver	237	136	101	19215
19	Guadalajara	216	Peralejos de las Truchas	170	90	80	19216
19	Guadalajara	217	Peralveche	166	89	77	19217
19	Guadalajara	218	Pinilla de Jadraque	88	44	44	19218
19	Guadalajara	219	Pinilla de Molina	26	16	10	19219
19	Guadalajara	220	Pioz	431	234	197	19220
19	Guadalajara	221	Piqueras	71	42	29	19221
19	Guadalajara	222	Pobo de Dueñas (El)	172	94	78	19222
19	Guadalajara	223	Poveda de la Sierra	195	102	93	19223
19	Guadalajara	224	Pozo de Almoguera	181	95	86	19224
19	Guadalajara	225	Pozo de Guadalajara	381	199	182	19225
19	Guadalajara	226	Prádena de Atienza	46	28	18	19226
19	Guadalajara	227	Prados Redondos	84	51	33	19227
19	Guadalajara	228	Puebla de Beleña	46	28	18	19228
19	Guadalajara	229	Puebla de Valles	70	39	31	19229
19	Guadalajara	230	Quer	82	41	41	19230
19	Guadalajara	231	Rebollosa de Jadraque	32	19	13	19231
19	Guadalajara	232	Recuenco (El)	111	55	56	19232
19	Guadalajara	233	Renera	64	34	30	19233
19	Guadalajara	234	Retiendas	54	26	28	19234
19	Guadalajara	235	Riba de Saelices	171	94	77	19235
19	Guadalajara	237	Rillo de Gallo	60	34	26	19237
19	Guadalajara	238	Riofrío del Llano	63	35	28	19238
19	Guadalajara	239	Robledillo de Mohernando	174	88	86	19239
19	Guadalajara	240	Robledo de Corpes	104	50	54	19240
19	Guadalajara	241	Romanillos de Atienza	63	37	26	19241
19	Guadalajara	242	Romanones	140	78	62	19242
19	Guadalajara	243	Rueda de la Sierra	66	34	32	19243
19	Guadalajara	244	Sacecorbo	161	90	71	19244
19	Guadalajara	245	Sacedón	1554	791	763	19245
19	Guadalajara	246	Saelices de la Sal	66	34	32	19246
19	Guadalajara	247	Salmerón	252	131	121	19247
19	Guadalajara	248	San Andrés del Congosto	84	44	40	19248
19	Guadalajara	249	San Andrés del Rey	46	19	27	19249
19	Guadalajara	250	Santiuste	26	15	11	19250
19	Guadalajara	251	Saúca	73	35	38	19251
19	Guadalajara	252	Sayatón	150	81	69	19252
19	Guadalajara	254	Selas	60	26	34	19254
19	Guadalajara	255	Setiles	162	88	74	19255
19	Guadalajara	256	Sienes	83	47	36	19256
19	Guadalajara	257	Sigüenza	4594	2299	2295	19257
19	Guadalajara	258	Solanillos del Extremo	124	64	60	19258
19	Guadalajara	259	Somolinos	51	25	26	19259
19	Guadalajara	260	Sotillo (El)	47	25	22	19260
19	Guadalajara	261	Sotodosos	64	30	34	19261
19	Guadalajara	262	Tamajón	238	116	122	19262
19	Guadalajara	263	Taragudo	33	20	13	19263
19	Guadalajara	264	Taravilla	72	38	34	19264
19	Guadalajara	265	Tartanedo	195	95	100	19265
19	Guadalajara	266	Tendilla	338	178	160	19266
19	Guadalajara	267	Terzaga	32	19	13	19267
19	Guadalajara	268	Tierzo	53	28	25	19268
19	Guadalajara	269	Toba (La)	120	69	51	19269
19	Guadalajara	270	Tordelrábano	12	5	7	19270
19	Guadalajara	271	Tordellego	74	36	38	19271
19	Guadalajara	272	Tordesilos	139	72	67	19272
19	Guadalajara	274	Torija	449	222	227	19274
19	Guadalajara	277	Torrecuadrada de Molina	22	14	8	19277
19	Guadalajara	278	Torrecuadradilla	61	37	24	19278
19	Guadalajara	279	Torre del Burgo	74	45	29	19279
19	Guadalajara	280	Torrejón del Rey	1211	621	590	19280
19	Guadalajara	281	Torremocha de Jadraque	18	13	5	19281
19	Guadalajara	282	Torremocha del Campo	317	173	144	19282
19	Guadalajara	283	Torremocha del Pinar	67	30	37	19283
19	Guadalajara	284	Torremochuela	16	10	6	19284
19	Guadalajara	285	Torrubia	44	24	20	19285
19	Guadalajara	286	Tórtola de Henares	434	227	207	19286
19	Guadalajara	287	Tortuera	223	117	106	19287
19	Guadalajara	288	Tortuero	37	22	15	19288
19	Guadalajara	289	Traíd	62	29	33	19289
19	Guadalajara	290	Trijueque	465	245	220	19290
19	Guadalajara	291	Trillo	1387	711	676	19291
19	Guadalajara	293	Uceda	930	466	464	19293
19	Guadalajara	294	Ujados	33	17	16	19294
19	Guadalajara	296	Utande	57	37	20	19296
19	Guadalajara	297	Valdarachas	28	11	17	19297
19	Guadalajara	298	Valdearenas	81	40	41	19298
19	Guadalajara	299	Valdeavellano	89	49	40	19299
19	Guadalajara	300	Valdeaveruelo	318	172	146	19300
19	Guadalajara	301	Valdeconcha	85	44	41	19301
19	Guadalajara	302	Valdegrudas	57	32	25	19302
19	Guadalajara	303	Valdelcubo	66	38	28	19303
19	Guadalajara	304	Valdenuño Fernández	152	83	69	19304
19	Guadalajara	305	Valdepeñas de la Sierra	226	121	105	19305
19	Guadalajara	306	Valderrebollo	37	19	18	19306
19	Guadalajara	307	Valdesotos	38	15	23	19307
19	Guadalajara	308	Valfermoso de Tajuña	103	54	49	19308
19	Guadalajara	309	Valhermoso	48	29	19	19309
19	Guadalajara	310	Valtablado del Río	14	9	5	19310
19	Guadalajara	311	Valverde de los Arroyos	102	54	48	19311
19	Guadalajara	314	Viana de Jadraque	53	32	21	19314
19	Guadalajara	317	Villanueva de Alcorón	279	154	125	19317
19	Guadalajara	318	Villanueva de Argecilla	40	21	19	19318
19	Guadalajara	319	Villanueva de la Torre	1309	687	622	19319
19	Guadalajara	321	Villares de Jadraque	54	27	27	19321
19	Guadalajara	322	Villaseca de Henares	72	37	35	19322
19	Guadalajara	323	Villaseca de Uceda	67	35	32	19323
19	Guadalajara	324	Villel de Mesa	255	133	122	19324
19	Guadalajara	325	Viñuelas	125	75	50	19325
19	Guadalajara	326	Yebes	167	117	50	19326
19	Guadalajara	327	Yebra	524	271	253	19327
19	Guadalajara	329	Yélamos de Abajo	112	54	58	19329
19	Guadalajara	330	Yélamos de Arriba	167	91	76	19330
19	Guadalajara	331	Yunquera de Henares	2039	1031	1008	19331
19	Guadalajara	332	Yunta (La)	168	82	86	19332
19	Guadalajara	333	Zaorejas	206	116	90	19333
19	Guadalajara	334	Zarzuela de Jadraque	44	17	27	19334
19	Guadalajara	335	Zorita de los Canes	96	52	44	19335
19	Guadalajara	901	Semillas	42	21	21	19901
20	Guipúzcoa	001	Abaltzisketa	258	153	105	20001
20	Guipúzcoa	002	Aduna	315	169	146	20002
20	Guipúzcoa	003	Aizarnazabal	534	284	250	20003
20	Guipúzcoa	004	Albiztur	291	162	129	20004
20	Guipúzcoa	005	Alegia	1595	813	782	20005
20	Guipúzcoa	006	Alkiza	254	143	111	20006
20	Guipúzcoa	007	Altzo	331	171	160	20007
20	Guipúzcoa	008	Amezketa	989	516	473	20008
20	Guipúzcoa	009	Andoain	14153	7091	7062	20009
20	Guipúzcoa	010	Anoeta	1707	878	829	20010
20	Guipúzcoa	011	Antzuola	1896	967	929	20011
20	Guipúzcoa	012	Arama	167	82	85	20012
20	Guipúzcoa	013	Aretxabaleta	6101	3108	2993	20013
20	Guipúzcoa	014	Asteasu	1187	635	552	20014
20	Guipúzcoa	015	Ataun	1558	811	747	20015
20	Guipúzcoa	016	Aia	1650	916	734	20016
20	Guipúzcoa	017	Azkoitia	10192	5065	5127	20017
20	Guipúzcoa	018	Azpeitia	13657	6854	6803	20018
20	Guipúzcoa	019	Beasain	12134	6060	6074	20019
20	Guipúzcoa	020	Beizama	160	90	70	20020
20	Guipúzcoa	021	Belauntza	321	174	147	20021
20	Guipúzcoa	022	Berastegi	977	534	443	20022
20	Guipúzcoa	023	Berrobi	553	298	255	20023
20	Guipúzcoa	024	Bidegoyan	417	234	183	20024
20	Guipúzcoa	025	Zegama	1276	655	621	20025
20	Guipúzcoa	026	Zerain	246	127	119	20026
20	Guipúzcoa	027	Zestoa	3140	1623	1517	20027
20	Guipúzcoa	028	Zizurkil	2843	1450	1393	20028
20	Guipúzcoa	029	Deba	5092	2577	2515	20029
20	Guipúzcoa	030	Eibar	28942	14165	14777	20030
20	Guipúzcoa	031	Elduain	193	99	94	20031
20	Guipúzcoa	032	Elgoibar	10702	5358	5344	20032
20	Guipúzcoa	033	Elgeta	968	496	472	20033
20	Guipúzcoa	034	Eskoriatza	3943	2028	1915	20034
20	Guipúzcoa	035	Ezkio-Itsaso	555	298	257	20035
20	Guipúzcoa	036	Hondarribia	14863	7431	7432	20036
20	Guipúzcoa	037	Gaintza	133	83	50	20037
20	Guipúzcoa	038	Gabiria	430	238	192	20038
20	Guipúzcoa	039	Getaria	2436	1228	1208	20039
20	Guipúzcoa	040	Hernani	18698	9295	9403	20040
20	Guipúzcoa	041	Hernialde	289	146	143	20041
20	Guipúzcoa	042	Ibarra	4334	2252	2082	20042
20	Guipúzcoa	043	Idiazabal	2038	1032	1006	20043
20	Guipúzcoa	044	Ikaztegieta	382	196	186	20044
20	Guipúzcoa	045	Irun	56515	27635	28880	20045
20	Guipúzcoa	046	Irura	749	390	359	20046
20	Guipúzcoa	047	Itsasondo	588	292	296	20047
20	Guipúzcoa	048	Larraul	147	86	61	20048
20	Guipúzcoa	049	Lazkao	4876	2497	2379	20049
20	Guipúzcoa	050	Leaburu	351	186	165	20050
20	Guipúzcoa	051	Legazpi	8958	4609	4349	20051
20	Guipúzcoa	052	Legorreta	1399	713	686	20052
20	Guipúzcoa	053	Lezo	5799	2903	2896	20053
20	Guipúzcoa	054	Lizartza	592	304	288	20054
20	Guipúzcoa	055	Arrasate o Mondragón	23718	11863	11855	20055
20	Guipúzcoa	056	Mutriku	4790	2384	2406	20056
20	Guipúzcoa	057	Mutiloa	165	85	80	20057
20	Guipúzcoa	058	Olaberria	923	477	446	20058
20	Guipúzcoa	059	Oñati	10717	5367	5350	20059
20	Guipúzcoa	060	Orexa	81	45	36	20060
20	Guipúzcoa	061	Orio	4388	2221	2167	20061
20	Guipúzcoa	062	Ormaiztegi	1159	592	567	20062
20	Guipúzcoa	063	Oiartzun	9185	4627	4558	20063
20	Guipúzcoa	064	Pasaia	16776	8137	8639	20064
20	Guipúzcoa	065	Soraluze/Placencia de las Armas	4270	2119	2151	20065
20	Guipúzcoa	066	Errezil	631	339	292	20066
20	Guipúzcoa	067	Errenteria	39200	19292	19908	20067
20	Guipúzcoa	068	Leintz-Gatzaga	258	143	115	20068
20	Guipúzcoa	069	Donostia-San Sebastián	180277	84663	95614	20069
20	Guipúzcoa	070	Segura	1247	622	625	20070
20	Guipúzcoa	071	Tolosa	18076	8708	9368	20071
20	Guipúzcoa	072	Urnieta	5488	2806	2682	20072
20	Guipúzcoa	073	Usurbil	5292	2716	2576	20073
20	Guipúzcoa	074	Bergara	15089	7515	7574	20074
20	Guipúzcoa	075	Villabona	5531	2790	2741	20075
20	Guipúzcoa	076	Ordizia	9089	4405	4684	20076
20	Guipúzcoa	077	Urretxu	6428	3225	3203	20077
20	Guipúzcoa	078	Zaldibia	1525	789	736	20078
20	Guipúzcoa	079	Zarautz	20638	10198	10440	20079
20	Guipúzcoa	080	Zumarraga	10300	5151	5149	20080
20	Guipúzcoa	081	Zumaia	8392	4183	4209	20081
20	Guipúzcoa	901	Mendaro	1378	709	669	20901
20	Guipúzcoa	902	Lasarte-Oria	17561	8750	8811	20902
20	Guipúzcoa	903	Astigarraga	3435	1714	1721	20903
20	Guipúzcoa	904	Baliarrain	88	45	43	20904
20	Guipúzcoa	905	Orendain	146	84	62	20905
20	Guipúzcoa	906	Altzaga	98	50	48	20906
20	Guipúzcoa	907	Gaztelu	157	88	69	20907
21	Huelva	001	Alájar	776	392	384	21001
21	Huelva	002	Aljaraque	10806	5414	5392	21002
21	Huelva	003	Almendro (El)	864	448	416	21003
21	Huelva	004	Almonaster la Real	1963	960	1003	21004
21	Huelva	005	Almonte	17444	8774	8670	21005
21	Huelva	006	Alosno	4834	2324	2510	21006
21	Huelva	007	Aracena	6756	3287	3469	21007
21	Huelva	008	Aroche	3503	1738	1765	21008
21	Huelva	009	Arroyomolinos de León	1157	594	563	21009
21	Huelva	010	Ayamonte	16939	8322	8617	21010
21	Huelva	011	Beas	4124	2062	2062	21011
21	Huelva	012	Berrocal	409	201	208	21012
21	Huelva	013	Bollullos Par del Condado	12822	6378	6444	21013
21	Huelva	014	Bonares	5122	2609	2513	21014
21	Huelva	015	Cabezas Rubias	962	498	464	21015
21	Huelva	016	Cala	1414	704	710	21016
21	Huelva	017	Calañas	4725	2315	2410	21017
21	Huelva	018	Campillo (El)	2430	1169	1261	21018
21	Huelva	019	Campofrío	844	428	416	21019
21	Huelva	020	Cañaveral de León	501	240	261	21020
21	Huelva	021	Cartaya	12584	6291	6293	21021
21	Huelva	022	Castaño del Robledo	200	106	94	21022
21	Huelva	023	Cerro de Andévalo (El)	2741	1337	1404	21023
21	Huelva	024	Corteconcepción	672	339	333	21024
21	Huelva	025	Cortegana	5084	2519	2565	21025
21	Huelva	026	Cortelazor	317	158	159	21026
21	Huelva	027	Cumbres de Enmedio	62	31	31	21027
21	Huelva	028	Cumbres de San Bartolomé	575	286	289	21028
21	Huelva	029	Cumbres Mayores	2119	1039	1080	21029
21	Huelva	030	Chucena	1964	989	975	21030
21	Huelva	031	Encinasola	1789	876	913	21031
21	Huelva	032	Escacena del Campo	2190	1094	1096	21032
21	Huelva	033	Fuenteheridos	636	320	316	21033
21	Huelva	034	Galaroza	1603	769	834	21034
21	Huelva	035	Gibraleón	10827	5495	5332	21035
21	Huelva	036	Granada de Río-Tinto (La)	222	115	107	21036
21	Huelva	037	Granado (El)	661	359	302	21037
21	Huelva	038	Higuera de la Sierra	1258	634	624	21038
21	Huelva	039	Hinojales	432	218	214	21039
21	Huelva	040	Hinojos	3556	1799	1757	21040
21	Huelva	041	Huelva	140985	68077	72908	21041
21	Huelva	042	Isla Cristina	18236	9155	9081	21042
21	Huelva	043	Jabugo	2558	1284	1274	21043
21	Huelva	044	Lepe	19086	9784	9302	21044
21	Huelva	045	Linares de la Sierra	316	153	163	21045
21	Huelva	046	Lucena del Puerto	2237	1167	1070	21046
21	Huelva	047	Manzanilla	2504	1237	1267	21047
21	Huelva	048	Marines (Los)	328	162	166	21048
21	Huelva	049	Minas de Riotinto	4888	2325	2563	21049
21	Huelva	050	Moguer	14389	7324	7065	21050
21	Huelva	051	Nava (La)	319	167	152	21051
21	Huelva	052	Nerva	6413	3106	3307	21052
21	Huelva	053	Niebla	3847	1938	1909	21053
21	Huelva	054	Palma del Condado (La)	9695	4798	4897	21054
21	Huelva	055	Palos de la Frontera	7115	3638	3477	21055
21	Huelva	056	Paterna del Campo	3894	1991	1903	21056
21	Huelva	057	Paymogo	1269	621	648	21057
21	Huelva	058	Puebla de Guzmán	3253	1648	1605	21058
21	Huelva	059	Puerto Moral	254	125	129	21059
21	Huelva	060	Punta Umbría	11987	6081	5906	21060
21	Huelva	061	Rociana del Condado	6292	3217	3075	21061
21	Huelva	062	Rosal de la Frontera	1865	893	972	21062
21	Huelva	063	San Bartolomé de la Torre	2945	1490	1455	21063
21	Huelva	064	San Juan del Puerto	5933	2961	2972	21064
21	Huelva	065	Sanlúcar de Guadiana	397	197	200	21065
21	Huelva	066	San Silvestre de Guzmán	647	320	327	21066
21	Huelva	067	Santa Ana la Real	509	239	270	21067
21	Huelva	068	Santa Bárbara de Casa	1337	672	665	21068
21	Huelva	069	Santa Olalla del Cala	2244	1127	1117	21069
21	Huelva	070	Trigueros	7213	3596	3617	21070
21	Huelva	071	Valdelarco	275	132	143	21071
21	Huelva	072	Valverde del Camino	12480	6052	6428	21072
21	Huelva	073	Villablanca	2053	1060	993	21073
21	Huelva	074	Villalba del Alcor	3604	1795	1809	21074
21	Huelva	075	Villanueva de las Cruces	423	202	221	21075
21	Huelva	076	Villanueva de los Castillejos	2682	1319	1363	21076
21	Huelva	077	Villarrasa	2130	1082	1048	21077
21	Huelva	078	Zalamea la Real	3455	1693	1762	21078
21	Huelva	079	Zufre	1054	555	499	21079
22	Huesca	001	Abiego	292	145	147	22001
22	Huesca	002	Abizanda	137	72	65	22002
22	Huesca	003	Adahuesca	154	81	73	22003
22	Huesca	004	Agüero	172	92	80	22004
22	Huesca	006	Aisa	383	206	177	22006
22	Huesca	007	Albalate de Cinca	1149	592	557	22007
22	Huesca	008	Albalatillo	258	128	130	22008
22	Huesca	009	Albelda	937	481	456	22009
22	Huesca	011	Albero Alto	101	52	49	22011
22	Huesca	012	Albero Bajo	109	59	50	22012
22	Huesca	013	Alberuela de Tubo	388	192	196	22013
22	Huesca	014	Alcalá de Gurrea	319	153	166	22014
22	Huesca	015	Alcalá del Obispo	356	186	170	22015
22	Huesca	016	Alcampell	911	444	467	22016
22	Huesca	017	Alcolea de Cinca	1214	614	600	22017
22	Huesca	018	Alcubierre	467	249	218	22018
22	Huesca	019	Alerre	195	102	93	22019
22	Huesca	020	Alfántega	117	61	56	22020
22	Huesca	021	Almudévar	2324	1188	1136	22021
22	Huesca	022	Almunia de San Juan	682	346	336	22022
22	Huesca	023	Almuniente	621	320	301	22023
22	Huesca	024	Alquézar	310	157	153	22024
22	Huesca	025	Altorricón	1462	760	702	22025
22	Huesca	027	Angüés	435	237	198	22027
22	Huesca	028	Ansó	529	268	261	22028
22	Huesca	029	Antillón	164	83	81	22029
22	Huesca	032	Aragüés del Puerto	135	81	54	22032
22	Huesca	035	Arén	384	200	184	22035
22	Huesca	036	Argavieso	129	74	55	22036
22	Huesca	037	Arguis	68	39	29	22037
22	Huesca	039	Ayerbe	1106	561	545	22039
22	Huesca	040	Azanuy-Alins	193	86	107	22040
22	Huesca	041	Azara	216	108	108	22041
22	Huesca	042	Azlor	158	81	77	22042
22	Huesca	043	Baélls	153	85	68	22043
22	Huesca	044	Bailo	307	180	127	22044
22	Huesca	045	Baldellou	144	79	65	22045
22	Huesca	046	Ballobar	1062	534	528	22046
22	Huesca	047	Banastás	190	101	89	22047
22	Huesca	048	Barbastro	14671	7147	7524	22048
22	Huesca	049	Barbués	122	63	59	22049
22	Huesca	050	Barbuñales	112	58	54	22050
22	Huesca	051	Bárcabo	113	62	51	22051
22	Huesca	052	Belver de Cinca	1368	718	650	22052
22	Huesca	053	Benabarre	1139	594	545	22053
22	Huesca	054	Benasque	1496	792	704	22054
22	Huesca	055	Berbegal	466	233	233	22055
22	Huesca	057	Bielsa	474	240	234	22057
22	Huesca	058	Bierge	223	126	97	22058
22	Huesca	059	Biescas	1294	681	613	22059
22	Huesca	060	Binaced	1589	809	780	22060
22	Huesca	061	Binéfar	8228	4130	4098	22061
22	Huesca	062	Bisaurri	216	123	93	22062
22	Huesca	063	Biscarrués	232	123	109	22063
22	Huesca	064	Blecua y Torres	182	92	90	22064
22	Huesca	066	Boltaña	855	436	419	22066
22	Huesca	067	Bonansa	76	40	36	22067
22	Huesca	068	Borau	74	40	34	22068
22	Huesca	069	Broto	518	266	252	22069
22	Huesca	072	Caldearenas	259	145	114	22072
22	Huesca	074	Campo	342	164	178	22074
22	Huesca	075	Camporrélls	248	127	121	22075
22	Huesca	076	Canal de Berdún	434	238	196	22076
22	Huesca	077	Candasnos	538	281	257	22077
22	Huesca	078	Canfranc	531	292	239	22078
22	Huesca	079	Capdesaso	173	80	93	22079
22	Huesca	080	Capella	393	203	190	22080
22	Huesca	081	Casbas de Huesca	304	161	143	22081
22	Huesca	082	Castejón del Puente	423	225	198	22082
22	Huesca	083	Castejón de Monegros	707	357	350	22083
22	Huesca	084	Castejón de Sos	572	297	275	22084
22	Huesca	085	Castelflorite	148	76	72	22085
22	Huesca	086	Castiello de Jaca	185	98	87	22086
22	Huesca	087	Castigaleu	102	58	44	22087
22	Huesca	088	Castillazuelo	230	109	121	22088
22	Huesca	089	Castillonroy	423	206	217	22089
22	Huesca	090	Colungo	124	67	57	22090
22	Huesca	094	Chalamera	159	90	69	22094
22	Huesca	095	Chía	113	63	50	22095
22	Huesca	096	Chimillas	186	100	86	22096
22	Huesca	099	Esplús	756	361	395	22099
22	Huesca	102	Estada	206	106	100	22102
22	Huesca	103	Estadilla	913	465	448	22103
22	Huesca	105	Estopiñán del Castillo	181	100	81	22105
22	Huesca	106	Fago	39	25	14	22106
22	Huesca	107	Fanlo	176	100	76	22107
22	Huesca	109	Fiscal	254	142	112	22109
22	Huesca	110	Fonz	1113	571	542	22110
22	Huesca	111	Foradada del Toscar	242	117	125	22111
22	Huesca	112	Fraga	12000	5999	6001	22112
22	Huesca	113	Fueva (La)	615	326	289	22113
22	Huesca	114	Gistaín	175	102	73	22114
22	Huesca	115	Grado (El)	566	300	266	22115
22	Huesca	116	Grañén	1966	1010	956	22116
22	Huesca	117	Graus	3199	1612	1587	22117
22	Huesca	119	Gurrea de Gállego	1834	938	896	22119
22	Huesca	122	Hoz de Jaca	77	34	43	22122
22	Huesca	124	Huerto	263	144	119	22124
22	Huesca	125	Huesca	45653	22002	23651	22125
22	Huesca	126	Ibieca	101	50	51	22126
22	Huesca	127	Igriés	225	114	111	22127
22	Huesca	128	Ilche	279	146	133	22128
22	Huesca	129	Isábena	253	130	123	22129
22	Huesca	130	Jaca	11414	5656	5758	22130
22	Huesca	131	Jasa	127	73	54	22131
22	Huesca	133	Labuerda	172	90	82	22133
22	Huesca	135	Laluenga	266	137	129	22135
22	Huesca	136	Lalueza	1207	639	568	22136
22	Huesca	137	Lanaja	1569	812	757	22137
22	Huesca	139	Laperdiguera	99	49	50	22139
22	Huesca	141	Lascellas-Ponzano	164	85	79	22141
22	Huesca	142	Lascuarre	164	90	74	22142
22	Huesca	143	Laspaúles	290	159	131	22143
22	Huesca	144	Laspuña	274	149	125	22144
22	Huesca	149	Loarre	407	215	192	22149
22	Huesca	150	Loporzano	519	271	248	22150
22	Huesca	151	Loscorrales	120	67	53	22151
22	Huesca	155	Monesma y Cajigar	102	51	51	22155
22	Huesca	156	Monflorite-Lascasas	201	110	91	22156
22	Huesca	157	Montanuy	307	174	133	22157
22	Huesca	158	Monzón	14665	7359	7306	22158
22	Huesca	160	Naval	295	151	144	22160
22	Huesca	162	Novales	184	93	91	22162
22	Huesca	163	Nueno	240	136	104	22163
22	Huesca	164	Olvena	56	25	31	22164
22	Huesca	165	Ontiñena	652	326	326	22165
22	Huesca	167	Osso de Cinca	730	400	330	22167
22	Huesca	168	Palo	27	15	12	22168
22	Huesca	170	Panticosa	709	356	353	22170
22	Huesca	172	Peñalba	795	395	400	22172
22	Huesca	173	Peñas de Riglos (Las)	279	157	122	22173
22	Huesca	174	Peralta de Alcofea	725	358	367	22174
22	Huesca	175	Peralta de Calasanz	271	148	123	22175
22	Huesca	176	Peraltilla	169	91	78	22176
22	Huesca	177	Perarrúa	127	62	65	22177
22	Huesca	178	Pertusa	153	81	72	22178
22	Huesca	181	Piracés	100	64	36	22181
22	Huesca	182	Plan	322	173	149	22182
22	Huesca	184	Poleñino	260	132	128	22184
22	Huesca	186	Pozán de Vero	259	123	136	22186
22	Huesca	187	Puebla de Castro (La)	335	172	163	22187
22	Huesca	188	Puente de Montañana	127	61	66	22188
22	Huesca	189	Puértolas	209	115	94	22189
22	Huesca	190	Pueyo de Araguás (El)	160	100	60	22190
22	Huesca	193	Pueyo de Santa Cruz	340	171	169	22193
22	Huesca	195	Quicena	149	79	70	22195
22	Huesca	197	Robres	670	347	323	22197
22	Huesca	199	Sabiñánigo	8483	4287	4196	22199
22	Huesca	200	Sahún	289	159	130	22200
22	Huesca	201	Salas Altas	380	196	184	22201
22	Huesca	202	Salas Bajas	142	70	72	22202
22	Huesca	203	Salillas	117	62	55	22203
22	Huesca	204	Sallent de Gállego	1053	550	503	22204
22	Huesca	205	San Esteban de Litera	604	302	302	22205
22	Huesca	206	Sangarrén	279	136	143	22206
22	Huesca	207	San Juan de Plan	152	81	71	22207
22	Huesca	208	Santa Cilia	170	97	73	22208
22	Huesca	209	Santa Cruz de la Serós	139	80	59	22209
22	Huesca	212	Santaliestra y San Quílez	95	54	41	22212
22	Huesca	213	Sariñena	4021	2019	2002	22213
22	Huesca	214	Secastilla	162	71	91	22214
22	Huesca	215	Seira	209	105	104	22215
22	Huesca	217	Sena	562	295	267	22217
22	Huesca	218	Senés de Alcubierre	61	31	30	22218
22	Huesca	220	Sesa	260	133	127	22220
22	Huesca	221	Sesué	119	60	59	22221
22	Huesca	222	Siétamo	366	205	161	22222
22	Huesca	223	Sopeira	113	57	56	22223
22	Huesca	225	Tamarite de Litera	3751	1876	1875	22225
22	Huesca	226	Tardienta	1070	547	523	22226
22	Huesca	227	Tella-Sin	275	144	131	22227
22	Huesca	228	Tierz	180	89	91	22228
22	Huesca	229	Tolva	197	105	92	22229
22	Huesca	230	Torla	317	168	149	22230
22	Huesca	232	Torralba de Aragón	126	60	66	22232
22	Huesca	233	Torre la Ribera	116	65	51	22233
22	Huesca	234	Torrente de Cinca	1081	538	543	22234
22	Huesca	235	Torres de Alcanadre	137	80	57	22235
22	Huesca	236	Torres de Barbués	363	182	181	22236
22	Huesca	239	Tramaced	106	64	42	22239
22	Huesca	242	Valfarta	96	55	41	22242
22	Huesca	243	Valle de Bardají	56	29	27	22243
22	Huesca	244	Valle de Lierp	59	31	28	22244
22	Huesca	245	Velilla de Cinca	479	238	241	22245
22	Huesca	246	Veracruz	111	59	52	22246
22	Huesca	247	Viacamp y Litera	30	20	10	22247
22	Huesca	248	Vicién	125	65	60	22248
22	Huesca	249	Villanova	140	70	70	22249
22	Huesca	250	Villanúa	345	174	171	22250
22	Huesca	251	Villanueva de Sigena	508	251	257	22251
22	Huesca	252	Yebra de Basa	166	96	70	22252
22	Huesca	253	Yésero	76	40	36	22253
22	Huesca	254	Zaidín	1669	833	836	22254
22	Huesca	901	Valle de Hecho	992	512	480	22901
22	Huesca	902	Puente la Reina de Jaca	232	121	111	22902
22	Huesca	903	San Miguel del Cinca	915	473	442	22903
22	Huesca	904	Sotonera (La)	1108	590	518	22904
22	Huesca	905	Lupiñén-Ortilla	359	191	168	22905
22	Huesca	906	Santa María de Dulcis	216	112	104	22906
22	Huesca	907	Aínsa-Sobrarbe	1595	829	766	22907
22	Huesca	908	Hoz y Costean	224	127	97	22908
22	Huesca	909	Vencillón	465	238	227	22909
23	Jaén	001	Albánchez de Úbeda	1497	760	737	23001
23	Jaén	002	Alcalá la Real	21599	10627	10972	23002
23	Jaén	003	Alcaudete	11367	5625	5742	23003
23	Jaén	004	Aldeaquemada	602	314	288	23004
23	Jaén	005	Andújar	37621	18559	19062	23005
23	Jaén	006	Arjona	5634	2848	2786	23006
23	Jaén	007	Arjonilla	3917	1955	1962	23007
23	Jaén	008	Arquillos	1970	985	985	23008
23	Jaén	009	Baeza	15738	7720	8018	23009
23	Jaén	010	Bailén	17472	8903	8569	23010
23	Jaén	011	Baños de la Encina	2721	1385	1336	23011
23	Jaén	012	Beas de Segura	8029	4118	3911	23012
23	Jaén	014	Begíjar	3136	1573	1563	23014
23	Jaén	015	Bélmez de la Moraleda	1959	1001	958	23015
23	Jaén	016	Benatae	574	319	255	23016
23	Jaén	017	Cabra del Santo Cristo	2250	1149	1101	23017
23	Jaén	018	Cambil	3108	1638	1470	23018
23	Jaén	019	Campillo de Arenas	2179	1109	1070	23019
23	Jaén	020	Canena	2122	1025	1097	23020
23	Jaén	021	Carboneros	679	336	343	23021
23	Jaén	024	Carolina (La)	14938	7360	7578	23024
23	Jaén	025	Castellar	3676	1853	1823	23025
23	Jaén	026	Castillo de Locubín	5166	2535	2631	23026
23	Jaén	027	Cazalilla	829	421	408	23027
23	Jaén	028	Cazorla	8397	4083	4314	23028
23	Jaén	029	Chiclana de Segura	1346	675	671	23029
23	Jaén	030	Chilluévar	1721	852	869	23030
23	Jaén	031	Escañuela	935	464	471	23031
23	Jaén	032	Espelúy	788	393	395	23032
23	Jaén	033	Frailes	1858	948	910	23033
23	Jaén	034	Fuensanta de Martos	3330	1661	1669	23034
23	Jaén	035	Fuerte del Rey	1157	576	581	23035
23	Jaén	037	Génave	691	364	327	23037
23	Jaén	038	Guardia de Jaén (La)	2062	1074	988	23038
23	Jaén	039	Guarromán	2802	1376	1426	23039
23	Jaén	040	Lahiguera	1913	945	968	23040
23	Jaén	041	Higuera de Calatrava	691	356	335	23041
23	Jaén	042	Hinojares	501	239	262	23042
23	Jaén	043	Hornos	718	347	371	23043
23	Jaén	044	Huelma	6232	3191	3041	23044
23	Jaén	045	Huesa	2719	1367	1352	23045
23	Jaén	046	Ibros	3015	1513	1502	23046
23	Jaén	047	Iruela (La)	1907	967	940	23047
23	Jaén	048	Iznatoraf	1218	608	610	23048
23	Jaén	049	Jabalquinto	2547	1267	1280	23049
23	Jaén	050	Jaén	110781	53491	57290	23050
23	Jaén	051	Jamilena	3301	1683	1618	23051
23	Jaén	052	Jimena	1582	763	819	23052
23	Jaén	053	Jódar	11805	5848	5957	23053
23	Jaén	054	Larva	521	273	248	23054
23	Jaén	055	Linares	58034	28290	29744	23055
23	Jaén	056	Lopera	3978	1953	2025	23056
23	Jaén	057	Lupión	1050	500	550	23057
23	Jaén	058	Mancha Real	9012	4616	4396	23058
23	Jaén	059	Marmolejo	7549	3800	3749	23059
23	Jaén	060	Martos	22732	10988	11744	23060
23	Jaén	061	Mengíbar	8339	4181	4158	23061
23	Jaén	062	Montizón	1969	1010	959	23062
23	Jaén	063	Navas de San Juan	5155	2552	2603	23063
23	Jaén	064	Noalejo	2278	1146	1132	23064
23	Jaén	065	Orcera	2258	1128	1130	23065
23	Jaén	066	Peal de Becerro	5310	2633	2677	23066
23	Jaén	067	Pegalajar	3074	1570	1504	23067
23	Jaén	069	Porcuna	6941	3470	3471	23069
23	Jaén	070	Pozo Alcón	5618	2819	2799	23070
23	Jaén	071	Puente de Génave	1972	974	998	23071
23	Jaén	072	Puerta de Segura (La)	2677	1339	1338	23072
23	Jaén	073	Quesada	6089	2995	3094	23073
23	Jaén	074	Rus	3747	1870	1877	23074
23	Jaén	075	Sabiote	4192	2120	2072	23075
23	Jaén	076	Santa Elena	992	528	464	23076
23	Jaén	077	Santiago de Calatrava	916	455	461	23077
23	Jaén	079	Santisteban del Puerto	4863	2472	2391	23079
23	Jaén	080	Santo Tomé	2315	1164	1151	23080
23	Jaén	081	Segura de la Sierra	2204	1103	1101	23081
23	Jaén	082	Siles	2636	1320	1316	23082
23	Jaén	084	Sorihuela del Guadalimar	1238	632	606	23084
23	Jaén	085	Torreblascopedro	2976	1493	1483	23085
23	Jaén	086	Torre del Campo	13052	6534	6518	23086
23	Jaén	087	Torredonjimeno	13846	6810	7036	23087
23	Jaén	088	Torreperogil	7424	3661	3763	23088
23	Jaén	090	Torres	1816	937	879	23090
23	Jaén	091	Torres de Albánchez	1021	510	511	23091
23	Jaén	092	Úbeda	32456	15815	16641	23092
23	Jaén	093	Valdepeñas de Jaén	4509	2283	2226	23093
23	Jaén	094	Vilches	5030	2504	2526	23094
23	Jaén	095	Villacarrillo	11067	5497	5570	23095
23	Jaén	096	Villanueva de la Reina	3304	1647	1657	23096
23	Jaén	097	Villanueva del Arzobispo	8650	4349	4301	23097
23	Jaén	098	Villardompardo	1258	620	638	23098
23	Jaén	099	Villares (Los)	4851	2424	2427	23099
23	Jaén	101	Villarrodrigo	565	279	286	23101
23	Jaén	901	Cárcheles	1537	756	781	23901
23	Jaén	902	Bedmar y Garcíez	3268	1641	1627	23902
23	Jaén	903	Villatorres	4197	2123	2074	23903
23	Jaén	904	Santiago-Pontones	4425	2250	2175	23904
24	León	001	Acebedo	284	155	129	24001
24	León	002	Algadefe	371	187	184	24002
24	León	003	Alija del Infantado	962	484	478	24003
24	León	004	Almanza	733	391	342	24004
24	León	005	Antigua (La)	625	332	293	24005
24	León	006	Ardón	683	354	329	24006
24	León	007	Arganza	959	476	483	24007
24	León	008	Astorga	12377	5864	6513	24008
24	León	009	Balboa	460	242	218	24009
24	León	010	Bañeza (La)	10404	5047	5357	24010
24	León	011	Barjas	403	219	184	24011
24	León	012	Barrios de Luna (Los)	347	171	176	24012
24	León	014	Bembibre	10734	5316	5418	24014
24	León	015	Benavides	3046	1542	1504	24015
24	León	016	Benuza	930	492	438	24016
24	León	017	Bercianos del Páramo	861	434	427	24017
24	León	018	Bercianos del Real Camino	221	111	110	24018
24	León	019	Berlanga del Bierzo	429	201	228	24019
24	León	020	Boca de Huérgano	600	328	272	24020
24	León	021	Boñar	2592	1263	1329	24021
24	León	022	Borrenes	510	259	251	24022
24	León	023	Brazuelo	347	174	173	24023
24	León	024	Burgo Ranero (El)	960	507	453	24024
24	León	025	Burón	404	216	188	24025
24	León	026	Bustillo del Páramo	1884	947	937	24026
24	León	027	Cabañas Raras	1320	677	643	24027
24	León	028	Cabreros del Río	602	311	291	24028
24	León	029	Cabrillanes	1139	560	579	24029
24	León	030	Cacabelos	4868	2441	2427	24030
24	León	031	Calzada del Coto	303	169	134	24031
24	León	032	Campazas	163	84	79	24032
24	León	033	Campo de Villavidel	345	177	168	24033
24	León	034	Camponaraya	3209	1558	1651	24034
24	León	036	Candín	444	241	203	24036
24	León	037	Cármenes	437	227	210	24037
24	León	038	Carracedelo	3552	1731	1821	24038
24	León	039	Carrizo	2735	1356	1379	24039
24	León	040	Carrocera	616	301	315	24040
24	León	041	Carucedo	665	318	347	24041
24	León	042	Castilfalé	105	53	52	24042
24	León	043	Castrillo de Cabrera	191	96	95	24043
24	León	044	Castrillo de la Valduerna	238	103	135	24044
24	León	046	Castrocalbón	1370	696	674	24046
24	León	047	Castrocontrigo	1186	587	599	24047
24	León	049	Castropodame	1921	983	938	24049
24	León	050	Castrotierra de Valmadrigal	155	77	78	24050
24	León	051	Cea	744	389	355	24051
24	León	052	Cebanico	250	134	116	24052
24	León	053	Cebrones del Río	702	347	355	24053
24	León	054	Cimanes de la Vega	688	341	347	24054
24	León	055	Cimanes del Tejar	1011	498	513	24055
24	León	056	Cistierna	4418	2149	2269	24056
24	León	057	Congosto	1734	828	906	24057
24	León	058	Corbillos de los Oteros	295	145	150	24058
24	León	059	Corullón	1211	607	604	24059
24	León	060	Crémenes	1098	528	570	24060
24	León	061	Cuadros	1676	805	871	24061
24	León	062	Cubillas de los Oteros	214	107	107	24062
24	León	063	Cubillas de Rueda	640	323	317	24063
24	León	064	Cubillos del Sil	1520	793	727	24064
24	León	065	Chozas de Abajo	2144	1103	1041	24065
24	León	066	Destriana	854	405	449	24066
24	León	067	Encinedo	1037	525	512	24067
24	León	068	Ercina (La)	718	353	365	24068
24	León	069	Escobar de Campos	77	46	31	24069
24	León	070	Fabero	5924	2942	2982	24070
24	León	071	Folgoso de la Ribera	1364	663	701	24071
24	León	073	Fresno de la Vega	693	351	342	24073
24	León	074	Fuentes de Carbajal	136	71	65	24074
24	León	076	Garrafe de Torío	1191	602	589	24076
24	León	077	Gordaliza del Pino	353	177	176	24077
24	León	078	Gordoncillo	625	305	320	24078
24	León	079	Gradefes	1342	652	690	24079
24	León	080	Grajal de Campos	306	134	172	24080
24	León	081	Gusendos de los Oteros	213	108	105	24081
24	León	082	Hospital de Órbigo	1127	551	576	24082
24	León	083	Igüeña	1950	1015	935	24083
24	León	084	Izagre	266	131	135	24084
24	León	086	Joarilla de las Matas	439	229	210	24086
24	León	087	Laguna Dalga	916	461	455	24087
24	León	088	Laguna de Negrillos	1537	777	760	24088
24	León	089	León	138006	64391	73615	24089
24	León	090	Lucillo	530	267	263	24090
24	León	091	Luyego	1006	480	526	24091
24	León	092	Llamas de la Ribera	1214	616	598	24092
24	León	093	Magaz de Cepeda	518	244	274	24093
24	León	094	Mansilla de las Mulas	1756	891	865	24094
24	León	095	Mansilla Mayor	424	210	214	24095
24	León	096	Maraña	181	94	87	24096
24	León	097	Matadeón de los Oteros	305	158	147	24097
24	León	098	Matallana de Torío	1691	842	849	24098
24	León	099	Matanza	297	150	147	24099
24	León	100	Molinaseca	783	407	376	24100
24	León	101	Murias de Paredes	657	303	354	24101
24	León	102	Noceda	936	465	471	24102
24	León	103	Oencia	531	289	242	24103
24	León	104	Omañas (Las)	446	228	218	24104
24	León	105	Onzonilla	1440	719	721	24105
24	León	106	Oseja de Sajambre	360	200	160	24106
24	León	107	Pajares de los Oteros	362	188	174	24107
24	León	108	Palacios de la Valduerna	549	256	293	24108
24	León	109	Palacios del Sil	1470	749	721	24109
24	León	110	Páramo del Sil	1831	930	901	24110
24	León	112	Peranzanes	344	190	154	24112
24	León	113	Pobladura de Pelayo García	584	295	289	24113
24	León	114	Pola de Gordón (La)	4974	2400	2574	24114
24	León	115	Ponferrada	62642	30472	32170	24115
24	León	116	Posada de Valdeón	490	264	226	24116
24	León	117	Pozuelo del Páramo	642	332	310	24117
24	León	118	Prado de la Guzpeña	168	88	80	24118
24	León	119	Priaranza del Bierzo	974	496	478	24119
24	León	120	Prioro	461	241	220	24120
24	León	121	Puebla de Lillo	733	385	348	24121
24	León	122	Puente de Domingo Flórez	1985	1050	935	24122
24	León	123	Quintana del Castillo	1133	597	536	24123
24	León	124	Quintana del Marco	541	278	263	24124
24	León	125	Quintana y Congosto	814	413	401	24125
24	León	127	Regueras de Arriba	404	209	195	24127
24	León	129	Reyero	156	81	75	24129
24	León	130	Riaño	627	344	283	24130
24	León	131	Riego de la Vega	1144	557	587	24131
24	León	132	Riello	977	508	469	24132
24	León	133	Rioseco de Tapia	566	300	266	24133
24	León	134	Robla (La)	5035	2492	2543	24134
24	León	136	Roperuelos del Páramo	823	407	416	24136
24	León	137	Sabero	1876	922	954	24137
24	León	139	Sahagún	3112	1487	1625	24139
24	León	141	San Adrián del Valle	159	74	85	24141
24	León	142	San Andrés del Rabanedo	24212	11779	12433	24142
24	León	143	Sancedo	593	299	294	24143
24	León	144	San Cristóbal de la Polantera	1091	550	541	24144
24	León	145	San Emiliano	911	466	445	24145
24	León	146	San Esteban de Nogales	358	164	194	24146
24	León	148	San Justo de la Vega	2289	1163	1126	24148
24	León	149	San Millán de los Caballeros	193	98	95	24149
24	León	150	San Pedro Bercianos	389	198	191	24150
24	León	151	Santa Colomba de Curueño	634	306	328	24151
24	León	152	Santa Colomba de Somoza	464	235	229	24152
24	León	153	Santa Cristina de Valmadrigal	366	191	175	24153
24	León	154	Santa Elena de Jamuz	1401	712	689	24154
24	León	155	Santa María de la Isla	705	369	336	24155
24	León	156	Santa María del Monte de Cea	398	193	205	24156
24	León	157	Santa María del Páramo	3173	1552	1621	24157
24	León	158	Santa María de Ordás	431	208	223	24158
24	León	159	Santa Marina del Rey	2594	1283	1311	24159
24	León	160	Santas Martas	1014	526	488	24160
24	León	161	Santiago Millas	351	179	172	24161
24	León	162	Santovenia de la Valdoncina	1698	835	863	24162
24	León	163	Sariegos	2230	1127	1103	24163
24	León	164	Sena de Luna	499	247	252	24164
24	León	165	Sobrado	559	291	268	24165
24	León	166	Soto de la Vega	1999	1014	985	24166
24	León	167	Soto y Amío	1074	518	556	24167
24	León	168	Toral de los Guzmanes	697	357	340	24168
24	León	169	Toreno	4330	2207	2123	24169
24	León	170	Torre del Bierzo	3165	1589	1576	24170
24	León	171	Trabadelo	565	296	269	24171
24	León	172	Truchas	777	381	396	24172
24	León	173	Turcia	1322	659	663	24173
24	León	174	Urdiales del Páramo	719	372	347	24174
24	León	175	Valdefresno	1761	908	853	24175
24	León	176	Valdefuentes del Páramo	441	229	212	24176
24	León	177	Valdelugueros	442	246	196	24177
24	León	178	Valdemora	126	57	69	24178
24	León	179	Valdepiélago	435	219	216	24179
24	León	180	Valdepolo	1611	843	768	24180
24	León	181	Valderas	2174	1105	1069	24181
24	León	182	Valderrey	649	318	331	24182
24	León	183	Valderrueda	1278	648	630	24183
24	León	184	Valdesamario	278	137	141	24184
24	León	185	Val de San Lorenzo	767	368	399	24185
24	León	187	Valdevimbre	1208	615	593	24187
24	León	188	Valencia de Don Juan	4064	2016	2048	24188
24	León	189	Valverde de la Virgen	4152	2083	2069	24189
24	León	190	Valverde-Enrique	219	108	111	24190
24	León	191	Vallecillo	171	89	82	24191
24	León	193	Vecilla (La)	422	219	203	24193
24	León	194	Vegacervera	376	193	183	24194
24	León	196	Vega de Espinareda	2960	1479	1481	24196
24	León	197	Vega de Infanzones	892	436	456	24197
24	León	198	Vega de Valcarce	874	440	434	24198
24	León	199	Vegaquemada	548	263	285	24199
24	León	201	Vegas del Condado	1392	735	657	24201
24	León	202	Villablino	14169	7120	7049	24202
24	León	203	Villabraz	152	78	74	24203
24	León	205	Villadangos del Páramo	1024	513	511	24205
24	León	206	Villadecanes	2325	1161	1164	24206
24	León	207	Villademor de la Vega	465	247	218	24207
24	León	209	Villafranca del Bierzo	3807	1886	1921	24209
24	León	210	Villagatón	872	442	430	24210
24	León	211	Villamandos	435	207	228	24211
24	León	212	Villamañán	1437	717	720	24212
24	León	213	Villamartín de Don Sancho	194	101	93	24213
24	León	214	Villamejil	993	494	499	24214
24	León	215	Villamol	252	126	126	24215
24	León	216	Villamontán de la Valduerna	1109	560	549	24216
24	León	217	Villamoratiel de las Matas	185	110	75	24217
24	León	218	Villanueva de las Manzanas	608	296	312	24218
24	León	219	Villaobispo de Otero	718	360	358	24219
24	León	221	Villaquejida	1086	563	523	24221
24	León	222	Villaquilambre	8070	4041	4029	24222
24	León	223	Villarejo de Órbigo	3434	1670	1764	24223
24	León	224	Villares de Órbigo	953	484	469	24224
24	León	225	Villasabariego	1239	618	621	24225
24	León	226	Villaselán	321	173	148	24226
24	León	227	Villaturiel	1813	953	860	24227
24	León	228	Villazala	1052	547	505	24228
24	León	229	Villazanzo de Valderaduey	721	384	337	24229
24	León	230	Zotes del Páramo	665	355	310	24230
24	León	901	Villamanín	1301	645	656	24901
24	León	902	Villaornate y Castro	554	301	253	24902
25	Lleida	001	Abella de la Conca	197	106	91	25001
25	Lleida	002	Àger	528	284	244	25002
25	Lleida	003	Agramunt	4902	2506	2396	25003
25	Lleida	004	Alamús (Els)	698	350	348	25004
25	Lleida	005	Alàs i Cerc	400	213	187	25005
25	Lleida	006	Albagés (L')	510	265	245	25006
25	Lleida	007	Albatàrrec	1130	567	563	25007
25	Lleida	008	Albesa	1494	738	756	25008
25	Lleida	009	Albi (L')	782	407	375	25009
25	Lleida	010	Alcanó	259	133	126	25010
25	Lleida	011	Alcarràs	4767	2393	2374	25011
25	Lleida	012	Alcoletge	1770	919	851	25012
25	Lleida	013	Alfarràs	2905	1414	1491	25013
25	Lleida	014	Alfés	328	171	157	25014
25	Lleida	015	Algerri	521	254	267	25015
25	Lleida	016	Alguaire	2807	1425	1382	25016
25	Lleida	017	Alins	272	136	136	25017
25	Lleida	019	Almacelles	5564	2813	2751	25019
25	Lleida	020	Almatret	484	253	231	25020
25	Lleida	021	Almenar	3441	1763	1678	25021
25	Lleida	022	Alòs de Balaguer	187	109	78	25022
25	Lleida	023	Alpicat	4016	2005	2011	25023
25	Lleida	024	Alt Àneu	411	227	184	25024
25	Lleida	025	Naut Aran	1480	777	703	25025
25	Lleida	027	Anglesola	1277	652	625	25027
25	Lleida	029	Arbeca	2384	1220	1164	25029
25	Lleida	030	Pont de Bar (El)	160	88	72	25030
25	Lleida	031	Arres	63	32	31	25031
25	Lleida	032	Arsèguel	108	58	50	25032
25	Lleida	033	Artesa de Lleida	1326	683	643	25033
25	Lleida	034	Artesa de Segre	3169	1624	1545	25034
25	Lleida	035	Sentiu de Sió (La)	474	230	244	25035
25	Lleida	036	Aspa	267	135	132	25036
25	Lleida	037	Avellanes i Santa Linya (Les)	483	257	226	25037
25	Lleida	038	Aitona	2186	1086	1100	25038
25	Lleida	039	Baix Pallars	363	207	156	25039
25	Lleida	040	Balaguer	13275	6509	6766	25040
25	Lleida	041	Barbens	787	403	384	25041
25	Lleida	042	Baronia de Rialb (La)	266	139	127	25042
25	Lleida	043	Vall de Boí (La)	870	481	389	25043
25	Lleida	044	Bassella	308	156	152	25044
25	Lleida	045	Bausen	62	36	26	25045
25	Lleida	046	Belianes	550	260	290	25046
25	Lleida	047	Bellcaire d'Urgell	1307	626	681	25047
25	Lleida	048	Bell-lloc d'Urgell	2124	1050	1074	25048
25	Lleida	049	Bellmunt d'Urgell	231	113	118	25049
25	Lleida	050	Bellpuig	4041	2009	2032	25050
25	Lleida	051	Bellver de Cerdanya	1614	861	753	25051
25	Lleida	052	Bellvís	2173	1067	1106	25052
25	Lleida	053	Benavent de Segrià	904	469	435	25053
25	Lleida	055	Biosca	247	126	121	25055
25	Lleida	056	Bovera	396	202	194	25056
25	Lleida	057	Bòrdes (Es)	212	111	101	25057
25	Lleida	058	Borges Blanques (Les)	5212	2601	2611	25058
25	Lleida	059	Bossòst	866	434	432	25059
25	Lleida	060	Cabanabona	98	49	49	25060
25	Lleida	061	Cabó	123	71	52	25061
25	Lleida	062	Camarasa	885	449	436	25062
25	Lleida	063	Canejan	108	52	56	25063
25	Lleida	064	Castellar de la Ribera	153	70	83	25064
25	Lleida	067	Castelldans	959	483	476	25067
25	Lleida	068	Castellnou de Seana	701	362	339	25068
25	Lleida	069	Castelló de Farfanya	587	298	289	25069
25	Lleida	070	Castellserà	1107	541	566	25070
25	Lleida	071	Cava	57	34	23	25071
25	Lleida	072	Cervera	7437	3659	3778	25072
25	Lleida	073	Cervià de les Garrigues	845	438	407	25073
25	Lleida	074	Ciutadilla	213	108	105	25074
25	Lleida	075	Clariana de Cardener	145	75	70	25075
25	Lleida	076	Cogul (El)	232	121	111	25076
25	Lleida	077	Coll de Nargó	606	323	283	25077
25	Lleida	078	Corbins	1055	537	518	25078
25	Lleida	079	Cubells	382	194	188	25079
25	Lleida	081	Espluga Calba (L')	424	222	202	25081
25	Lleida	082	Espot	298	162	136	25082
25	Lleida	085	Estaràs	187	103	84	25085
25	Lleida	086	Esterri d'Àneu	646	319	327	25086
25	Lleida	087	Esterri de Cardós	75	40	35	25087
25	Lleida	088	Estamariu	123	66	57	25088
25	Lleida	089	Farrera	97	57	40	25089
25	Lleida	092	Floresta (La)	177	96	81	25092
25	Lleida	093	Fondarella	680	343	337	25093
25	Lleida	094	Foradada	215	125	90	25094
25	Lleida	096	Fuliola (La)	1251	630	621	25096
25	Lleida	097	Fulleda	116	61	55	25097
25	Lleida	098	Gavet de la Conca	322	159	163	25098
25	Lleida	099	Golmés	1336	644	692	25099
25	Lleida	100	Gósol	225	125	100	25100
25	Lleida	101	Granadella (La)	810	420	390	25101
25	Lleida	102	Granja d'Escarp (La)	1100	586	514	25102
25	Lleida	103	Granyanella	150	77	73	25103
25	Lleida	104	Granyena de Segarra	158	82	76	25104
25	Lleida	105	Granyena de les Garrigues	170	86	84	25105
25	Lleida	109	Guimerà	399	202	197	25109
25	Lleida	110	Guissona	3339	1700	1639	25110
25	Lleida	111	Guixers	151	91	60	25111
25	Lleida	112	Ivars de Noguera	338	171	167	25112
25	Lleida	113	Ivars d'Urgell	1764	907	857	25113
25	Lleida	114	Ivorra	153	72	81	25114
25	Lleida	115	Isona i Conca Dellà	1222	650	572	25115
25	Lleida	118	Juncosa	629	360	269	25118
25	Lleida	119	Juneda	2988	1503	1485	25119
25	Lleida	120	Lleida	112194	54537	57657	25120
25	Lleida	121	Les	697	351	346	25121
25	Lleida	122	Linyola	2401	1192	1209	25122
25	Lleida	123	Lladorre	234	119	115	25123
25	Lleida	124	Lladurs	244	128	116	25124
25	Lleida	125	Llardecans	625	322	303	25125
25	Lleida	126	Llavorsí	285	141	144	25126
25	Lleida	127	Lles de Cerdanya	288	161	127	25127
25	Lleida	128	Llimiana	147	81	66	25128
25	Lleida	129	Llobera	237	122	115	25129
25	Lleida	130	Maldà	292	153	139	25130
25	Lleida	131	Massalcoreig	638	305	333	25131
25	Lleida	132	Massoteres	183	95	88	25132
25	Lleida	133	Maials	985	493	492	25133
25	Lleida	134	Menàrguens	806	412	394	25134
25	Lleida	135	Miralcamp	1250	598	652	25135
25	Lleida	136	Molsosa (La)	133	68	65	25136
25	Lleida	137	Mollerussa	9581	4749	4832	25137
25	Lleida	138	Montgai	789	402	387	25138
25	Lleida	139	Montellà i Martinet	507	265	242	25139
25	Lleida	140	Montferrer i Castellbò	738	405	333	25140
25	Lleida	141	Montoliu de Segarra	192	109	83	25141
25	Lleida	142	Montoliu de Lleida	479	235	244	25142
25	Lleida	143	Montornès de Segarra	104	48	56	25143
25	Lleida	145	Nalec	105	50	55	25145
25	Lleida	146	Navès	272	131	141	25146
25	Lleida	148	Odèn	279	159	120	25148
25	Lleida	149	Oliana	1864	943	921	25149
25	Lleida	150	Oliola	227	125	102	25150
25	Lleida	151	Olius	555	282	273	25151
25	Lleida	152	Oluges (Les)	187	95	92	25152
25	Lleida	153	Omellons (Els)	264	135	129	25153
25	Lleida	154	Omells de na Gaia (Els)	152	82	70	25154
25	Lleida	155	Organyà	992	507	485	25155
25	Lleida	156	Os de Balaguer	768	401	367	25156
25	Lleida	157	Ossó de Sió	233	119	114	25157
25	Lleida	158	Palau d'Anglesola (El)	1682	831	851	25158
25	Lleida	161	Conca de Dalt	419	218	201	25161
25	Lleida	163	Coma i la Pedra (La)	240	147	93	25163
25	Lleida	164	Penelles	536	293	243	25164
25	Lleida	165	Peramola	394	212	182	25165
25	Lleida	166	Pinell de Solsonès	225	120	105	25166
25	Lleida	167	Pinós	320	174	146	25167
25	Lleida	168	Poal (El)	613	330	283	25168
25	Lleida	169	Pobla de Cérvoles (La)	212	119	93	25169
25	Lleida	170	Bellaguarda	354	174	180	25170
25	Lleida	171	Pobla de Segur (La)	2852	1385	1467	25171
25	Lleida	172	Ponts	2382	1204	1178	25172
25	Lleida	173	Pont de Suert (El)	2164	1094	1070	25173
25	Lleida	174	Portella (La)	576	311	265	25174
25	Lleida	175	Prats i Sansor	212	115	97	25175
25	Lleida	176	Preixana	440	216	224	25176
25	Lleida	177	Preixens	523	250	273	25177
25	Lleida	179	Prullans	219	116	103	25179
25	Lleida	180	Puiggròs	261	137	124	25180
25	Lleida	181	Puigverd d'Agramunt	243	136	107	25181
25	Lleida	182	Puigverd de Lleida	1043	511	532	25182
25	Lleida	183	Rialp	517	272	245	25183
25	Lleida	185	Ribera d'Urgellet	811	423	388	25185
25	Lleida	186	Riner	286	150	136	25186
25	Lleida	189	Rosselló	1852	903	949	25189
25	Lleida	190	Salàs de Pallars	330	163	167	25190
25	Lleida	191	Sanaüja	464	225	239	25191
25	Lleida	192	Sant Guim de Freixenet	1046	506	540	25192
25	Lleida	193	Sant Llorenç de Morunys	900	457	443	25193
25	Lleida	194	Sant Ramon	556	277	279	25194
25	Lleida	196	Sant Esteve de la Sarga	117	72	45	25196
25	Lleida	197	Sant Guim de la Plana	189	100	89	25197
25	Lleida	200	Sarroca de Lleida	481	242	239	25200
25	Lleida	201	Sarroca de Bellera	155	87	68	25201
25	Lleida	202	Senterada	112	59	53	25202
25	Lleida	203	Seu d'Urgell (La)	10943	5305	5638	25203
25	Lleida	204	Seròs	1737	927	810	25204
25	Lleida	205	Sidamon	527	264	263	25205
25	Lleida	206	Soleràs (El)	418	215	203	25206
25	Lleida	207	Solsona	7343	3649	3694	25207
25	Lleida	208	Soriguera	308	158	150	25208
25	Lleida	209	Sort	1791	897	894	25209
25	Lleida	210	Soses	1537	801	736	25210
25	Lleida	211	Sudanell	712	385	327	25211
25	Lleida	212	Sunyer	300	148	152	25212
25	Lleida	215	Talarn	364	184	180	25215
25	Lleida	216	Talavera	296	155	141	25216
25	Lleida	217	Tàrrega	12548	6063	6485	25217
25	Lleida	218	Tarrés	105	58	47	25218
25	Lleida	219	Tarroja de Segarra	178	88	90	25219
25	Lleida	220	Térmens	1404	706	698	25220
25	Lleida	221	Tírvia	122	67	55	25221
25	Lleida	222	Tiurana	23	16	7	25222
25	Lleida	223	Torà	1191	599	592	25223
25	Lleida	224	Torms (Els)	197	106	91	25224
25	Lleida	225	Tornabous	820	415	405	25225
25	Lleida	226	Torrebesses	323	159	164	25226
25	Lleida	227	Torre de Cabdella (La)	679	339	340	25227
25	Lleida	228	Torrefarrera	1734	884	850	25228
25	Lleida	230	Torregrossa	2242	1107	1135	25230
25	Lleida	231	Torrelameu	578	317	261	25231
25	Lleida	232	Torres de Segre	1815	932	883	25232
25	Lleida	233	Torre-serona	326	162	164	25233
25	Lleida	234	Tremp	5377	2650	2727	25234
25	Lleida	238	Vallbona de les Monges	266	128	138	25238
25	Lleida	239	Valls de Valira (Les)	757	413	344	25239
25	Lleida	240	Vallfogona de Balaguer	1505	756	749	25240
25	Lleida	242	Verdú	1041	498	543	25242
25	Lleida	243	Vielha e Mijaran	4139	2079	2060	25243
25	Lleida	244	Vilagrassa	453	243	210	25244
25	Lleida	245	Vilaller	578	303	275	25245
25	Lleida	247	Vilamòs	152	78	74	25247
25	Lleida	248	Vilanova de Bellpuig	1139	567	572	25248
25	Lleida	249	Vilanova de l'Aguda	273	140	133	25249
25	Lleida	250	Vilanova de Meià	473	244	229	25250
25	Lleida	251	Vilanova de Segrià	789	405	384	25251
25	Lleida	252	Vila-sana	514	252	262	25252
25	Lleida	253	Vilosell (El)	197	88	109	25253
25	Lleida	254	Vilanova de la Barca	921	459	462	25254
25	Lleida	255	Vinaixa	627	302	325	25255
25	Lleida	901	Vall de Cardós	318	166	152	25901
25	Lleida	902	Sant Martí de Riucorb	696	356	340	25902
25	Lleida	903	Guingueta d'Àneu (La)	313	161	152	25903
25	Lleida	904	Castell de Mur	149	78	71	25904
25	Lleida	905	Ribera d'Ondara	516	269	247	25905
25	Lleida	906	Valls d'Aguilar (Les)	296	161	135	25906
25	Lleida	907	Torrefeta i Florejacs	658	332	326	25907
25	Lleida	908	Fígols i Alinyà	296	162	134	25908
25	Lleida	909	Vansa i Fórnols (La)	170	87	83	25909
25	Lleida	910	Josa i Tuixén	169	90	79	25910
25	Lleida	911	Plans de Sió (Els)	595	308	287	25911
25	Lleida	912	Gimenells i el Pla de la Font	1124	587	537	25912
25	Lleida	913	Riu de Cerdanya	81	39	42	25913
26	Rioja (La)	001	Ábalos	276	157	119	26001
26	Rioja (La)	002	Agoncillo	875	458	417	26002
26	Rioja (La)	003	Aguilar del Río Alhama	687	351	336	26003
26	Rioja (La)	004	Ajamil	61	39	22	26004
26	Rioja (La)	005	Albelda de Iregua	2299	1166	1133	26005
26	Rioja (La)	006	Alberite	2012	1006	1006	26006
26	Rioja (La)	007	Alcanadre	793	409	384	26007
26	Rioja (La)	008	Aldeanueva de Ebro	2491	1294	1197	26008
26	Rioja (La)	009	Alesanco	480	245	235	26009
26	Rioja (La)	010	Alesón	142	71	71	26010
26	Rioja (La)	011	Alfaro	9083	4566	4517	26011
26	Rioja (La)	012	Almarza de Cameros	39	24	15	26012
26	Rioja (La)	013	Anguciana	45	29	16	26013
26	Rioja (La)	014	Anguiano	585	322	263	26014
26	Rioja (La)	015	Arenzana de Abajo	308	160	148	26015
26	Rioja (La)	016	Arenzana de Arriba	39	21	18	26016
26	Rioja (La)	017	Arnedillo	439	212	227	26017
26	Rioja (La)	018	Arnedo	12855	6399	6456	26018
26	Rioja (La)	019	Arrúbal	434	225	209	26019
26	Rioja (La)	020	Ausejo	700	381	319	26020
26	Rioja (La)	021	Autol	1959	1005	954	26021
26	Rioja (La)	022	Azofra	344	186	158	26022
26	Rioja (La)	023	Badarán	729	391	338	26023
26	Rioja (La)	024	Bañares	390	198	192	26024
26	Rioja (La)	025	Baños de Rioja	110	64	46	26025
26	Rioja (La)	026	Baños de Río Tobía	1758	904	854	26026
26	Rioja (La)	027	Berceo	222	136	86	26027
26	Rioja (La)	028	Bergasa	137	75	62	26028
26	Rioja (La)	029	Bergasillas Bajera	30	17	13	26029
26	Rioja (La)	030	Bezares	31	19	12	26030
26	Rioja (La)	031	Bobadilla	162	93	69	26031
26	Rioja (La)	032	Brieva de Cameros	70	41	29	26032
26	Rioja (La)	033	Briñas	206	105	101	26033
26	Rioja (La)	034	Briones	818	432	386	26034
26	Rioja (La)	035	Cabezón de Cameros	30	21	9	26035
26	Rioja (La)	036	Calahorra	18924	9172	9752	26036
26	Rioja (La)	037	Camprovín	216	115	101	26037
26	Rioja (La)	038	Canales de la Sierra	83	44	39	26038
26	Rioja (La)	039	Canillas de Río Tuerto	67	32	35	26039
26	Rioja (La)	040	Cañas	111	51	60	26040
26	Rioja (La)	041	Cárdenas	241	117	124	26041
26	Rioja (La)	042	Casalarreina	901	452	449	26042
26	Rioja (La)	043	Castañares de Rioja	459	230	229	26043
26	Rioja (La)	044	Castroviejo	61	31	30	26044
26	Rioja (La)	045	Cellorigo	21	11	10	26045
26	Rioja (La)	046	Cenicero	2055	1037	1018	26046
26	Rioja (La)	047	Cervera del Río Alhama	2960	1528	1432	26047
26	Rioja (La)	048	Cidamón	46	24	22	26048
26	Rioja (La)	049	Cihuri	153	80	73	26049
26	Rioja (La)	050	Cirueña	122	71	51	26050
26	Rioja (La)	051	Clavijo	190	100	90	26051
26	Rioja (La)	052	Cordovín	213	109	104	26052
26	Rioja (La)	053	Corera	250	120	130	26053
26	Rioja (La)	054	Cornago	567	307	260	26054
26	Rioja (La)	055	Corporales	62	31	31	26055
26	Rioja (La)	056	Cuzcurrita de Río Tirón	470	254	216	26056
26	Rioja (La)	057	Daroca de Rioja	53	32	21	26057
26	Rioja (La)	058	Enciso	169	104	65	26058
26	Rioja (La)	059	Entrena	1130	588	542	26059
26	Rioja (La)	060	Estollo	144	80	64	26060
26	Rioja (La)	061	Ezcaray	1861	995	866	26061
26	Rioja (La)	062	Foncea	123	65	58	26062
26	Rioja (La)	063	Fonzaleche	168	100	68	26063
26	Rioja (La)	064	Fuenmayor	2301	1166	1135	26064
26	Rioja (La)	065	Galbárruli	71	41	30	26065
26	Rioja (La)	066	Galilea	278	142	136	26066
26	Rioja (La)	067	Gallinero de Cameros	27	18	9	26067
26	Rioja (La)	068	Gimileo	91	42	49	26068
26	Rioja (La)	069	Grañón	412	215	197	26069
26	Rioja (La)	070	Grávalos	273	138	135	26070
26	Rioja (La)	071	Haro	9245	4556	4689	26071
26	Rioja (La)	072	Herce	352	182	170	26072
26	Rioja (La)	073	Herramélluri	162	86	76	26073
26	Rioja (La)	074	Hervías	180	93	87	26074
26	Rioja (La)	075	Hormilla	465	240	225	26075
26	Rioja (La)	076	Hormilleja	174	87	87	26076
26	Rioja (La)	077	Hornillos de Cameros	22	11	11	26077
26	Rioja (La)	078	Hornos de Moncalvillo	95	44	51	26078
26	Rioja (La)	079	Huércanos	889	459	430	26079
26	Rioja (La)	080	Igea	766	415	351	26080
26	Rioja (La)	081	Jalón de Cameros	47	27	20	26081
26	Rioja (La)	082	Laguna de Cameros	176	98	78	26082
26	Rioja (La)	083	Lagunilla del Jubera	332	178	154	26083
26	Rioja (La)	084	Lardero	3183	1592	1591	26084
26	Rioja (La)	086	Ledesma de la Cogolla	21	15	6	26086
26	Rioja (La)	087	Leiva	291	143	148	26087
26	Rioja (La)	088	Leza de Río Leza	28	19	9	26088
26	Rioja (La)	089	Logroño	128493	61723	66770	26089
26	Rioja (La)	091	Lumbreras	156	95	61	26091
26	Rioja (La)	092	Manjarrés	142	81	61	26092
26	Rioja (La)	093	Mansilla de la Sierra	49	33	16	26093
26	Rioja (La)	094	Manzanares de Rioja	116	64	52	26094
26	Rioja (La)	095	Matute	23	11	12	26095
26	Rioja (La)	096	Medrano	211	112	99	26096
26	Rioja (La)	098	Munilla	120	62	58	26098
26	Rioja (La)	099	Murillo de Río Leza	1461	741	720	26099
26	Rioja (La)	100	Muro de Aguas	70	41	29	26100
26	Rioja (La)	101	Muro en Cameros	40	26	14	26101
26	Rioja (La)	102	Nájera	7076	3542	3534	26102
26	Rioja (La)	103	Nalda	813	427	386	26103
26	Rioja (La)	104	Navajún	18	12	6	26104
26	Rioja (La)	105	Navarrete	2087	1077	1010	26105
26	Rioja (La)	106	Nestares	73	39	34	26106
26	Rioja (La)	107	Nieva de Cameros	114	59	55	26107
26	Rioja (La)	108	Ocón	328	196	132	26108
26	Rioja (La)	109	Ochánduri	100	50	50	26109
26	Rioja (La)	110	Ojacastro	249	148	101	26110
26	Rioja (La)	111	Ollauri	306	169	137	26111
26	Rioja (La)	112	Ortigosa de Cameros	316	168	148	26112
26	Rioja (La)	113	Pazuengos	46	28	18	26113
26	Rioja (La)	114	Pedroso	108	62	46	26114
26	Rioja (La)	115	Pinillos	31	17	14	26115
26	Rioja (La)	117	Pradejón	3019	1589	1430	26117
26	Rioja (La)	118	Pradillo	79	42	37	26118
26	Rioja (La)	119	Préjano	214	104	110	26119
26	Rioja (La)	120	Quel	1888	991	897	26120
26	Rioja (La)	121	Rabanera	38	27	11	26121
26	Rioja (La)	122	Rasillo de Cameros (El)	111	61	50	26122
26	Rioja (La)	123	Redal (El)	200	102	98	26123
26	Rioja (La)	124	Ribafrecha	967	528	439	26124
26	Rioja (La)	125	Rincón de Soto	2474	1322	1152	26125
26	Rioja (La)	126	Robres del Castillo	16	10	6	26126
26	Rioja (La)	127	Rodezno	318	172	146	26127
26	Rioja (La)	128	Sajazarra	139	71	68	26128
26	Rioja (La)	129	San Asensio	1195	619	576	26129
26	Rioja (La)	130	San Millán de la Cogolla	264	162	102	26130
26	Rioja (La)	131	San Millán de Yécora	51	31	20	26131
26	Rioja (La)	132	San Román de Cameros	162	89	73	26132
26	Rioja (La)	134	Santa Coloma	142	88	54	26134
26	Rioja (La)	135	Santa Engracia del Jubera	201	117	84	26135
26	Rioja (La)	136	Santa Eulalia Bajera	119	68	51	26136
26	Rioja (La)	138	Santo Domingo de la Calzada	5724	2878	2846	26138
26	Rioja (La)	139	San Torcuato	97	55	42	26139
26	Rioja (La)	140	Santurde de Rioja	290	145	145	26140
26	Rioja (La)	141	Santurdejo	184	102	82	26141
26	Rioja (La)	142	San Vicente de la Sonsierra	1104	571	533	26142
26	Rioja (La)	143	Sojuela	81	47	34	26143
26	Rioja (La)	144	Sorzano	218	112	106	26144
26	Rioja (La)	145	Sotés	217	128	89	26145
26	Rioja (La)	146	Soto en Cameros	165	90	75	26146
26	Rioja (La)	147	Terroba	32	17	15	26147
26	Rioja (La)	148	Tirgo	267	136	131	26148
26	Rioja (La)	149	Tobía	40	21	19	26149
26	Rioja (La)	150	Tormantos	213	114	99	26150
26	Rioja (La)	151	Torrecilla en Cameros	555	297	258	26151
26	Rioja (La)	152	Torrecilla sobre Alesanco	78	39	39	26152
26	Rioja (La)	153	Torre en Cameros	14	11	3	26153
26	Rioja (La)	154	Torremontalbo	16	10	6	26154
26	Rioja (La)	155	Treviana	251	132	119	26155
26	Rioja (La)	157	Tricio	338	161	177	26157
26	Rioja (La)	158	Tudelilla	422	211	211	26158
26	Rioja (La)	160	Uruñuela	738	380	358	26160
26	Rioja (La)	161	Valdemadera	13	9	4	26161
26	Rioja (La)	162	Valgañón	157	85	72	26162
26	Rioja (La)	163	Ventosa	131	70	61	26163
26	Rioja (La)	164	Ventrosa	87	38	49	26164
26	Rioja (La)	165	Viguera	357	207	150	26165
26	Rioja (La)	166	Villalba de Rioja	148	87	61	26166
26	Rioja (La)	167	Villalobar de Rioja	123	74	49	26167
26	Rioja (La)	168	Villamediana de Iregua	2260	1181	1079	26168
26	Rioja (La)	169	Villanueva de Cameros	122	64	58	26169
26	Rioja (La)	170	Villar de Arnedo (El)	632	304	328	26170
26	Rioja (La)	171	Villar de Torre	306	160	146	26171
26	Rioja (La)	172	Villarejo	50	31	19	26172
26	Rioja (La)	173	Villarroya	9	4	5	26173
26	Rioja (La)	174	Villarta-Quintana	212	106	106	26174
26	Rioja (La)	175	Villavelayo	73	42	31	26175
26	Rioja (La)	176	Villaverde de Rioja	95	55	40	26176
26	Rioja (La)	177	Villoslada de Cameros	388	230	158	26177
26	Rioja (La)	178	Viniegra de Abajo	121	64	57	26178
26	Rioja (La)	179	Viniegra de Arriba	55	34	21	26179
26	Rioja (La)	180	Zarratón	258	133	125	26180
26	Rioja (La)	181	Zarzosa	12	9	3	26181
26	Rioja (La)	183	Zorraquín	42	27	15	26183
27	Lugo	001	Abadín	3516	1668	1848	27001
27	Lugo	002	Alfoz	2462	1191	1271	27002
27	Lugo	003	Antas de Ulla	2769	1327	1442	27003
27	Lugo	004	Baleira	1923	993	930	27004
27	Lugo	005	Barreiros	3446	1662	1784	27005
27	Lugo	006	Becerreá	3732	1883	1849	27006
27	Lugo	007	Begonte	3818	1896	1922	27007
27	Lugo	008	Bóveda	2048	985	1063	27008
27	Lugo	009	Carballedo	3238	1611	1627	27009
27	Lugo	010	Castro de Rei	5961	2972	2989	27010
27	Lugo	011	Castroverde	3532	1811	1721	27011
27	Lugo	012	Cervantes	2243	1222	1021	27012
27	Lugo	013	Cervo	5082	2543	2539	27013
27	Lugo	014	Corgo (O)	4266	2151	2115	27014
27	Lugo	015	Cospeito	5931	2916	3015	27015
27	Lugo	016	Chantada	9823	4829	4994	27016
27	Lugo	017	Folgoso do Courel	1593	808	785	27017
27	Lugo	018	Fonsagrada (A)	5448	2858	2590	27018
27	Lugo	019	Foz	9558	4545	5013	27019
27	Lugo	020	Friol	4837	2405	2432	27020
27	Lugo	021	Xermade	2728	1329	1399	27021
27	Lugo	022	Guitiriz	6358	3137	3221	27022
27	Lugo	023	Guntín	3554	1776	1778	27023
27	Lugo	024	Incio (O)	2540	1240	1300	27024
27	Lugo	025	Xove	3629	1807	1822	27025
27	Lugo	026	Láncara	3331	1715	1616	27026
27	Lugo	027	Lourenzá	2849	1376	1473	27027
27	Lugo	028	Lugo	88235	41415	46820	27028
27	Lugo	029	Meira	1852	900	952	27029
27	Lugo	030	Mondoñedo	5135	2379	2756	27030
27	Lugo	031	Monforte de Lemos	19712	9390	10322	27031
27	Lugo	032	Monterroso	4267	2114	2153	27032
27	Lugo	033	Muras	1151	569	582	27033
27	Lugo	034	Navia de Suarna	1974	1053	921	27034
27	Lugo	035	Negueira de Muñiz	261	137	124	27035
27	Lugo	037	Nogais (As)	1596	816	780	27037
27	Lugo	038	Ourol	1577	770	807	27038
27	Lugo	039	Outeiro de Rei	4256	2147	2109	27039
27	Lugo	040	Palas de Rei	4330	2116	2214	27040
27	Lugo	041	Pantón	3540	1673	1867	27041
27	Lugo	042	Paradela	2655	1316	1339	27042
27	Lugo	043	Páramo (O)	1938	989	949	27043
27	Lugo	044	Pastoriza (A)	4106	2046	2060	27044
27	Lugo	045	Pedrafita do Cebreiro	1630	872	758	27045
27	Lugo	046	Pol	2177	1066	1111	27046
27	Lugo	047	Pobra do Brollón (A)	2648	1285	1363	27047
27	Lugo	048	Pontenova (A)	3389	1658	1731	27048
27	Lugo	049	Portomarín	2099	1021	1078	27049
27	Lugo	050	Quiroga	4342	2094	2248	27050
27	Lugo	051	Ribadeo	9034	4231	4803	27051
27	Lugo	052	Ribas de Sil	1463	696	767	27052
27	Lugo	053	Ribeira de Piquín	886	434	452	27053
27	Lugo	054	Riotorto	1920	948	972	27054
27	Lugo	055	Samos	2157	1122	1035	27055
27	Lugo	056	Rábade	1607	801	806	27056
27	Lugo	057	Sarria	13018	6353	6665	27057
27	Lugo	058	Saviñao (O)	5104	2474	2630	27058
27	Lugo	059	Sober	3112	1503	1609	27059
27	Lugo	060	Taboada	4227	2038	2189	27060
27	Lugo	061	Trabada	1686	818	868	27061
27	Lugo	062	Triacastela	939	458	481	27062
27	Lugo	063	Valadouro (O)	2445	1219	1226	27063
27	Lugo	064	Vicedo (O)	2392	1178	1214	27064
27	Lugo	065	Vilalba	15699	7682	8017	27065
27	Lugo	066	Viveiro	15456	7468	7988	27066
27	Lugo	901	Baralla	3344	1717	1627	27901
27	Lugo	902	Burela	8045	3972	4073	27902
28	Madrid	001	Acebeda (La)	57	31	26	28001
28	Madrid	002	Ajalvir	2205	1154	1051	28002
28	Madrid	003	Alameda del Valle	198	111	87	28003
28	Madrid	004	Álamo (El)	4676	2656	2020	28004
28	Madrid	005	Alcalá de Henares	166397	82753	83644	28005
28	Madrid	006	Alcobendas	89612	44103	45509	28006
28	Madrid	007	Alcorcón	144636	71408	73228	28007
28	Madrid	008	Aldea del Fresno	1449	755	694	28008
28	Madrid	009	Algete	14731	7467	7264	28009
28	Madrid	010	Alpedrete	7286	3682	3604	28010
28	Madrid	011	Ambite	307	155	152	28011
28	Madrid	012	Anchuelo	579	317	262	28012
28	Madrid	013	Aranjuez	39652	19159	20493	28013
28	Madrid	014	Arganda del Rey	30662	15225	15437	28014
28	Madrid	015	Arroyomolinos	3824	1965	1859	28015
28	Madrid	016	Atazar (El)	87	47	40	28016
28	Madrid	017	Batres	844	435	409	28017
28	Madrid	018	Becerril de la Sierra	3246	1683	1563	28018
28	Madrid	019	Belmonte de Tajo	1158	589	569	28019
28	Madrid	020	Berzosa del Lozoya	118	59	59	28020
28	Madrid	021	Berrueco (El)	315	173	142	28021
28	Madrid	022	Boadilla del Monte	20686	10432	10254	28022
28	Madrid	023	Boalo (El)	3092	1588	1504	28023
28	Madrid	024	Braojos	160	90	70	28024
28	Madrid	025	Brea de Tajo	458	233	225	28025
28	Madrid	026	Brunete	5080	2506	2574	28026
28	Madrid	027	Buitrago del Lozoya	1471	723	748	28027
28	Madrid	028	Bustarviejo	1442	741	701	28028
28	Madrid	029	Cabanillas de la Sierra	453	240	213	28029
28	Madrid	030	Cabrera (La)	1689	843	846	28030
28	Madrid	031	Cadalso de los Vidrios	2248	1148	1100	28031
28	Madrid	032	Camarma de Esteruelas	2391	1212	1179	28032
28	Madrid	033	Campo Real	2735	1383	1352	28033
28	Madrid	034	Canencia	441	229	212	28034
28	Madrid	035	Carabaña	1118	556	562	28035
28	Madrid	036	Casarrubuelos	731	393	338	28036
28	Madrid	037	Cenicientos	1864	915	949	28037
28	Madrid	038	Cercedilla	5644	2818	2826	28038
28	Madrid	039	Cervera de Buitrago	85	51	34	28039
28	Madrid	040	Ciempozuelos	13564	6899	6665	28040
28	Madrid	041	Cobeña	2791	1417	1374	28041
28	Madrid	042	Colmenar del Arroyo	872	419	453	28042
28	Madrid	043	Colmenar de Oreja	5412	2647	2765	28043
28	Madrid	044	Colmenarejo	4395	2199	2196	28044
28	Madrid	045	Colmenar Viejo	32459	16111	16348	28045
28	Madrid	046	Collado Mediano	4529	2292	2237	28046
28	Madrid	047	Collado Villalba	42238	21075	21163	28047
28	Madrid	048	Corpa	354	179	175	28048
28	Madrid	049	Coslada	77057	38285	38772	28049
28	Madrid	050	Cubas de la Sagra	1689	825	864	28050
28	Madrid	051	Chapinería	1360	691	669	28051
28	Madrid	052	Chinchón	4168	2094	2074	28052
28	Madrid	053	Daganzo de Arriba	3830	1939	1891	28053
28	Madrid	054	Escorial (El)	10549	5245	5304	28054
28	Madrid	055	Estremera	1028	516	512	28055
28	Madrid	056	Fresnedillas de la Oliva	769	395	374	28056
28	Madrid	057	Fresno de Torote	643	365	278	28057
28	Madrid	058	Fuenlabrada	173788	87695	86093	28058
28	Madrid	059	Fuente el Saz de Jarama	4004	2080	1924	28059
28	Madrid	060	Fuentidueña de Tajo	1446	701	745	28060
28	Madrid	061	Galapagar	21807	11002	10805	28061
28	Madrid	062	Garganta de los Montes	325	173	152	28062
28	Madrid	063	Gargantilla del Lozoya	227	138	89	28063
28	Madrid	064	Gascones	107	55	52	28064
28	Madrid	065	Getafe	146310	72629	73681	28065
28	Madrid	066	Griñón	4488	2293	2195	28066
28	Madrid	067	Guadalix de la Sierra	3100	1605	1495	28067
28	Madrid	068	Guadarrama	9389	4627	4762	28068
28	Madrid	069	Hiruela (La)	74	35	39	28069
28	Madrid	070	Horcajo de la Sierra	144	77	67	28070
28	Madrid	071	Horcajuelo de la Sierra	103	45	58	28071
28	Madrid	072	Hoyo de Manzanares	5667	2894	2773	28072
28	Madrid	073	Humanes de Madrid	9424	4834	4590	28073
28	Madrid	074	Leganés	172049	85530	86519	28074
28	Madrid	075	Loeches	2985	1463	1522	28075
28	Madrid	076	Lozoya	434	222	212	28076
28	Madrid	078	Madarcos	21	11	10	28078
28	Madrid	079	Madrid	2882860	1345601	1537259	28079
28	Madrid	080	Majadahonda	45819	22178	23641	28080
28	Madrid	082	Manzanares el Real	3842	2015	1827	28082
28	Madrid	083	Meco	6328	3251	3077	28083
28	Madrid	084	Mejorada del Campo	15771	7914	7857	28084
28	Madrid	085	Miraflores de la Sierra	3678	1848	1830	28085
28	Madrid	086	Molar (El)	3695	1954	1741	28086
28	Madrid	087	Molinos (Los)	3322	1602	1720	28087
28	Madrid	088	Montejo de la Sierra	313	155	158	28088
28	Madrid	089	Moraleja de Enmedio	3056	1538	1518	28089
28	Madrid	090	Moralzarzal	5379	2737	2642	28090
28	Madrid	091	Morata de Tajuña	5383	2659	2724	28091
28	Madrid	092	Móstoles	196289	97383	98906	28092
28	Madrid	093	Navacerrada	1880	944	936	28093
28	Madrid	094	Navalafuente	541	292	249	28094
28	Madrid	095	Navalagamella	1128	562	566	28095
28	Madrid	096	Navalcarnero	13522	6839	6683	28096
28	Madrid	097	Navarredonda y San Mamés	108	61	47	28097
28	Madrid	099	Navas del Rey	1655	871	784	28099
28	Madrid	100	Nuevo Baztán	3380	1744	1636	28100
28	Madrid	101	Olmeda de las Fuentes	152	81	71	28101
28	Madrid	102	Orusco de Tajuña	647	337	310	28102
28	Madrid	104	Paracuellos de Jarama	5889	3013	2876	28104
28	Madrid	106	Parla	74203	37208	36995	28106
28	Madrid	107	Patones	352	182	170	28107
28	Madrid	108	Pedrezuela	1425	753	672	28108
28	Madrid	109	Pelayos de la Presa	1328	653	675	28109
28	Madrid	110	Perales de Tajuña	2072	1014	1058	28110
28	Madrid	111	Pezuela de las Torres	487	261	226	28111
28	Madrid	112	Pinilla del Valle	156	86	70	28112
28	Madrid	113	Pinto	28726	14404	14322	28113
28	Madrid	114	Piñuécar-Gandullas	145	68	77	28114
28	Madrid	115	Pozuelo de Alarcón	66298	32374	33924	28115
28	Madrid	116	Pozuelo del Rey	188	101	87	28116
28	Madrid	117	Prádena del Rincón	95	53	42	28117
28	Madrid	118	Puebla de la Sierra	71	40	31	28118
28	Madrid	119	Quijorna	1078	583	495	28119
28	Madrid	120	Rascafría	1615	849	766	28120
28	Madrid	121	Redueña	179	89	90	28121
28	Madrid	122	Ribatejada	381	207	174	28122
28	Madrid	123	Rivas-Vaciamadrid	29092	14582	14510	28123
28	Madrid	124	Robledillo de la Jara	91	41	50	28124
28	Madrid	125	Robledo de Chavela	2327	1162	1165	28125
28	Madrid	126	Robregordo	89	45	44	28126
28	Madrid	127	Rozas de Madrid (Las)	54676	26776	27900	28127
28	Madrid	128	Rozas de Puerto Real	283	151	132	28128
28	Madrid	129	San Agustín de Guadalix	5859	2936	2923	28129
28	Madrid	130	San Fernando de Henares	32364	16238	16126	28130
28	Madrid	131	San Lorenzo de El Escorial	11783	5701	6082	28131
28	Madrid	132	San Martín de la Vega	10630	5421	5209	28132
28	Madrid	133	San Martín de Valdeiglesias	6089	3007	3082	28133
28	Madrid	134	San Sebastián de los Reyes	58389	29121	29268	28134
28	Madrid	135	Santa María de la Alameda	710	384	326	28135
28	Madrid	136	Santorcaz	561	296	265	28136
28	Madrid	137	Santos de la Humosa (Los)	906	462	444	28137
28	Madrid	138	Serna del Monte (La)	114	57	57	28138
28	Madrid	140	Serranillos del Valle	923	485	438	28140
28	Madrid	141	Sevilla la Nueva	3632	1898	1734	28141
28	Madrid	143	Somosierra	93	52	41	28143
28	Madrid	144	Soto del Real	5347	2718	2629	28144
28	Madrid	145	Talamanca de Jarama	1444	711	733	28145
28	Madrid	146	Tielmes	1922	989	933	28146
28	Madrid	147	Titulcia	940	475	465	28147
28	Madrid	148	Torrejón de Ardoz	94161	44861	49300	28148
28	Madrid	149	Torrejón de la Calzada	4208	2106	2102	28149
28	Madrid	150	Torrejón de Velasco	1908	1008	900	28150
28	Madrid	151	Torrelaguna	2768	1353	1415	28151
28	Madrid	152	Torrelodones	13467	6616	6851	28152
28	Madrid	153	Torremocha de Jarama	342	182	160	28153
28	Madrid	154	Torres de la Alameda	4356	2203	2153	28154
28	Madrid	155	Valdaracete	617	300	317	28155
28	Madrid	156	Valdeavero	597	320	277	28156
28	Madrid	157	Valdelaguna	560	296	264	28157
28	Madrid	158	Valdemanco	533	283	250	28158
28	Madrid	159	Valdemaqueda	570	287	283	28159
28	Madrid	160	Valdemorillo	5824	3002	2822	28160
28	Madrid	161	Valdemoro	28243	14160	14083	28161
28	Madrid	162	Valdeolmos-Alalpardo	1775	934	841	28162
28	Madrid	163	Valdepiélagos	305	157	148	28163
28	Madrid	164	Valdetorres de Jarama	2001	1034	967	28164
28	Madrid	165	Valdilecha	1860	953	907	28165
28	Madrid	166	Valverde de Alcalá	302	153	149	28166
28	Madrid	167	Velilla de San Antonio	6767	3473	3294	28167
28	Madrid	168	Vellón (El)	1129	579	550	28168
28	Madrid	169	Venturada	819	432	387	28169
28	Madrid	170	Villaconejos	2870	1457	1413	28170
28	Madrid	171	Villa del Prado	3932	2009	1923	28171
28	Madrid	172	Villalbilla	4156	2188	1968	28172
28	Madrid	173	Villamanrique de Tajo	593	297	296	28173
28	Madrid	174	Villamanta	1571	808	763	28174
28	Madrid	175	Villamantilla	334	175	159	28175
28	Madrid	176	Villanueva de la Cañada	10706	5315	5391	28176
28	Madrid	177	Villanueva del Pardillo	4733	2396	2337	28177
28	Madrid	178	Villanueva de Perales	467	258	209	28178
28	Madrid	179	Villar del Olmo	1427	726	701	28179
28	Madrid	180	Villarejo de Salvanés	5650	2820	2830	28180
28	Madrid	181	Villaviciosa de Odón	19393	9616	9777	28181
28	Madrid	182	Villavieja del Lozoya	178	86	92	28182
28	Madrid	183	Zarzalejo	1046	533	513	28183
28	Madrid	901	Lozoyuela-Navas-Sieteiglesias	654	353	301	28901
28	Madrid	902	Puentes Viejas	414	227	187	28902
28	Madrid	903	Tres Cantos	35046	17387	17659	28903
29	Málaga	001	Alameda	5002	2484	2518	29001
29	Málaga	002	Alcaucín	1511	758	753	29002
29	Málaga	003	Alfarnate	1443	741	702	29003
29	Málaga	004	Alfarnatejo	399	213	186	29004
29	Málaga	005	Algarrobo	4852	2402	2450	29005
29	Málaga	006	Algatocín	949	478	471	29006
29	Málaga	007	Alhaurín de la Torre	21649	10796	10853	29007
29	Málaga	008	Alhaurín el Grande	17021	8509	8512	29008
29	Málaga	009	Almáchar	1904	970	934	29009
29	Málaga	010	Almargen	2104	1012	1092	29010
29	Málaga	011	Almogía	4072	2057	2015	29011
29	Málaga	012	Álora	12509	6263	6246	29012
29	Málaga	013	Alozaina	2145	1119	1026	29013
29	Málaga	014	Alpandeire	316	160	156	29014
29	Málaga	015	Antequera	40598	19867	20731	29015
29	Málaga	016	Árchez	352	176	176	29016
29	Málaga	017	Archidona	8171	4046	4125	29017
29	Málaga	018	Ardales	2903	1425	1478	29018
29	Málaga	019	Arenas	1191	643	548	29019
29	Málaga	020	Arriate	3420	1651	1769	29020
29	Málaga	021	Atajate	164	88	76	29021
29	Málaga	022	Benadalid	262	137	125	29022
29	Málaga	023	Benahavís	2079	1040	1039	29023
29	Málaga	024	Benalauría	499	258	241	29024
29	Málaga	025	Benalmádena	31964	15709	16255	29025
29	Málaga	026	Benamargosa	1551	785	766	29026
29	Málaga	027	Benamocarra	2811	1405	1406	29027
29	Málaga	028	Benaoján	1648	819	829	29028
29	Málaga	029	Benarrabá	630	333	297	29029
29	Málaga	030	Borge (El)	1021	520	501	29030
29	Málaga	031	Burgo (El)	1982	1009	973	29031
29	Málaga	032	Campillos	7657	3836	3821	29032
29	Málaga	033	Canillas de Aceituno	2213	1112	1101	29033
29	Málaga	034	Canillas de Albaida	701	372	329	29034
29	Málaga	035	Cañete la Real	2200	1131	1069	29035
29	Málaga	036	Carratraca	838	413	425	29036
29	Málaga	037	Cartajima	214	112	102	29037
29	Málaga	038	Cártama	13188	6650	6538	29038
29	Málaga	039	Casabermeja	3003	1570	1433	29039
29	Málaga	040	Casarabonela	2553	1291	1262	29040
29	Málaga	041	Casares	3309	1728	1581	29041
29	Málaga	042	Coín	17868	8893	8975	29042
29	Málaga	043	Colmenar	3124	1523	1601	29043
29	Málaga	044	Comares	1399	721	678	29044
29	Málaga	045	Cómpeta	2793	1408	1385	29045
29	Málaga	046	Cortes de la Frontera	3513	1760	1753	29046
29	Málaga	047	Cuevas Bajas	1473	710	763	29047
29	Málaga	048	Cuevas del Becerro	1960	984	976	29048
29	Málaga	049	Cuevas de San Marcos	4008	1975	2033	29049
29	Málaga	050	Cútar	603	304	299	29050
29	Málaga	051	Estepona	42157	20898	21259	29051
29	Málaga	052	Faraján	288	131	157	29052
29	Málaga	053	Frigiliana	2169	1067	1102	29053
29	Málaga	054	Fuengirola	47914	23444	24470	29054
29	Málaga	055	Fuente de Piedra	1913	923	990	29055
29	Málaga	056	Gaucín	1705	888	817	29056
29	Málaga	057	Genalguacil	575	297	278	29057
29	Málaga	058	Guaro	1877	948	929	29058
29	Málaga	059	Humilladero	2469	1253	1216	29059
29	Málaga	060	Igualeja	922	462	460	29060
29	Málaga	061	Istán	1348	674	674	29061
29	Málaga	062	Iznate	757	385	372	29062
29	Málaga	063	Jimera de Líbar	401	193	208	29063
29	Málaga	064	Jubrique	843	418	425	29064
29	Málaga	065	Júzcar	242	134	108	29065
29	Málaga	066	Macharaviaya	353	191	162	29066
29	Málaga	067	Málaga	531565	252570	278995	29067
29	Málaga	068	Manilva	5768	2936	2832	29068
29	Málaga	069	Marbella	105910	52263	53647	29069
29	Málaga	070	Mijas	41912	20973	20939	29070
29	Málaga	071	Moclinejo	1116	567	549	29071
29	Málaga	072	Mollina	3416	1663	1753	29072
29	Málaga	073	Monda	1685	838	847	29073
29	Málaga	074	Montejaque	1008	487	521	29074
29	Málaga	075	Nerja	16112	7936	8176	29075
29	Málaga	076	Ojén	2048	1078	970	29076
29	Málaga	077	Parauta	225	117	108	29077
29	Málaga	079	Periana	3387	1752	1635	29079
29	Málaga	080	Pizarra	6608	3215	3393	29080
29	Málaga	081	Pujerra	304	170	134	29081
29	Málaga	082	Rincón de la Victoria	23029	11568	11461	29082
29	Málaga	083	Riogordo	2692	1366	1326	29083
29	Málaga	084	Ronda	34021	16673	17348	29084
29	Málaga	085	Salares	208	102	106	29085
29	Málaga	086	Sayalonga	1177	609	568	29086
29	Málaga	087	Sedella	490	262	228	29087
29	Málaga	088	Sierra de Yeguas	3221	1590	1631	29088
29	Málaga	089	Teba	4383	2239	2144	29089
29	Málaga	090	Tolox	2390	1235	1155	29090
29	Málaga	091	Torrox	12094	5991	6103	29091
29	Málaga	092	Totalán	616	311	305	29092
29	Málaga	093	Valle de Abdalajís	3007	1471	1536	29093
29	Málaga	094	Vélez-Málaga	55156	27340	27816	29094
29	Málaga	095	Villanueva de Algaidas	4183	2068	2115	29095
29	Málaga	096	Villanueva del Rosario	3318	1626	1692	29096
29	Málaga	097	Villanueva del Trabuco	4760	2413	2347	29097
29	Málaga	098	Villanueva de Tapia	1621	833	788	29098
29	Málaga	099	Viñuela	1200	597	603	29099
29	Málaga	100	Yunquera	3268	1700	1568	29100
29	Málaga	901	Torremolinos	41281	20376	20905	29901
30	Murcia	001	Abanilla	6106	3050	3056	30001
30	Murcia	002	Abarán	12241	6111	6130	30002
30	Murcia	003	Águilas	27559	13719	13840	30003
30	Murcia	004	Albudeite	1369	690	679	30004
30	Murcia	005	Alcantarilla	33453	16464	16989	30005
30	Murcia	006	Aledo	997	505	492	30006
30	Murcia	007	Alguazas	7052	3513	3539	30007
30	Murcia	008	Alhama de Murcia	15856	7925	7931	30008
30	Murcia	009	Archena	14516	7211	7305	30009
30	Murcia	010	Beniel	8116	4063	4053	30010
30	Murcia	011	Blanca	5749	2871	2878	30011
30	Murcia	012	Bullas	10753	5389	5364	30012
30	Murcia	013	Calasparra	8888	4440	4448	30013
30	Murcia	014	Campos del Río	2035	994	1041	30014
30	Murcia	015	Caravaca de la Cruz	22250	11034	11216	30015
30	Murcia	016	Cartagena	179939	89098	90841	30016
30	Murcia	017	Cehegín	14171	7089	7082	30017
30	Murcia	018	Ceutí	7305	3703	3602	30018
30	Murcia	019	Cieza	32126	15752	16374	30019
30	Murcia	020	Fortuna	6814	3475	3339	30020
30	Murcia	021	Fuente Álamo de Murcia	10140	5201	4939	30021
30	Murcia	022	Jumilla	20854	10426	10428	30022
30	Murcia	023	Librilla	3908	1924	1984	30023
30	Murcia	024	Lorca	72000	35821	36179	30024
30	Murcia	025	Lorquí	5562	2772	2790	30025
30	Murcia	026	Mazarrón	18847	9840	9007	30026
30	Murcia	027	Molina de Segura	44389	22104	22285	30027
30	Murcia	028	Moratalla	8460	4275	4185	30028
30	Murcia	029	Mula	13738	6819	6919	30029
30	Murcia	030	Murcia	357166	174017	183149	30030
30	Murcia	031	Ojós	593	300	293	30031
30	Murcia	032	Pliego	3409	1746	1663	30032
30	Murcia	033	Puerto Lumbreras	10859	5338	5521	30033
30	Murcia	034	Ricote	1582	771	811	30034
30	Murcia	035	San Javier	18925	9550	9375	30035
30	Murcia	036	San Pedro del Pinatar	15583	7685	7898	30036
30	Murcia	037	Torre-Pacheco	22719	12499	10220	30037
30	Murcia	038	Torres de Cotillas (Las)	16003	8076	7927	30038
30	Murcia	039	Totana	22359	11314	11045	30039
30	Murcia	040	Ulea	959	483	476	30040
30	Murcia	041	Unión (La)	14606	7298	7308	30041
30	Murcia	042	Villanueva del Río Segura	1568	755	813	30042
30	Murcia	043	Yecla	29319	14742	14577	30043
30	Murcia	901	Santomera	10972	5490	5482	30901
30	Murcia	902	Alcázares (Los)	7513	3783	3730	30902
31	Navarra	001	Abáigar	97	53	44	31001
31	Navarra	002	Abárzuza	514	258	256	31002
31	Navarra	003	Abaurregaina/Abaurrea Alta	167	100	67	31003
31	Navarra	004	Abaurrepea/Abaurrea Baja	47	33	14	31004
31	Navarra	005	Aberin	362	191	171	31005
31	Navarra	006	Ablitas	2330	1197	1133	31006
31	Navarra	007	Adiós	143	73	70	31007
31	Navarra	008	Aguilar de Codés	105	60	45	31008
31	Navarra	009	Aibar/Oibar	918	479	439	31009
31	Navarra	010	Altsasu/Alsasua	7124	3614	3510	31010
31	Navarra	011	Allín	824	429	395	31011
31	Navarra	012	Allo	1039	526	513	31012
31	Navarra	013	Améscoa Baja	796	415	381	31013
31	Navarra	014	Ancín	301	160	141	31014
31	Navarra	015	Andosilla	2423	1208	1215	31015
31	Navarra	016	Ansoáin	7133	3614	3519	31016
31	Navarra	017	Anue	419	245	174	31017
31	Navarra	018	Añorbe	445	239	206	31018
31	Navarra	019	Aoiz/Agoitz	1842	916	926	31019
31	Navarra	020	Araitz	611	357	254	31020
31	Navarra	021	Aranarache	95	47	48	31021
31	Navarra	022	Arantza	655	367	288	31022
31	Navarra	023	Aranguren	3746	1948	1798	31023
31	Navarra	024	Arano	151	82	69	31024
31	Navarra	025	Arakil	888	475	413	31025
31	Navarra	026	Aras	229	124	105	31026
31	Navarra	027	Arbizu	932	490	442	31027
31	Navarra	028	Arce/Artzi	305	172	133	31028
31	Navarra	029	Arcos (Los)	1315	654	661	31029
31	Navarra	030	Arellano	196	105	91	31030
31	Navarra	031	Areso	293	151	142	31031
31	Navarra	032	Arguedas	2265	1145	1120	31032
31	Navarra	033	Aria	68	41	27	31033
31	Navarra	034	Aribe	60	31	29	31034
31	Navarra	035	Armañanzas	91	48	43	31035
31	Navarra	036	Arróniz	1172	620	552	31036
31	Navarra	037	Arruazu	100	53	47	31037
31	Navarra	038	Artajona	1679	891	788	31038
31	Navarra	039	Artazu	79	44	35	31039
31	Navarra	040	Atez	207	124	83	31040
31	Navarra	041	Ayegui	1002	520	482	31041
31	Navarra	042	Azagra	3530	1768	1762	31042
31	Navarra	043	Azuelo	55	25	30	31043
31	Navarra	044	Bakaiku	360	201	159	31044
31	Navarra	045	Barásoain	443	224	219	31045
31	Navarra	046	Barbarin	98	44	54	31046
31	Navarra	047	Bargota	381	186	195	31047
31	Navarra	048	Barillas	199	99	100	31048
31	Navarra	049	Basaburua	676	387	289	31049
31	Navarra	050	Baztan	7598	3874	3724	31050
31	Navarra	051	Beire	307	152	155	31051
31	Navarra	052	Belascoáin	103	50	53	31052
31	Navarra	053	Berbinzana	720	357	363	31053
31	Navarra	054	Bertizarana	657	337	320	31054
31	Navarra	055	Betelu	348	186	162	31055
31	Navarra	056	Biurrun-Olcoz	180	95	85	31056
31	Navarra	057	Buñuel	2420	1194	1226	31057
31	Navarra	058	Auritz/Burguete	336	145	191	31058
31	Navarra	059	Burgui	236	133	103	31059
31	Navarra	060	Burlada/Burlata	16887	8337	8550	31060
31	Navarra	061	Busto (El)	102	55	47	31061
31	Navarra	062	Cabanillas	1503	783	720	31062
31	Navarra	063	Cabredo	127	68	59	31063
31	Navarra	064	Cadreita	1855	918	937	31064
31	Navarra	065	Caparroso	2324	1136	1188	31065
31	Navarra	066	Cárcar	1244	607	637	31066
31	Navarra	067	Carcastillo	2620	1306	1314	31067
31	Navarra	068	Cascante	3665	1825	1840	31068
31	Navarra	069	Cáseda	1060	518	542	31069
31	Navarra	070	Castejón	3143	1570	1573	31070
31	Navarra	071	Castillonuevo	22	14	8	31071
31	Navarra	072	Cintruénigo	5694	2841	2853	31072
31	Navarra	073	Ziordia	368	165	203	31073
31	Navarra	074	Cirauqui	454	254	200	31074
31	Navarra	075	Ciriza	64	26	38	31075
31	Navarra	076	Cizur	1308	662	646	31076
31	Navarra	077	Corella	6820	3410	3410	31077
31	Navarra	078	Cortes	3290	1698	1592	31078
31	Navarra	079	Desojo	144	79	65	31079
31	Navarra	080	Dicastillo	684	357	327	31080
31	Navarra	081	Donamaria	387	192	195	31081
31	Navarra	082	Etxalar	789	412	377	31082
31	Navarra	083	Echarri	51	29	22	31083
31	Navarra	084	Etxarri-Aranatz	2234	1144	1090	31084
31	Navarra	085	Etxauri	414	215	199	31085
31	Navarra	086	Egüés	2348	1200	1148	31086
31	Navarra	087	Elgorriaga	206	101	105	31087
31	Navarra	088	Noáin (Valle de Elorz)/Noain (Elortzibar)	3921	1972	1949	31088
31	Navarra	089	Enériz	192	99	93	31089
31	Navarra	090	Eratsun	180	112	68	31090
31	Navarra	091	Ergoiena	466	260	206	31091
31	Navarra	092	Erro	787	436	351	31092
31	Navarra	093	Ezcároz	362	191	171	31093
31	Navarra	094	Eslava	172	84	88	31094
31	Navarra	095	Esparza de Salazar	115	60	55	31095
31	Navarra	096	Espronceda	171	98	73	31096
31	Navarra	097	Estella/Lizarra	12683	6132	6551	31097
31	Navarra	098	Esteribar	1519	805	714	31098
31	Navarra	099	Etayo	96	48	48	31099
31	Navarra	100	Eulate	373	197	176	31100
31	Navarra	101	Ezcabarte	1202	647	555	31101
31	Navarra	102	Ezkurra	232	147	85	31102
31	Navarra	103	Ezprogui	63	31	32	31103
31	Navarra	104	Falces	2591	1267	1324	31104
31	Navarra	105	Fitero	1960	980	980	31105
31	Navarra	106	Fontellas	736	374	362	31106
31	Navarra	107	Funes	2188	1138	1050	31107
31	Navarra	108	Fustiñana	2304	1164	1140	31108
31	Navarra	109	Galar	1154	608	546	31109
31	Navarra	110	Gallipienzo	160	85	75	31110
31	Navarra	111	Gallués	122	78	44	31111
31	Navarra	112	Garaioa	130	70	60	31112
31	Navarra	113	Garde	199	109	90	31113
31	Navarra	114	Garínoain	356	190	166	31114
31	Navarra	115	Garralda	209	105	104	31115
31	Navarra	116	Genevilla	116	63	53	31116
31	Navarra	117	Goizueta	903	479	424	31117
31	Navarra	118	Goñi	188	111	77	31118
31	Navarra	119	Güesa	74	41	33	31119
31	Navarra	120	Guesálaz	480	280	200	31120
31	Navarra	121	Guirguillano	72	40	32	31121
31	Navarra	122	Huarte/Uharte	2862	1443	1419	31122
31	Navarra	123	Uharte-Arakil	770	416	354	31123
31	Navarra	124	Ibargoiti	237	135	102	31124
31	Navarra	125	Igúzquiza	363	182	181	31125
31	Navarra	126	Imotz	408	229	179	31126
31	Navarra	127	Irañeta	160	84	76	31127
31	Navarra	128	Isaba/Izaba	525	257	268	31128
31	Navarra	129	Ituren	470	236	234	31129
31	Navarra	130	Iturmendi	380	193	187	31130
31	Navarra	131	Iza	728	382	346	31131
31	Navarra	132	Izagaondoa	172	103	69	31132
31	Navarra	133	Izalzu	48	29	19	31133
31	Navarra	134	Jaurrieta	254	134	120	31134
31	Navarra	135	Javier	119	51	68	31135
31	Navarra	136	Juslapeña	469	263	206	31136
31	Navarra	137	Beintza-Labaien	290	160	130	31137
31	Navarra	138	Lakuntza	977	505	472	31138
31	Navarra	139	Lana	215	123	92	31139
31	Navarra	140	Lantz	123	77	46	31140
31	Navarra	141	Lapoblación	195	108	87	31141
31	Navarra	142	Larraga	1892	1014	878	31142
31	Navarra	143	Larraona	156	81	75	31143
31	Navarra	144	Larraun	1106	626	480	31144
31	Navarra	145	Lazagurría	227	122	105	31145
31	Navarra	146	Leache	49	30	19	31146
31	Navarra	147	Legarda	80	46	34	31147
31	Navarra	148	Legaria	120	61	59	31148
31	Navarra	149	Leitza	2939	1538	1401	31149
31	Navarra	150	Leoz	258	161	97	31150
31	Navarra	151	Lerga	84	44	40	31151
31	Navarra	152	Lerín	1916	960	956	31152
31	Navarra	153	Lesaka	2681	1412	1269	31153
31	Navarra	154	Lezáun	278	161	117	31154
31	Navarra	155	Liédena	331	153	178	31155
31	Navarra	156	Lizoáin	236	141	95	31156
31	Navarra	157	Lodosa	4598	2337	2261	31157
31	Navarra	158	Lónguida	296	156	140	31158
31	Navarra	159	Lumbier	1434	764	670	31159
31	Navarra	160	Luquin	127	69	58	31160
31	Navarra	161	Mañeru	362	188	174	31161
31	Navarra	162	Marañón	72	39	33	31162
31	Navarra	163	Marcilla	2574	1339	1235	31163
31	Navarra	164	Mélida	814	428	386	31164
31	Navarra	165	Mendavia	3580	1781	1799	31165
31	Navarra	166	Mendaza	367	177	190	31166
31	Navarra	167	Mendigorría	899	462	437	31167
31	Navarra	168	Metauten	300	161	139	31168
31	Navarra	169	Milagro	2599	1276	1323	31169
31	Navarra	170	Mirafuentes	52	28	24	31170
31	Navarra	171	Miranda de Arga	997	510	487	31171
31	Navarra	172	Monreal	289	155	134	31172
31	Navarra	173	Monteagudo	1175	590	585	31173
31	Navarra	174	Morentin	128	63	65	31174
31	Navarra	175	Mues	104	56	48	31175
31	Navarra	176	Murchante	3070	1514	1556	31176
31	Navarra	177	Murieta	273	149	124	31177
31	Navarra	178	Murillo el Cuende	649	350	299	31178
31	Navarra	179	Murillo el Fruto	750	374	376	31179
31	Navarra	180	Muruzábal	249	127	122	31180
31	Navarra	181	Navascués	213	133	80	31181
31	Navarra	182	Nazar	56	32	24	31182
31	Navarra	183	Obanos	772	372	400	31183
31	Navarra	184	Oco	85	50	35	31184
31	Navarra	185	Ochagavía	681	351	330	31185
31	Navarra	186	Odieta	318	175	143	31186
31	Navarra	187	Oitz	144	88	56	31187
31	Navarra	188	Olaibar	170	91	79	31188
31	Navarra	189	Olazti/Olazagutía	1654	856	798	31189
31	Navarra	190	Olejua	54	26	28	31190
31	Navarra	191	Olite	3130	1566	1564	31191
31	Navarra	192	Olóriz	175	100	75	31192
31	Navarra	193	Olza	1371	711	660	31193
31	Navarra	194	Ollo	318	181	137	31194
31	Navarra	195	Orbaitzeta	236	131	105	31195
31	Navarra	196	Orbara	58	29	29	31196
31	Navarra	197	Orísoain	99	57	42	31197
31	Navarra	198	Oronz	57	31	26	31198
31	Navarra	199	Oroz-Betelu	221	119	102	31199
31	Navarra	200	Oteiza	897	466	431	31200
31	Navarra	201	Pamplona/Iruña	182666	87268	95398	31201
31	Navarra	202	Peralta	5082	2574	2508	31202
31	Navarra	203	Petilla de Aragón	43	22	21	31203
31	Navarra	204	Piedramillera	67	39	28	31204
31	Navarra	205	Pitillas	572	291	281	31205
31	Navarra	206	Puente la Reina/Gares	2276	1131	1145	31206
31	Navarra	207	Pueyo	310	163	147	31207
31	Navarra	208	Ribaforada	3188	1632	1556	31208
31	Navarra	209	Romanzado	168	99	69	31209
31	Navarra	210	Roncal	354	172	182	31210
31	Navarra	211	Orreaga/Roncesvalles	31	16	15	31211
31	Navarra	212	Sada	239	127	112	31212
31	Navarra	213	Saldías	151	83	68	31213
31	Navarra	214	Salinas de Oro	114	63	51	31214
31	Navarra	215	San Adrián	5330	2592	2738	31215
31	Navarra	216	Sangüesa/Zangoza	4673	2406	2267	31216
31	Navarra	217	San Martín de Unx	471	252	219	31217
31	Navarra	219	Sansol	123	60	63	31219
31	Navarra	220	Santacara	1050	536	514	31220
31	Navarra	221	Doneztebe/Santesteban	1359	670	689	31221
31	Navarra	222	Sarriés	77	46	31	31222
31	Navarra	223	Sartaguda	1357	692	665	31223
31	Navarra	224	Sesma	1364	655	709	31224
31	Navarra	225	Sorlada	52	27	25	31225
31	Navarra	226	Sunbilla	688	358	330	31226
31	Navarra	227	Tafalla	10288	5071	5217	31227
31	Navarra	228	Tiebas-Muruarte de Reta	574	308	266	31228
31	Navarra	229	Tirapu	64	35	29	31229
31	Navarra	230	Torralba del Río	155	84	71	31230
31	Navarra	231	Torres del Río	182	85	97	31231
31	Navarra	232	Tudela	27819	13549	14270	31232
31	Navarra	233	Tulebras	108	36	72	31233
31	Navarra	234	Ucar	116	67	49	31234
31	Navarra	235	Ujué	238	124	114	31235
31	Navarra	236	Ultzama	1614	816	798	31236
31	Navarra	237	Unciti	228	141	87	31237
31	Navarra	238	Unzué	138	82	56	31238
31	Navarra	239	Urdazubi/Urdax	392	188	204	31239
31	Navarra	240	Urdiain	639	327	312	31240
31	Navarra	241	Urraul Alto	170	97	73	31241
31	Navarra	242	Urraul Bajo	279	134	145	31242
31	Navarra	243	Urroz	361	190	171	31243
31	Navarra	244	Urrotz	208	119	89	31244
31	Navarra	245	Urzainqui	109	57	52	31245
31	Navarra	246	Uterga	138	67	71	31246
31	Navarra	247	Uztárroz/Uztarroze	266	133	133	31247
31	Navarra	248	Luzaide/Valcarlos	470	232	238	31248
31	Navarra	249	Valtierra	2430	1177	1253	31249
31	Navarra	250	Bera/Vera de Bidasoa	3490	1767	1723	31250
31	Navarra	251	Viana	3493	1815	1678	31251
31	Navarra	252	Vidángoz	115	61	54	31252
31	Navarra	253	Bidaurreta	96	59	37	31253
31	Navarra	254	Villafranca	2510	1239	1271	31254
31	Navarra	255	Villamayor de Monjardín	127	68	59	31255
31	Navarra	256	Hiriberri/Villanueva de Aezkoa	152	86	66	31256
31	Navarra	257	Villatuerta	778	402	376	31257
31	Navarra	258	Villava/Atarrabia	9333	4618	4715	31258
31	Navarra	259	Igantzi	588	304	284	31259
31	Navarra	260	Yerri	1436	762	674	31260
31	Navarra	261	Yesa	239	136	103	31261
31	Navarra	262	Zabalza	156	75	81	31262
31	Navarra	263	Zubieta	307	177	130	31263
31	Navarra	264	Zugarramurdi	234	120	114	31264
31	Navarra	265	Zúñiga	114	68	46	31265
31	Navarra	901	Barañain	20871	10242	10629	31901
31	Navarra	902	Berrioplano	1213	614	599	31902
31	Navarra	903	Berriozar	5557	2868	2689	31903
31	Navarra	904	Irurtzun	2112	1092	1020	31904
31	Navarra	905	Beriáin	2584	1280	1304	31905
31	Navarra	906	Orcoyen	1267	655	612	31906
31	Navarra	907	Zizur Mayor/Zizur Nagusia	10686	5306	5380	31907
31	Navarra	908	Lekunberri	825	422	403	31908
32	Ourense	001	Allariz	5158	2481	2677	32001
32	Ourense	002	Amoeiro	2293	1110	1183	32002
32	Ourense	003	Arnoia (A)	1211	562	649	32003
32	Ourense	004	Avión	2984	1304	1680	32004
32	Ourense	005	Baltar	1282	636	646	32005
32	Ourense	006	Bande	2602	1235	1367	32006
32	Ourense	007	Baños de Molgas	2222	1096	1126	32007
32	Ourense	008	Barbadás	6286	3053	3233	32008
32	Ourense	009	Barco de Valdeorras (O)	12767	6388	6379	32009
32	Ourense	010	Beade	614	302	312	32010
32	Ourense	011	Beariz	1704	793	911	32011
32	Ourense	012	Blancos (Os)	1322	657	665	32012
32	Ourense	013	Boborás	3462	1576	1886	32013
32	Ourense	014	Bola (A)	1566	727	839	32014
32	Ourense	015	Bolo (O)	1432	700	732	32015
32	Ourense	016	Calvos de Randín	1256	633	623	32016
32	Ourense	017	Carballeda de Valdeorras	2313	1161	1152	32017
32	Ourense	018	Carballeda de Avia	1685	803	882	32018
32	Ourense	019	Carballiño (O)	12434	5878	6556	32019
32	Ourense	020	Cartelle	3927	1879	2048	32020
32	Ourense	021	Castrelo do Val	1336	654	682	32021
32	Ourense	022	Castrelo de Miño	2153	1029	1124	32022
32	Ourense	023	Castro Caldelas	1919	972	947	32023
32	Ourense	024	Celanova	5960	2804	3156	32024
32	Ourense	025	Cenlle	1673	784	889	32025
32	Ourense	026	Coles	3162	1579	1583	32026
32	Ourense	027	Cortegada	1441	697	744	32027
32	Ourense	028	Cualedro	2457	1239	1218	32028
32	Ourense	029	Chandrexa de Queixa	897	494	403	32029
32	Ourense	030	Entrimo	1474	664	810	32030
32	Ourense	031	Esgos	1339	652	687	32031
32	Ourense	032	Xinzo de Limia	9599	4740	4859	32032
32	Ourense	033	Gomesende	1205	554	651	32033
32	Ourense	034	Gudiña (A)	1724	855	869	32034
32	Ourense	035	Irixo (O)	2185	1010	1175	32035
32	Ourense	036	Xunqueira de Ambía	2097	1018	1079	32036
32	Ourense	037	Xunqueira de Espadanedo	1097	523	574	32037
32	Ourense	038	Larouco	617	292	325	32038
32	Ourense	039	Laza	2027	1014	1013	32039
32	Ourense	040	Leiro	2046	961	1085	32040
32	Ourense	041	Lobeira	1286	612	674	32041
32	Ourense	042	Lobios	2691	1289	1402	32042
32	Ourense	043	Maceda	3387	1650	1737	32043
32	Ourense	044	Manzaneda	1264	648	616	32044
32	Ourense	045	Maside	3297	1551	1746	32045
32	Ourense	046	Melón	1601	715	886	32046
32	Ourense	047	Merca (A)	2426	1157	1269	32047
32	Ourense	048	Mezquita (A)	1549	783	766	32048
32	Ourense	049	Montederramo	1285	663	622	32049
32	Ourense	050	Monterrei	3425	1702	1723	32050
32	Ourense	051	Muíños	2042	983	1059	32051
32	Ourense	052	Nogueira de Ramuín	2667	1256	1411	32052
32	Ourense	053	Oímbra	2021	1022	999	32053
32	Ourense	054	Ourense	108647	50818	57829	32054
32	Ourense	055	Paderne de Allariz	1714	818	896	32055
32	Ourense	056	Padrenda	2836	1342	1494	32056
32	Ourense	057	Parada de Sil	909	429	480	32057
32	Ourense	058	Pereiro de Aguiar (O)	4892	2405	2487	32058
32	Ourense	059	Peroxa (A)	2590	1214	1376	32059
32	Ourense	060	Petín	1139	551	588	32060
32	Ourense	061	Piñor	1620	797	823	32061
32	Ourense	062	Porqueira	1192	563	629	32062
32	Ourense	063	Pobra de Trives (A)	2911	1438	1473	32063
32	Ourense	064	Pontedeva	708	323	385	32064
32	Ourense	065	Punxín	978	455	523	32065
32	Ourense	066	Quintela de Leirado	950	440	510	32066
32	Ourense	067	Rairiz de Veiga	1895	933	962	32067
32	Ourense	068	Ramirás	2077	963	1114	32068
32	Ourense	069	Ribadavia	5509	2654	2855	32069
32	Ourense	070	San Xoán de Río	1030	488	542	32070
32	Ourense	071	Riós	2265	1126	1139	32071
32	Ourense	072	Rúa (A)	5008	2443	2565	32072
32	Ourense	073	Rubiá	1828	900	928	32073
32	Ourense	074	San Amaro	1534	741	793	32074
32	Ourense	075	San Cibrao das Viñas	3614	1747	1867	32075
32	Ourense	076	San Cristovo de Cea	3232	1551	1681	32076
32	Ourense	077	Sandiás	1712	787	925	32077
32	Ourense	078	Sarreaus	1917	944	973	32078
32	Ourense	079	Taboadela	1755	881	874	32079
32	Ourense	080	Teixeira (A)	597	276	321	32080
32	Ourense	081	Toén	2623	1325	1298	32081
32	Ourense	082	Trasmiras	1940	948	992	32082
32	Ourense	083	Veiga (A)	1446	717	729	32083
32	Ourense	084	Verea	1516	732	784	32084
32	Ourense	085	Verín	13033	6353	6680	32085
32	Ourense	086	Viana do Bolo	4089	2027	2062	32086
32	Ourense	087	Vilamarín	2262	1113	1149	32087
32	Ourense	088	Vilamartín de Valdeorras	2502	1213	1289	32088
32	Ourense	089	Vilar de Barrio	2084	1040	1044	32089
32	Ourense	090	Vilar de Santos	1033	505	528	32090
32	Ourense	091	Vilardevós	2931	1465	1466	32091
32	Ourense	092	Vilariño de Conso	854	467	387	32092
33	Asturias	001	Allande	2501	1287	1214	33001
33	Asturias	002	Aller	15398	7566	7832	33002
33	Asturias	003	Amieva	905	477	428	33003
33	Asturias	004	Avilés	83930	40344	43586	33004
33	Asturias	005	Belmonte de Miranda	2304	1180	1124	33005
33	Asturias	006	Bimenes	2174	1039	1135	33006
33	Asturias	007	Boal	2529	1253	1276	33007
33	Asturias	008	Cabrales	2371	1194	1177	33008
33	Asturias	009	Cabranes	1269	628	641	33009
33	Asturias	010	Candamo	2601	1248	1353	33010
33	Asturias	011	Cangas del Narcea	17161	8677	8484	33011
33	Asturias	012	Cangas de Onís	6343	3095	3248	33012
33	Asturias	013	Caravia	591	301	290	33013
33	Asturias	014	Carreño	10557	5125	5432	33014
33	Asturias	015	Caso	1990	1063	927	33015
33	Asturias	016	Castrillón	22593	10966	11627	33016
33	Asturias	017	Castropol	4357	2052	2305	33017
33	Asturias	018	Coaña	3692	1794	1898	33018
33	Asturias	019	Colunga	4387	2147	2240	33019
33	Asturias	020	Corvera de Asturias	16118	7865	8253	33020
33	Asturias	021	Cudillero	6127	2986	3141	33021
33	Asturias	022	Degaña	1528	802	726	33022
33	Asturias	023	Franco (El)	4154	2029	2125	33023
33	Asturias	024	Gijón	267426	126994	140432	33024
33	Asturias	025	Gozón	11194	5440	5754	33025
33	Asturias	026	Grado	11666	5603	6063	33026
33	Asturias	027	Grandas de Salime	1343	681	662	33027
33	Asturias	028	Ibias	2190	1164	1026	33028
33	Asturias	029	Illano	639	329	310	33029
33	Asturias	030	Illas	1126	588	538	33030
33	Asturias	031	Langreo	48886	23369	25517	33031
33	Asturias	032	Laviana	14804	7177	7627	33032
33	Asturias	033	Lena	13901	6750	7151	33033
33	Asturias	034	Valdés	15297	7459	7838	33034
33	Asturias	035	Llanera	11991	5885	6106	33035
33	Asturias	036	Llanes	13144	6327	6817	33036
33	Asturias	037	Mieres	49506	23692	25814	33037
33	Asturias	038	Morcín	3066	1496	1570	33038
33	Asturias	039	Muros de Nalón	2291	1075	1216	33039
33	Asturias	040	Nava	5656	2798	2858	33040
33	Asturias	041	Navia	9079	4362	4717	33041
33	Asturias	042	Noreña	4320	2067	2253	33042
33	Asturias	043	Onís	893	447	446	33043
33	Asturias	044	Oviedo	200411	93518	106893	33044
33	Asturias	045	Parres	5563	2715	2848	33045
33	Asturias	046	Peñamellera Alta	740	366	374	33046
33	Asturias	047	Peñamellera Baja	1621	803	818	33047
33	Asturias	048	Pesoz	265	135	130	33048
33	Asturias	049	Piloña	8892	4317	4575	33049
33	Asturias	050	Ponga	760	451	309	33050
33	Asturias	051	Pravia	9419	4550	4869	33051
33	Asturias	052	Proaza	919	480	439	33052
33	Asturias	053	Quirós	1664	874	790	33053
33	Asturias	054	Regueras (Las)	2174	1075	1099	33054
33	Asturias	055	Ribadedeva	1891	924	967	33055
33	Asturias	056	Ribadesella	6245	2968	3277	33056
33	Asturias	057	Ribera de Arriba	1998	986	1012	33057
33	Asturias	058	Riosa	2578	1326	1252	33058
33	Asturias	059	Salas	6938	3382	3556	33059
33	Asturias	060	San Martín del Rey Aurelio	20794	9976	10818	33060
33	Asturias	061	San Martín de Oscos	524	264	260	33061
33	Asturias	062	Santa Eulalia de Oscos	591	296	295	33062
33	Asturias	063	San Tirso de Abres	643	307	336	33063
33	Asturias	064	Santo Adriano	335	169	166	33064
33	Asturias	065	Sariego	1393	689	704	33065
33	Asturias	066	Siero	47360	22869	24491	33066
33	Asturias	067	Sobrescobio	818	430	388	33067
33	Asturias	068	Somiedo	1621	862	759	33068
33	Asturias	069	Soto del Barco	4310	2057	2253	33069
33	Asturias	070	Tapia de Casariego	4368	2072	2296	33070
33	Asturias	071	Taramundi	906	435	471	33071
33	Asturias	072	Teverga	2264	1180	1084	33072
33	Asturias	073	Tineo	12931	6521	6410	33073
33	Asturias	074	Vegadeo	4759	2260	2499	33074
33	Asturias	075	Villanueva de Oscos	410	211	199	33075
33	Asturias	076	Villaviciosa	14275	6990	7285	33076
33	Asturias	077	Villayón	1966	1009	957	33077
33	Asturias	078	Yernes y Tameza	223	110	113	33078
34	Palencia	001	Abarca de Campos	50	26	24	34001
34	Palencia	003	Abia de las Torres	204	103	101	34003
34	Palencia	004	Aguilar de Campoo	7643	3730	3913	34004
34	Palencia	005	Alar del Rey	1303	615	688	34005
34	Palencia	006	Alba de Cerrato	101	49	52	34006
34	Palencia	009	Amayuelas de Arriba	43	26	17	34009
34	Palencia	010	Ampudia	698	363	335	34010
34	Palencia	011	Amusco	559	309	250	34011
34	Palencia	012	Antigüedad	427	228	199	34012
34	Palencia	015	Arconada	67	35	32	34015
34	Palencia	017	Astudillo	1287	663	624	34017
34	Palencia	018	Autilla del Pino	249	131	118	34018
34	Palencia	019	Autillo de Campos	191	87	104	34019
34	Palencia	020	Ayuela	78	47	31	34020
34	Palencia	022	Baltanás	1561	808	753	34022
34	Palencia	023	Venta de Baños	6188	2994	3194	34023
34	Palencia	024	Baquerín de Campos	38	23	15	34024
34	Palencia	025	Bárcena de Campos	63	26	37	34025
34	Palencia	027	Barruelo de Santullán	1834	857	977	34027
34	Palencia	028	Báscones de Ojeda	212	107	105	34028
34	Palencia	029	Becerril de Campos	1095	536	559	34029
34	Palencia	031	Belmonte de Campos	46	22	24	34031
34	Palencia	032	Berzosilla	73	33	40	34032
34	Palencia	033	Boada de Campos	24	13	11	34033
34	Palencia	034	Boadilla del Camino	190	101	89	34034
34	Palencia	035	Boadilla de Rioseco	188	90	98	34035
34	Palencia	036	Brañosera	290	151	139	34036
34	Palencia	037	Buenavista de Valdavia	440	221	219	34037
34	Palencia	038	Bustillo de la Vega	383	201	182	34038
34	Palencia	039	Bustillo del Páramo de Carrión	93	52	41	34039
34	Palencia	041	Calahorra de Boedo	137	69	68	34041
34	Palencia	042	Calzada de los Molinos	386	208	178	34042
34	Palencia	045	Capillas	116	57	59	34045
34	Palencia	046	Cardeñosa de Volpejera	56	30	26	34046
34	Palencia	047	Carrión de los Condes	2425	1130	1295	34047
34	Palencia	048	Castil de Vela	112	53	59	34048
34	Palencia	049	Castrejón de la Peña	622	325	297	34049
34	Palencia	050	Castrillo de Don Juan	337	185	152	34050
34	Palencia	051	Castrillo de Onielo	179	85	94	34051
34	Palencia	052	Castrillo de Villavega	285	144	141	34052
34	Palencia	053	Castromocho	257	133	124	34053
34	Palencia	055	Cervatos de la Cueza	397	206	191	34055
34	Palencia	056	Cervera de Pisuerga	2706	1358	1348	34056
34	Palencia	057	Cevico de la Torre	705	344	361	34057
34	Palencia	058	Cevico Navero	275	142	133	34058
34	Palencia	059	Cisneros	600	284	316	34059
34	Palencia	060	Cobos de Cerrato	244	119	125	34060
34	Palencia	061	Collazos de Boedo	157	87	70	34061
34	Palencia	062	Congosto de Valdavia	284	165	119	34062
34	Palencia	063	Cordovilla la Real	126	72	54	34063
34	Palencia	066	Cubillas de Cerrato	87	44	43	34066
34	Palencia	067	Dehesa de Montejo	218	121	97	34067
34	Palencia	068	Dehesa de Romanos	44	27	17	34068
34	Palencia	069	Dueñas	2949	1510	1439	34069
34	Palencia	070	Espinosa de Cerrato	274	145	129	34070
34	Palencia	071	Espinosa de Villagonzalo	272	137	135	34071
34	Palencia	072	Frechilla	272	130	142	34072
34	Palencia	073	Fresno del Río	200	100	100	34073
34	Palencia	074	Frómista	980	487	493	34074
34	Palencia	076	Fuentes de Nava	815	407	408	34076
34	Palencia	077	Fuentes de Valdepero	242	136	106	34077
34	Palencia	079	Grijota	819	416	403	34079
34	Palencia	080	Guardo	8645	4361	4284	34080
34	Palencia	081	Guaza de Campos	78	38	40	34081
34	Palencia	082	Hérmedes de Cerrato	133	66	67	34082
34	Palencia	083	Herrera de Pisuerga	2627	1308	1319	34083
34	Palencia	084	Herrera de Valdecañas	203	101	102	34084
34	Palencia	086	Hontoria de Cerrato	123	64	59	34086
34	Palencia	087	Hornillos de Cerrato	130	68	62	34087
34	Palencia	088	Husillos	223	122	101	34088
34	Palencia	089	Itero de la Vega	243	124	119	34089
34	Palencia	091	Lagartos	169	88	81	34091
34	Palencia	092	Lantadilla	518	247	271	34092
34	Palencia	093	Vid de Ojeda (La)	136	80	56	34093
34	Palencia	094	Ledigos	105	54	51	34094
34	Palencia	096	Lomas	62	27	35	34096
34	Palencia	098	Magaz de Pisuerga	726	369	357	34098
34	Palencia	099	Manquillos	71	37	34	34099
34	Palencia	100	Mantinos	201	101	100	34100
34	Palencia	101	Marcilla de Campos	74	33	41	34101
34	Palencia	102	Mazariegos	291	158	133	34102
34	Palencia	103	Mazuecos de Valdeginate	138	69	69	34103
34	Palencia	104	Melgar de Yuso	389	214	175	34104
34	Palencia	106	Meneses de Campos	156	80	76	34106
34	Palencia	107	Micieces de Ojeda	113	62	51	34107
34	Palencia	108	Monzón de Campos	758	399	359	34108
34	Palencia	109	Moratinos	89	47	42	34109
34	Palencia	110	Mudá	129	66	63	34110
34	Palencia	112	Nogal de las Huertas	69	40	29	34112
34	Palencia	113	Olea de Boedo	45	21	24	34113
34	Palencia	114	Olmos de Ojeda	341	186	155	34114
34	Palencia	116	Osornillo	100	55	45	34116
34	Palencia	120	Palencia	80613	38398	42215	34120
34	Palencia	121	Palenzuela	318	169	149	34121
34	Palencia	122	Páramo de Boedo	111	56	55	34122
34	Palencia	123	Paredes de Nava	2428	1197	1231	34123
34	Palencia	124	Payo de Ojeda	97	59	38	34124
34	Palencia	125	Pedraza de Campos	131	68	63	34125
34	Palencia	126	Pedrosa de la Vega	393	207	186	34126
34	Palencia	127	Perales	116	60	56	34127
34	Palencia	129	Pino del Río	283	164	119	34129
34	Palencia	130	Piña de Campos	294	156	138	34130
34	Palencia	131	Población de Arroyo	92	50	42	34131
34	Palencia	132	Población de Campos	200	111	89	34132
34	Palencia	133	Población de Cerrato	127	66	61	34133
34	Palencia	134	Polentinos	91	48	43	34134
34	Palencia	135	Pomar de Valdivia	536	278	258	34135
34	Palencia	136	Poza de la Vega	274	148	126	34136
34	Palencia	137	Pozo de Urama	43	22	21	34137
34	Palencia	139	Prádanos de Ojeda	252	132	120	34139
34	Palencia	140	Puebla de Valdavia (La)	157	76	81	34140
34	Palencia	141	Quintana del Puente	256	130	126	34141
34	Palencia	143	Quintanilla de Onsoña	239	134	105	34143
34	Palencia	146	Reinoso de Cerrato	83	49	34	34146
34	Palencia	147	Renedo de la Vega	270	155	115	34147
34	Palencia	149	Requena de Campos	58	30	28	34149
34	Palencia	151	Respenda de la Peña	274	144	130	34151
34	Palencia	152	Revenga de Campos	189	95	94	34152
34	Palencia	154	Revilla de Collazos	86	47	39	34154
34	Palencia	155	Ribas de Campos	197	105	92	34155
34	Palencia	156	Riberos de la Cueza	89	51	38	34156
34	Palencia	157	Saldaña	3187	1603	1584	34157
34	Palencia	158	Salinas de Pisuerga	281	150	131	34158
34	Palencia	159	San Cebrián de Campos	541	312	229	34159
34	Palencia	160	San Cebrián de Mudá	210	103	107	34160
34	Palencia	161	San Cristóbal de Boedo	48	28	20	34161
34	Palencia	163	San Mamés de Campos	112	49	63	34163
34	Palencia	165	San Román de la Cuba	119	59	60	34165
34	Palencia	167	Santa Cecilia del Alcor	165	90	75	34167
34	Palencia	168	Santa Cruz de Boedo	65	34	31	34168
34	Palencia	169	Santervás de la Vega	550	300	250	34169
34	Palencia	170	Santibáñez de Ecla	102	45	57	34170
34	Palencia	171	Santibáñez de la Peña	1514	757	757	34171
34	Palencia	174	Santoyo	286	138	148	34174
34	Palencia	175	Serna (La)	124	74	50	34175
34	Palencia	176	Sotobañado y Priorato	182	98	84	34176
34	Palencia	177	Soto de Cerrato	228	115	113	34177
34	Palencia	178	Tabanera de Cerrato	180	94	86	34178
34	Palencia	179	Tabanera de Valdavia	56	23	33	34179
34	Palencia	180	Támara de Campos	98	52	46	34180
34	Palencia	181	Tariego de Cerrato	561	292	269	34181
34	Palencia	182	Torquemada	1176	601	575	34182
34	Palencia	184	Torremormojón	92	48	44	34184
34	Palencia	185	Triollo	98	52	46	34185
34	Palencia	186	Valbuena de Pisuerga	80	46	34	34186
34	Palencia	189	Valdeolmillos	88	46	42	34189
34	Palencia	190	Valderrábano	82	49	33	34190
34	Palencia	192	Valde-Ucieza	124	70	54	34192
34	Palencia	196	Valle de Cerrato	130	75	55	34196
34	Palencia	199	Velilla del Río Carrión	1818	926	892	34199
34	Palencia	201	Vertavillo	228	126	102	34201
34	Palencia	202	Villabasta de Valdavia	40	18	22	34202
34	Palencia	204	Villacidaler	78	38	40	34204
34	Palencia	205	Villaconancio	89	52	37	34205
34	Palencia	206	Villada	1290	638	652	34206
34	Palencia	208	Villaeles de Valdavia	87	47	40	34208
34	Palencia	210	Villahán	140	76	64	34210
34	Palencia	211	Villaherreros	273	130	143	34211
34	Palencia	213	Villalaco	81	34	47	34213
34	Palencia	214	Villalba de Guardo	248	133	115	34214
34	Palencia	215	Villalcázar de Sirga	237	111	126	34215
34	Palencia	216	Villalcón	89	42	47	34216
34	Palencia	217	Villalobón	358	188	170	34217
34	Palencia	218	Villaluenga de la Vega	667	374	293	34218
34	Palencia	220	Villamartín de Campos	169	90	79	34220
34	Palencia	221	Villamediana	236	123	113	34221
34	Palencia	222	Villameriel	158	87	71	34222
34	Palencia	223	Villamoronta	331	175	156	34223
34	Palencia	224	Villamuera de la Cueza	63	36	27	34224
34	Palencia	225	Villamuriel de Cerrato	4734	2437	2297	34225
34	Palencia	227	Villanueva del Rebollar	101	51	50	34227
34	Palencia	228	Villanuño de Valdavia	130	71	59	34228
34	Palencia	229	Villaprovedo	105	63	42	34229
34	Palencia	230	Villarmentero de Campos	14	10	4	34230
34	Palencia	231	Villarrabé	287	139	148	34231
34	Palencia	232	Villarramiel	1096	562	534	34232
34	Palencia	233	Villasarracino	271	142	129	34233
34	Palencia	234	Villasila de Valdavia	107	59	48	34234
34	Palencia	236	Villaturde	253	123	130	34236
34	Palencia	237	Villaumbrales	886	460	426	34237
34	Palencia	238	Villaviudas	473	224	249	34238
34	Palencia	240	Villerías de Campos	131	72	59	34240
34	Palencia	241	Villodre	46	27	19	34241
34	Palencia	242	Villodrigo	129	65	64	34242
34	Palencia	243	Villoldo	496	264	232	34243
34	Palencia	245	Villota del Páramo	458	265	193	34245
34	Palencia	246	Villovieco	124	64	60	34246
34	Palencia	901	Osorno la Mayor	1712	925	787	34901
34	Palencia	902	Valle del Retortillo	219	105	114	34902
34	Palencia	903	Loma de Ucieza	328	174	154	34903
34	Palencia	904	Pernía (La)	479	263	216	34904
35	Palmas (Las)	001	Agaete	5665	2882	2783	35001
35	Palmas (Las)	002	Agüimes	20692	10558	10134	35002
35	Palmas (Las)	003	Antigua	4821	2670	2151	35003
35	Palmas (Las)	004	Arrecife	43711	22217	21494	35004
35	Palmas (Las)	005	Artenara	1572	803	769	35005
35	Palmas (Las)	006	Arucas	31973	16014	15959	35006
35	Palmas (Las)	007	Betancuria	677	348	329	35007
35	Palmas (Las)	008	Firgas	6814	3454	3360	35008
35	Palmas (Las)	009	Gáldar	22291	11174	11117	35009
35	Palmas (Las)	010	Haría	4201	2163	2038	35010
35	Palmas (Las)	011	Ingenio	24616	12463	12153	35011
35	Palmas (Las)	012	Mogán	13136	6873	6263	35012
35	Palmas (Las)	013	Moya	8664	4391	4273	35013
35	Palmas (Las)	014	Oliva (La)	10578	5713	4865	35014
35	Palmas (Las)	015	Pájara	12923	7390	5533	35015
35	Palmas (Las)	016	Palmas de Gran Canaria (Las)	358518	175221	183297	35016
35	Palmas (Las)	017	Puerto del Rosario	21274	11169	10105	35017
35	Palmas (Las)	018	San Bartolomé	13129	6829	6300	35018
35	Palmas (Las)	019	San Bartolomé de Tirajana	39939	20681	19258	35019
35	Palmas (Las)	020	San Nicolás de Tolentino	8070	4084	3986	35020
35	Palmas (Las)	021	Santa Brígida	18153	9067	9086	35021
35	Palmas (Las)	022	Santa Lucía de Tirajana	44974	22875	22099	35022
35	Palmas (Las)	023	Santa María de Guía de Gran Canaria	14032	6999	7033	35023
35	Palmas (Las)	024	Teguise	12184	6265	5919	35024
35	Palmas (Las)	025	Tejeda	2565	1307	1258	35025
35	Palmas (Las)	026	Telde	88110	44269	43841	35026
35	Palmas (Las)	027	Teror	11898	5999	5899	35027
35	Palmas (Las)	028	Tías	13537	7024	6513	35028
35	Palmas (Las)	029	Tinajo	4373	2279	2094	35029
35	Palmas (Las)	030	Tuineje	9851	5248	4603	35030
35	Palmas (Las)	031	Valsequillo de Gran Canaria	8049	4139	3910	35031
35	Palmas (Las)	032	Valleseco	4006	2059	1947	35032
35	Palmas (Las)	033	Vega de San Mateo	7424	3847	3577	35033
35	Palmas (Las)	034	Yaiza	5175	2896	2279	35034
36	Pontevedra	001	Arbo	4318	2105	2213	36001
36	Pontevedra	002	Barro	3538	1673	1865	36002
36	Pontevedra	003	Baiona	10741	5271	5470	36003
36	Pontevedra	004	Bueu	12526	6109	6417	36004
36	Pontevedra	005	Caldas de Reis	9441	4540	4901	36005
36	Pontevedra	006	Cambados	13240	6427	6813	36006
36	Pontevedra	007	Campo Lameiro	2307	1099	1208	36007
36	Pontevedra	008	Cangas	23442	11569	11873	36008
36	Pontevedra	009	Cañiza (A)	6986	3313	3673	36009
36	Pontevedra	010	Catoira	3507	1720	1787	36010
36	Pontevedra	011	Cerdedo	2566	1122	1444	36011
36	Pontevedra	012	Cotobade	4786	2187	2599	36012
36	Pontevedra	013	Covelo	4046	1884	2162	36013
36	Pontevedra	014	Crecente	2984	1370	1614	36014
36	Pontevedra	015	Cuntis	5660	2610	3050	36015
36	Pontevedra	016	Dozón	2174	1037	1137	36016
36	Pontevedra	017	Estrada (A)	22317	10456	11861	36017
36	Pontevedra	018	Forcarei	4889	2303	2586	36018
36	Pontevedra	019	Fornelos de Montes	2271	1035	1236	36019
36	Pontevedra	020	Agolada	4391	2158	2233	36020
36	Pontevedra	021	Gondomar	11463	5615	5848	36021
36	Pontevedra	022	Grove (O)	11036	5467	5569	36022
36	Pontevedra	023	Guarda (A)	10000	4872	5128	36023
36	Pontevedra	024	Lalín	20169	9707	10462	36024
36	Pontevedra	025	Lama (A)	3047	1392	1655	36025
36	Pontevedra	026	Marín	25482	12572	12910	36026
36	Pontevedra	027	Meaño	5403	2580	2823	36027
36	Pontevedra	028	Meis	4973	2301	2672	36028
36	Pontevedra	029	Moaña	17907	8689	9218	36029
36	Pontevedra	030	Mondariz	5571	2594	2977	36030
36	Pontevedra	031	Mondariz-Balneario	651	310	341	36031
36	Pontevedra	032	Moraña	4327	2064	2263	36032
36	Pontevedra	033	Mos	13793	6733	7060	36033
36	Pontevedra	034	Neves (As)	4750	2260	2490	36034
36	Pontevedra	035	Nigrán	15905	7769	8136	36035
36	Pontevedra	036	Oia	2925	1454	1471	36036
36	Pontevedra	037	Pazos de Borbén	3111	1437	1674	36037
36	Pontevedra	038	Pontevedra	75212	35585	39627	36038
36	Pontevedra	039	Porriño (O)	16011	7716	8295	36039
36	Pontevedra	040	Portas	3260	1540	1720	36040
36	Pontevedra	041	Poio	14037	6807	7230	36041
36	Pontevedra	042	Ponteareas	18322	8814	9508	36042
36	Pontevedra	043	Ponte Caldelas	6501	3073	3428	36043
36	Pontevedra	044	Pontecesures	2984	1477	1507	36044
36	Pontevedra	045	Redondela	29108	14130	14978	36045
36	Pontevedra	046	Ribadumia	4221	2051	2170	36046
36	Pontevedra	047	Rodeiro	4355	2232	2123	36047
36	Pontevedra	048	Rosal (O)	5846	2811	3035	36048
36	Pontevedra	049	Salceda de Caselas	6144	3007	3137	36049
36	Pontevedra	050	Salvaterra de Miño	8501	4067	4434	36050
36	Pontevedra	051	Sanxenxo	16183	7940	8243	36051
36	Pontevedra	052	Silleda	9214	4416	4798	36052
36	Pontevedra	053	Soutomaior	5369	2588	2781	36053
36	Pontevedra	054	Tomiño	10901	5326	5575	36054
36	Pontevedra	055	Tui	15939	7612	8327	36055
36	Pontevedra	056	Valga	6310	3089	3221	36056
36	Pontevedra	057	Vigo	285526	135413	150113	36057
36	Pontevedra	058	Vilaboa	5780	2843	2937	36058
36	Pontevedra	059	Vila de Cruces	7171	3502	3669	36059
36	Pontevedra	060	Vilagarcía de Arousa	33832	16310	17522	36060
36	Pontevedra	061	Vilanova de Arousa	10303	4971	5332	36061
36	Pontevedra	901	Illa de Arousa (A)	4948	2457	2491	36901
37	Salamanca	001	Abusejo	256	126	130	37001
37	Salamanca	002	Agallas	191	98	93	37002
37	Salamanca	003	Ahigal de los Aceiteros	206	105	101	37003
37	Salamanca	004	Ahigal de Villarino	44	21	23	37004
37	Salamanca	005	Alameda de Gardón (La)	157	72	85	37005
37	Salamanca	006	Alamedilla (La)	219	112	107	37006
37	Salamanca	007	Alaraz	670	342	328	37007
37	Salamanca	008	Alba de Tormes	4654	2290	2364	37008
37	Salamanca	009	Alba de Yeltes	284	138	146	37009
37	Salamanca	010	Alberca (La)	1122	584	538	37010
37	Salamanca	011	Alberguería de Argañán (La)	200	103	97	37011
37	Salamanca	012	Alconada	226	112	114	37012
37	Salamanca	013	Aldeacipreste	225	122	103	37013
37	Salamanca	014	Aldeadávila de la Ribera	1702	856	846	37014
37	Salamanca	015	Aldea del Obispo	396	207	189	37015
37	Salamanca	016	Aldealengua	574	301	273	37016
37	Salamanca	017	Aldeanueva de Figueroa	343	176	167	37017
37	Salamanca	018	Aldeanueva de la Sierra	107	50	57	37018
37	Salamanca	019	Aldearrodrigo	214	108	106	37019
37	Salamanca	020	Aldearrubia	548	297	251	37020
37	Salamanca	021	Aldeaseca de Alba	130	63	67	37021
37	Salamanca	022	Aldeaseca de la Frontera	362	180	182	37022
37	Salamanca	023	Aldeatejada	634	307	327	37023
37	Salamanca	024	Aldeavieja de Tormes	140	71	69	37024
37	Salamanca	025	Aldehuela de la Bóveda	385	189	196	37025
37	Salamanca	026	Aldehuela de Yeltes	313	160	153	37026
37	Salamanca	027	Almenara de Tormes	254	127	127	37027
37	Salamanca	028	Almendra	196	99	97	37028
37	Salamanca	029	Anaya de Alba	322	176	146	37029
37	Salamanca	030	Añover de Tormes	108	58	50	37030
37	Salamanca	031	Arabayona de Mógica	519	276	243	37031
37	Salamanca	032	Arapiles	514	261	253	37032
37	Salamanca	033	Arcediano	118	60	58	37033
37	Salamanca	034	Arco (El)	102	57	45	37034
37	Salamanca	035	Armenteros	324	156	168	37035
37	Salamanca	036	San Miguel del Robledo	105	49	56	37036
37	Salamanca	037	Atalaya (La)	158	85	73	37037
37	Salamanca	038	Babilafuente	986	515	471	37038
37	Salamanca	039	Bañobárez	429	220	209	37039
37	Salamanca	040	Barbadillo	565	271	294	37040
37	Salamanca	041	Barbalos	108	55	53	37041
37	Salamanca	042	Barceo	70	38	32	37042
37	Salamanca	044	Barruecopardo	587	295	292	37044
37	Salamanca	045	Bastida (La)	39	21	18	37045
37	Salamanca	046	Béjar	15690	7435	8255	37046
37	Salamanca	047	Beleña	148	75	73	37047
37	Salamanca	049	Bermellar	222	109	113	37049
37	Salamanca	050	Berrocal de Huebra	122	60	62	37050
37	Salamanca	051	Berrocal de Salvatierra	135	68	67	37051
37	Salamanca	052	Boada	426	216	210	37052
37	Salamanca	054	Bodón (El)	339	174	165	37054
37	Salamanca	055	Bogajo	211	111	100	37055
37	Salamanca	056	Bouza (La)	70	33	37	37056
37	Salamanca	057	Bóveda del Río Almar	315	168	147	37057
37	Salamanca	058	Brincones	108	55	53	37058
37	Salamanca	059	Buenamadre	180	94	86	37059
37	Salamanca	060	Buenavista	94	50	44	37060
37	Salamanca	061	Cabaco (El)	285	144	141	37061
37	Salamanca	062	Cabezabellosa de la Calzada	135	73	62	37062
37	Salamanca	063	Cabeza de Béjar (La)	110	56	54	37063
37	Salamanca	065	Cabeza del Caballo	482	251	231	37065
37	Salamanca	067	Cabrerizos	2015	995	1020	37067
37	Salamanca	068	Cabrillas	538	255	283	37068
37	Salamanca	069	Calvarrasa de Abajo	988	496	492	37069
37	Salamanca	070	Calvarrasa de Arriba	680	349	331	37070
37	Salamanca	071	Calzada de Béjar (La)	106	58	48	37071
37	Salamanca	072	Calzada de Don Diego	260	134	126	37072
37	Salamanca	073	Calzada de Valdunciel	659	322	337	37073
37	Salamanca	074	Campillo de Azaba	265	132	133	37074
37	Salamanca	077	Campo de Peñaranda (El)	394	200	194	37077
37	Salamanca	078	Candelario	1109	539	570	37078
37	Salamanca	079	Canillas de Abajo	110	63	47	37079
37	Salamanca	080	Cantagallo	288	140	148	37080
37	Salamanca	081	Cantalapiedra	1323	655	668	37081
37	Salamanca	082	Cantalpino	1174	632	542	37082
37	Salamanca	083	Cantaracillo	281	144	137	37083
37	Salamanca	085	Carbajosa de la Sagrada	1674	840	834	37085
37	Salamanca	086	Carpio de Azaba	110	57	53	37086
37	Salamanca	087	Carrascal de Barregas	495	256	239	37087
37	Salamanca	088	Carrascal del Obispo	255	124	131	37088
37	Salamanca	089	Casafranca	86	40	46	37089
37	Salamanca	090	Casas del Conde (Las)	88	40	48	37090
37	Salamanca	091	Casillas de Flores	264	123	141	37091
37	Salamanca	092	Castellanos de Moriscos	373	174	199	37092
37	Salamanca	096	Castillejo de Martín Viejo	337	176	161	37096
37	Salamanca	097	Castraz	61	36	25	37097
37	Salamanca	098	Cepeda	530	256	274	37098
37	Salamanca	099	Cereceda de la Sierra	104	52	52	37099
37	Salamanca	100	Cerezal de Peñahorcada	127	71	56	37100
37	Salamanca	101	Cerralbo	256	132	124	37101
37	Salamanca	102	Cerro (El)	555	295	260	37102
37	Salamanca	103	Cespedosa de Tormes	650	339	311	37103
37	Salamanca	104	Cilleros de la Bastida	41	21	20	37104
37	Salamanca	106	Cipérez	439	221	218	37106
37	Salamanca	107	Ciudad Rodrigo	14556	6972	7584	37107
37	Salamanca	108	Coca de Alba	158	71	87	37108
37	Salamanca	109	Colmenar de Montemayor	273	153	120	37109
37	Salamanca	110	Cordovilla	145	83	62	37110
37	Salamanca	112	Cristóbal	254	130	124	37112
37	Salamanca	113	Cubo de Don Sancho (El)	592	310	282	37113
37	Salamanca	114	Chagarcía Medianero	146	79	67	37114
37	Salamanca	115	Dios le Guarde	166	92	74	37115
37	Salamanca	116	Doñinos de Ledesma	108	58	50	37116
37	Salamanca	117	Doñinos de Salamanca	726	376	350	37117
37	Salamanca	118	Ejeme	199	107	92	37118
37	Salamanca	119	Encina (La)	205	111	94	37119
37	Salamanca	120	Encina de San Silvestre	125	62	63	37120
37	Salamanca	121	Encinas de Abajo	671	349	322	37121
37	Salamanca	122	Encinas de Arriba	288	138	150	37122
37	Salamanca	123	Encinasola de los Comendadores	297	151	146	37123
37	Salamanca	124	Endrinal	301	167	134	37124
37	Salamanca	125	Escurial de la Sierra	299	152	147	37125
37	Salamanca	126	Espadaña	50	27	23	37126
37	Salamanca	127	Espeja	298	157	141	37127
37	Salamanca	128	Espino de la Orbada	362	183	179	37128
37	Salamanca	129	Florida de Liébana	252	135	117	37129
37	Salamanca	130	Forfoleda	251	124	127	37130
37	Salamanca	131	Frades de la Sierra	286	150	136	37131
37	Salamanca	132	Fregeneda (La)	554	271	283	37132
37	Salamanca	133	Fresnedoso	128	58	70	37133
37	Salamanca	134	Fresno Alhándiga	314	166	148	37134
37	Salamanca	135	Fuente de San Esteban (La)	1544	784	760	37135
37	Salamanca	136	Fuenteguinaldo	938	474	464	37136
37	Salamanca	137	Fuenteliante	142	68	74	37137
37	Salamanca	138	Fuenterroble de Salvatierra	270	137	133	37138
37	Salamanca	139	Fuentes de Béjar	282	121	161	37139
37	Salamanca	140	Fuentes de Oñoro	1396	672	724	37140
37	Salamanca	141	Gajates	246	122	124	37141
37	Salamanca	142	Galindo y Perahuy	362	199	163	37142
37	Salamanca	143	Galinduste	584	286	298	37143
37	Salamanca	144	Galisancho	566	316	250	37144
37	Salamanca	145	Gallegos de Argañán	415	218	197	37145
37	Salamanca	146	Gallegos de Solmirón	199	94	105	37146
37	Salamanca	147	Garcibuey	294	164	130	37147
37	Salamanca	148	Garcihernández	606	320	286	37148
37	Salamanca	149	Garcirrey	111	55	56	37149
37	Salamanca	150	Gejuelo del Barro	53	29	24	37150
37	Salamanca	151	Golpejas	201	99	102	37151
37	Salamanca	152	Gomecello	525	270	255	37152
37	Salamanca	154	Guadramiro	223	130	93	37154
37	Salamanca	155	Guijo de Ávila	115	64	51	37155
37	Salamanca	156	Guijuelo	5082	2527	2555	37156
37	Salamanca	157	Herguijuela de Ciudad Rodrigo	143	77	66	37157
37	Salamanca	158	Herguijuela de la Sierra	326	162	164	37158
37	Salamanca	159	Herguijuela del Campo	124	57	67	37159
37	Salamanca	160	Hinojosa de Duero	840	417	423	37160
37	Salamanca	161	Horcajo de Montemayor	207	105	102	37161
37	Salamanca	162	Horcajo Medianero	368	178	190	37162
37	Salamanca	163	Hoya (La)	23	18	5	37163
37	Salamanca	164	Huerta	275	145	130	37164
37	Salamanca	165	Iruelos	65	27	38	37165
37	Salamanca	166	Ituero de Azaba	271	145	126	37166
37	Salamanca	167	Juzbado	197	103	94	37167
37	Salamanca	168	Lagunilla	640	341	299	37168
37	Salamanca	169	Larrodrigo	305	159	146	37169
37	Salamanca	170	Ledesma	1954	960	994	37170
37	Salamanca	171	Ledrada	606	308	298	37171
37	Salamanca	172	Linares de Riofrío	1053	530	523	37172
37	Salamanca	173	Lumbrales	2210	1100	1110	37173
37	Salamanca	174	Macotera	1695	861	834	37174
37	Salamanca	175	Machacón	543	276	267	37175
37	Salamanca	176	Madroñal	182	98	84	37176
37	Salamanca	177	Maíllo (El)	443	226	217	37177
37	Salamanca	178	Malpartida	159	88	71	37178
37	Salamanca	179	Mancera de Abajo	363	185	178	37179
37	Salamanca	180	Manzano (El)	96	50	46	37180
37	Salamanca	181	Martiago	380	201	179	37181
37	Salamanca	182	Martinamor	82	43	39	37182
37	Salamanca	183	Martín de Yeltes	560	287	273	37183
37	Salamanca	184	Masueco	473	237	236	37184
37	Salamanca	185	Castellanos de Villiquera	587	305	282	37185
37	Salamanca	186	Mata de Ledesma (La)	146	70	76	37186
37	Salamanca	187	Matilla de los Caños del Río	711	363	348	37187
37	Salamanca	188	Maya (La)	262	141	121	37188
37	Salamanca	189	Membribe de la Sierra	87	46	41	37189
37	Salamanca	190	Mieza	354	175	179	37190
37	Salamanca	191	Milano (El)	178	95	83	37191
37	Salamanca	192	Miranda de Azán	323	155	168	37192
37	Salamanca	193	Miranda del Castañar	654	347	307	37193
37	Salamanca	194	Mogarraz	365	172	193	37194
37	Salamanca	195	Molinillo	82	38	44	37195
37	Salamanca	196	Monforte de la Sierra	113	66	47	37196
37	Salamanca	197	Monleón	135	76	59	37197
37	Salamanca	198	Monleras	262	135	127	37198
37	Salamanca	199	Monsagro	237	136	101	37199
37	Salamanca	200	Montejo	239	132	107	37200
37	Salamanca	201	Montemayor del Río	377	204	173	37201
37	Salamanca	202	Monterrubio de Armuña	545	286	259	37202
37	Salamanca	203	Monterrubio de la Sierra	177	95	82	37203
37	Salamanca	204	Morasverdes	447	227	220	37204
37	Salamanca	205	Morille	186	100	86	37205
37	Salamanca	206	Moríñigo	137	70	67	37206
37	Salamanca	207	Moriscos	143	72	71	37207
37	Salamanca	208	Moronta	127	68	59	37208
37	Salamanca	209	Mozárbez	414	213	201	37209
37	Salamanca	211	Narros de Matalayegua	302	161	141	37211
37	Salamanca	212	Navacarros	132	72	60	37212
37	Salamanca	213	Nava de Béjar	122	61	61	37213
37	Salamanca	214	Nava de Francia	150	78	72	37214
37	Salamanca	215	Nava de Sotrobal	217	113	104	37215
37	Salamanca	216	Navales	392	226	166	37216
37	Salamanca	217	Navalmoral de Béjar	75	37	38	37217
37	Salamanca	218	Navamorales	172	93	79	37218
37	Salamanca	219	Navarredonda de la Rinconada	278	141	137	37219
37	Salamanca	221	Navasfrías	711	350	361	37221
37	Salamanca	222	Negrilla de Palencia	127	58	69	37222
37	Salamanca	223	Olmedo de Camaces	172	83	89	37223
37	Salamanca	224	Orbada (La)	284	149	135	37224
37	Salamanca	225	Pajares de la Laguna	144	72	72	37225
37	Salamanca	226	Palacios del Arzobispo	238	123	115	37226
37	Salamanca	228	Palaciosrubios	547	292	255	37228
37	Salamanca	229	Palencia de Negrilla	196	100	96	37229
37	Salamanca	230	Parada de Arriba	247	139	108	37230
37	Salamanca	231	Parada de Rubiales	345	182	163	37231
37	Salamanca	232	Paradinas de San Juan	652	352	300	37232
37	Salamanca	233	Pastores	56	29	27	37233
37	Salamanca	234	Payo (El)	496	242	254	37234
37	Salamanca	235	Pedraza de Alba	289	150	139	37235
37	Salamanca	236	Pedrosillo de Alba	258	126	132	37236
37	Salamanca	237	Pedrosillo de los Aires	457	252	205	37237
37	Salamanca	238	Pedrosillo el Ralo	153	73	80	37238
37	Salamanca	239	Pedroso de la Armuña (El)	319	157	162	37239
37	Salamanca	240	Pelabravo	799	411	388	37240
37	Salamanca	241	Pelarrodríguez	207	116	91	37241
37	Salamanca	242	Pelayos	77	39	38	37242
37	Salamanca	243	Peña (La)	156	72	84	37243
37	Salamanca	244	Peñacaballera	218	100	118	37244
37	Salamanca	245	Peñaparda	479	243	236	37245
37	Salamanca	246	Peñaranda de Bracamonte	6235	3048	3187	37246
37	Salamanca	247	Peñarandilla	279	135	144	37247
37	Salamanca	248	Peralejos de Abajo	197	94	103	37248
37	Salamanca	249	Peralejos de Arriba	70	39	31	37249
37	Salamanca	250	Pereña de la Ribera	557	281	276	37250
37	Salamanca	251	Peromingo	163	76	87	37251
37	Salamanca	252	Pinedas	188	97	91	37252
37	Salamanca	253	Pino de Tormes (El)	189	95	94	37253
37	Salamanca	254	Pitiegua	266	136	130	37254
37	Salamanca	255	Pizarral	100	48	52	37255
37	Salamanca	256	Poveda de las Cintas	342	186	156	37256
37	Salamanca	257	Pozos de Hinojo	83	42	41	37257
37	Salamanca	258	Puebla de Azaba	286	149	137	37258
37	Salamanca	259	Puebla de San Medel	67	36	31	37259
37	Salamanca	260	Puebla de Yeltes	252	133	119	37260
37	Salamanca	261	Puente del Congosto	341	168	173	37261
37	Salamanca	262	Puertas	108	59	49	37262
37	Salamanca	263	Puerto de Béjar	494	230	264	37263
37	Salamanca	264	Puerto Seguro	107	55	52	37264
37	Salamanca	265	Rágama	310	163	147	37265
37	Salamanca	266	Redonda (La)	114	55	59	37266
37	Salamanca	267	Retortillo	241	116	125	37267
37	Salamanca	268	Rinconada de la Sierra (La)	182	95	87	37268
37	Salamanca	269	Robleda	574	302	272	37269
37	Salamanca	270	Robliza de Cojos	209	105	104	37270
37	Salamanca	271	Rollán	597	304	293	37271
37	Salamanca	272	Saelices el Chico	176	92	84	37272
37	Salamanca	273	Sagrada (La)	184	95	89	37273
37	Salamanca	274	Salamanca	158556	74303	84253	37274
37	Salamanca	275	Saldeana	182	98	84	37275
37	Salamanca	276	Salmoral	327	164	163	37276
37	Salamanca	277	Salvatierra de Tormes	62	29	33	37277
37	Salamanca	278	San Cristóbal de la Cuesta	393	207	186	37278
37	Salamanca	279	Sancti-Spíritus	1172	610	562	37279
37	Salamanca	280	Sanchón de la Ribera	120	63	57	37280
37	Salamanca	281	Sanchón de la Sagrada	55	30	25	37281
37	Salamanca	282	Sanchotello	317	163	154	37282
37	Salamanca	283	Sando	176	94	82	37283
37	Salamanca	284	San Esteban de la Sierra	425	213	212	37284
37	Salamanca	285	San Felices de los Gallegos	645	321	324	37285
37	Salamanca	286	San Martín del Castañar	291	153	138	37286
37	Salamanca	287	San Miguel de Valero	431	228	203	37287
37	Salamanca	288	San Morales	231	128	103	37288
37	Salamanca	289	San Muñoz	364	183	181	37289
37	Salamanca	290	San Pedro del Valle	134	65	69	37290
37	Salamanca	291	San Pedro de Rozados	343	169	174	37291
37	Salamanca	292	San Pelayo de Guareña	106	54	52	37292
37	Salamanca	293	Santa María de Sando	183	96	87	37293
37	Salamanca	294	Santa Marta de Tormes	10546	5278	5268	37294
37	Salamanca	296	Santiago de la Puebla	545	281	264	37296
37	Salamanca	297	Santibáñez de Béjar	667	337	330	37297
37	Salamanca	298	Santibáñez de la Sierra	251	136	115	37298
37	Salamanca	299	Santiz	294	147	147	37299
37	Salamanca	300	Santos (Los)	716	364	352	37300
37	Salamanca	301	Sardón de los Frailes	102	54	48	37301
37	Salamanca	302	Saucelle	439	212	227	37302
37	Salamanca	303	Sahugo (El)	276	147	129	37303
37	Salamanca	304	Sepulcro-Hilario	294	152	142	37304
37	Salamanca	305	Sequeros	267	121	146	37305
37	Salamanca	306	Serradilla del Arroyo	448	230	218	37306
37	Salamanca	307	Serradilla del Llano	270	136	134	37307
37	Salamanca	309	Sierpe (La)	50	30	20	37309
37	Salamanca	310	Sieteiglesias de Tormes	184	91	93	37310
37	Salamanca	311	Sobradillo	376	179	197	37311
37	Salamanca	312	Sorihuela	366	178	188	37312
37	Salamanca	313	Sotoserrano	737	385	352	37313
37	Salamanca	314	Tabera de Abajo	111	59	52	37314
37	Salamanca	315	Tala (La)	141	74	67	37315
37	Salamanca	316	Tamames	995	509	486	37316
37	Salamanca	317	Tarazona de Guareña	434	233	201	37317
37	Salamanca	318	Tardáguila	262	140	122	37318
37	Salamanca	319	Tejado (El)	175	87	88	37319
37	Salamanca	320	Tejeda y Segoyuela	119	59	60	37320
37	Salamanca	321	Tenebrón	235	123	112	37321
37	Salamanca	322	Terradillos	3049	1577	1472	37322
37	Salamanca	323	Topas	717	365	352	37323
37	Salamanca	324	Tordillos	569	294	275	37324
37	Salamanca	325	Tornadizo (El)	147	77	70	37325
37	Salamanca	327	Torresmenudas	233	111	122	37327
37	Salamanca	328	Trabanca	245	128	117	37328
37	Salamanca	329	Tremedal de Tormes	43	22	21	37329
37	Salamanca	330	Valdecarros	454	232	222	37330
37	Salamanca	331	Valdefuentes de Sangusín	331	166	165	37331
37	Salamanca	332	Valdehijaderos	119	64	55	37332
37	Salamanca	333	Valdelacasa	344	190	154	37333
37	Salamanca	334	Valdelageve	127	67	60	37334
37	Salamanca	335	Valdelosa	489	230	259	37335
37	Salamanca	336	Valdemierque	70	35	35	37336
37	Salamanca	337	Valderrodrigo	191	90	101	37337
37	Salamanca	338	Valdunciel	118	57	61	37338
37	Salamanca	339	Valero	449	220	229	37339
37	Salamanca	340	Valsalabroso	232	124	108	37340
37	Salamanca	341	Valverde de Valdelacasa	74	37	37	37341
37	Salamanca	342	Valverdón	281	146	135	37342
37	Salamanca	343	Vallejera de Riofrío	56	30	26	37343
37	Salamanca	344	Vecinos	305	151	154	37344
37	Salamanca	345	Vega de Tirados	220	111	109	37345
37	Salamanca	346	Veguillas (Las)	303	150	153	37346
37	Salamanca	347	Vellés (La)	441	223	218	37347
37	Salamanca	348	Ventosa del Río Almar	147	68	79	37348
37	Salamanca	349	Vídola (La)	179	91	88	37349
37	Salamanca	350	Vilvestre	629	307	322	37350
37	Salamanca	351	Villaflores	454	228	226	37351
37	Salamanca	352	Villagonzalo de Tormes	237	118	119	37352
37	Salamanca	353	Villalba de los Llanos	195	107	88	37353
37	Salamanca	354	Villamayor	2901	1510	1391	37354
37	Salamanca	355	Villanueva del Conde	257	134	123	37355
37	Salamanca	356	Villar de Argañán	120	60	60	37356
37	Salamanca	357	Villar de Ciervo	400	207	193	37357
37	Salamanca	358	Villar de Gallimazo	213	104	109	37358
37	Salamanca	359	Villar de la Yegua	301	138	163	37359
37	Salamanca	360	Villar de Peralonso	344	159	185	37360
37	Salamanca	361	Villar de Samaniego	128	70	58	37361
37	Salamanca	362	Villares de la Reina	2901	1476	1425	37362
37	Salamanca	363	Villares de Yeltes	170	80	90	37363
37	Salamanca	364	Villarino de los Aires	1067	540	527	37364
37	Salamanca	365	Villarmayor	230	121	109	37365
37	Salamanca	366	Villarmuerto	61	35	26	37366
37	Salamanca	367	Villasbuenas	312	163	149	37367
37	Salamanca	368	Villasdardo	22	9	13	37368
37	Salamanca	369	Villaseco de los Gamitos	215	109	106	37369
37	Salamanca	370	Villaseco de los Reyes	436	224	212	37370
37	Salamanca	371	Villasrubias	355	193	162	37371
37	Salamanca	372	Villaverde de Guareña	193	94	99	37372
37	Salamanca	373	Villavieja de Yeltes	1119	558	561	37373
37	Salamanca	374	Villoria	1400	700	700	37374
37	Salamanca	375	Villoruela	1018	507	511	37375
37	Salamanca	376	Vitigudino	3128	1535	1593	37376
37	Salamanca	377	Yecla de Yeltes	357	176	181	37377
37	Salamanca	378	Zamarra	153	81	72	37378
37	Salamanca	379	Zamayón	208	118	90	37379
37	Salamanca	380	Zarapicos	67	38	29	37380
37	Salamanca	381	Zarza de Pumareda (La)	198	110	88	37381
37	Salamanca	382	Zorita de la Frontera	278	153	125	37382
38	Santa Cruz de Tenerife	001	Adeje	14007	7023	6984	38001
38	Santa Cruz de Tenerife	002	Agulo	1143	563	580	38002
38	Santa Cruz de Tenerife	003	Alajeró	1343	719	624	38003
38	Santa Cruz de Tenerife	004	Arafo	4802	2322	2480	38004
38	Santa Cruz de Tenerife	005	Arico	5644	2902	2742	38005
38	Santa Cruz de Tenerife	006	Arona	38416	19420	18996	38006
38	Santa Cruz de Tenerife	007	Barlovento	2398	1204	1194	38007
38	Santa Cruz de Tenerife	008	Breña Alta	5898	2906	2992	38008
38	Santa Cruz de Tenerife	009	Breña Baja	4051	2044	2007	38009
38	Santa Cruz de Tenerife	010	Buenavista del Norte	5140	2617	2523	38010
38	Santa Cruz de Tenerife	011	Candelaria	13294	6606	6688	38011
38	Santa Cruz de Tenerife	012	Fasnia	2554	1305	1249	38012
38	Santa Cruz de Tenerife	013	Frontera	4892	2480	2412	38013
38	Santa Cruz de Tenerife	014	Fuencaliente de la Palma	1800	918	882	38014
38	Santa Cruz de Tenerife	015	Garachico	5492	2710	2782	38015
38	Santa Cruz de Tenerife	016	Garafía	2007	1023	984	38016
38	Santa Cruz de Tenerife	017	Granadilla de Abona	20323	10264	10059	38017
38	Santa Cruz de Tenerife	018	Guancha (La)	5269	2613	2656	38018
38	Santa Cruz de Tenerife	019	Guía de Isora	14674	7286	7388	38019
38	Santa Cruz de Tenerife	020	Güímar	14646	7203	7443	38020
38	Santa Cruz de Tenerife	021	Hermigua	2131	1093	1038	38021
38	Santa Cruz de Tenerife	022	Icod de los Vinos	19977	9799	10178	38022
38	Santa Cruz de Tenerife	023	San Cristóbal de La Laguna	126543	62089	64454	38023
38	Santa Cruz de Tenerife	024	Llanos de Aridane (Los)	18190	8971	9219	38024
38	Santa Cruz de Tenerife	025	Matanza de Acentejo (La)	7000	3549	3451	38025
38	Santa Cruz de Tenerife	026	Orotava (La)	38348	19003	19345	38026
38	Santa Cruz de Tenerife	027	Paso (El)	7289	3702	3587	38027
38	Santa Cruz de Tenerife	028	Puerto de la Cruz	24988	12023	12965	38028
38	Santa Cruz de Tenerife	029	Puntagorda	1785	883	902	38029
38	Santa Cruz de Tenerife	030	Puntallana	2204	1087	1117	38030
38	Santa Cruz de Tenerife	031	Realejos (Los)	34147	16880	17267	38031
38	Santa Cruz de Tenerife	032	Rosario (El)	12696	6409	6287	38032
38	Santa Cruz de Tenerife	033	San Andrés y Sauces	5229	2650	2579	38033
38	Santa Cruz de Tenerife	034	San Juan de la Rambla	4345	2150	2195	38034
38	Santa Cruz de Tenerife	035	San Miguel de Abona	7315	3708	3607	38035
38	Santa Cruz de Tenerife	036	San Sebastián de la Gomera	7001	3542	3459	38036
38	Santa Cruz de Tenerife	037	Santa Cruz de la Palma	18204	8866	9338	38037
38	Santa Cruz de Tenerife	038	Santa Cruz de Tenerife	215132	103642	111490	38038
38	Santa Cruz de Tenerife	039	Santa Úrsula	10529	5273	5256	38039
38	Santa Cruz de Tenerife	040	Santiago del Teide	8863	4507	4356	38040
38	Santa Cruz de Tenerife	041	Sauzal (El)	7443	3723	3720	38041
38	Santa Cruz de Tenerife	042	Silos (Los)	5066	2488	2578	38042
38	Santa Cruz de Tenerife	043	Tacoronte	20800	10464	10336	38043
38	Santa Cruz de Tenerife	044	Tanque (El)	3000	1523	1477	38044
38	Santa Cruz de Tenerife	045	Tazacorte	6147	3095	3052	38045
38	Santa Cruz de Tenerife	046	Tegueste	9226	4574	4652	38046
38	Santa Cruz de Tenerife	047	Tijarafe	2672	1353	1319	38047
38	Santa Cruz de Tenerife	048	Valverde	3641	1822	1819	38048
38	Santa Cruz de Tenerife	049	Valle Gran Rey	4002	2046	1956	38049
38	Santa Cruz de Tenerife	050	Vallehermoso	2680	1354	1326	38050
38	Santa Cruz de Tenerife	051	Victoria de Acentejo (La)	8052	3988	4064	38051
38	Santa Cruz de Tenerife	052	Vilaflor	1634	816	818	38052
38	Santa Cruz de Tenerife	053	Villa de Mazo	4609	2329	2280	38053
39	Cantabria	001	Alfoz de Lloredo	2614	1327	1287	39001
39	Cantabria	002	Ampuero	3491	1765	1726	39002
39	Cantabria	003	Anievas	381	193	188	39003
39	Cantabria	004	Arenas de Iguña	2041	1019	1022	39004
39	Cantabria	005	Argoños	868	448	420	39005
39	Cantabria	006	Arnuero	1783	900	883	39006
39	Cantabria	007	Arredondo	635	355	280	39007
39	Cantabria	008	Astillero (El)	13348	6437	6911	39008
39	Cantabria	009	Bárcena de Cicero	2334	1178	1156	39009
39	Cantabria	010	Bárcena de Pie de Concha	922	452	470	39010
39	Cantabria	011	Bareyo	1708	874	834	39011
39	Cantabria	012	Cabezón de la Sal	7182	3539	3643	39012
39	Cantabria	013	Cabezón de Liébana	679	370	309	39013
39	Cantabria	014	Cabuérniga	1083	551	532	39014
39	Cantabria	015	Camaleño	1101	574	527	39015
39	Cantabria	016	Camargo	22749	11122	11627	39016
39	Cantabria	017	Campoo de Yuso	739	368	371	39017
39	Cantabria	018	Cartes	3415	1728	1687	39018
39	Cantabria	019	Castañeda	1423	695	728	39019
39	Cantabria	020	Castro-Urdiales	18719	9351	9368	39020
39	Cantabria	021	Cieza	682	329	353	39021
39	Cantabria	022	Cillorigo de Liébana	1103	589	514	39022
39	Cantabria	023	Colindres	6577	3306	3271	39023
39	Cantabria	024	Comillas	2359	1121	1238	39024
39	Cantabria	025	Corrales de Buelna (Los)	10718	5361	5357	39025
39	Cantabria	026	Corvera de Toranzo	2046	1023	1023	39026
39	Cantabria	027	Campoo de Enmedio	3972	2016	1956	39027
39	Cantabria	028	Entrambasaguas	2473	1239	1234	39028
39	Cantabria	029	Escalante	754	393	361	39029
39	Cantabria	030	Guriezo	1730	906	824	39030
39	Cantabria	031	Hazas de Cesto	1260	646	614	39031
39	Cantabria	032	Hermandad de Campoo de Suso	1895	1026	869	39032
39	Cantabria	033	Herrerías	786	435	351	39033
39	Cantabria	034	Lamasón	393	221	172	39034
39	Cantabria	035	Laredo	12634	6117	6517	39035
39	Cantabria	036	Liendo	831	430	401	39036
39	Cantabria	037	Liérganes	2270	1118	1152	39037
39	Cantabria	038	Limpias	1344	679	665	39038
39	Cantabria	039	Luena	956	503	453	39039
39	Cantabria	040	Marina de Cudeyo	4765	2391	2374	39040
39	Cantabria	041	Mazcuerras	1869	996	873	39041
39	Cantabria	042	Medio Cudeyo	6087	2979	3108	39042
39	Cantabria	043	Meruelo	1121	564	557	39043
39	Cantabria	044	Miengo	3544	1763	1781	39044
39	Cantabria	045	Miera	532	265	267	39045
39	Cantabria	046	Molledo	1935	925	1010	39046
39	Cantabria	047	Noja	2019	1005	1014	39047
39	Cantabria	048	Penagos	1633	804	829	39048
39	Cantabria	049	Peñarrubia	284	142	142	39049
39	Cantabria	050	Pesaguero	402	216	186	39050
39	Cantabria	051	Pesquera	95	47	48	39051
39	Cantabria	052	Piélagos	11862	5880	5982	39052
39	Cantabria	053	Polaciones	294	179	115	39053
39	Cantabria	054	Polanco	3574	1722	1852	39054
39	Cantabria	055	Potes	1573	772	801	39055
39	Cantabria	056	Puente Viesgo	2358	1178	1180	39056
39	Cantabria	057	Ramales de la Victoria	2228	1154	1074	39057
39	Cantabria	058	Rasines	963	494	469	39058
39	Cantabria	059	Reinosa	11193	5398	5795	39059
39	Cantabria	060	Reocín	6900	3441	3459	39060
39	Cantabria	061	Ribamontán al Mar	3651	1876	1775	39061
39	Cantabria	062	Ribamontán al Monte	1991	1029	962	39062
39	Cantabria	063	Rionansa	1444	808	636	39063
39	Cantabria	064	Riotuerto	1509	725	784	39064
39	Cantabria	065	Rozas de Valdearroyo (Las)	325	182	143	39065
39	Cantabria	066	Ruente	955	513	442	39066
39	Cantabria	067	Ruesga	1224	632	592	39067
39	Cantabria	068	Ruiloba	721	365	356	39068
39	Cantabria	069	San Felices de Buelna	2168	1047	1121	39069
39	Cantabria	070	San Miguel de Aguayo	158	85	73	39070
39	Cantabria	071	San Pedro del Romeral	645	331	314	39071
39	Cantabria	072	San Roque de Riomiera	528	301	227	39072
39	Cantabria	073	Santa Cruz de Bezana	7890	3895	3995	39073
39	Cantabria	074	Santa María de Cayón	6354	3185	3169	39074
39	Cantabria	075	Santander	184264	86324	97940	39075
39	Cantabria	076	Santillana del Mar	3909	1916	1993	39076
39	Cantabria	077	Santiurde de Reinosa	321	174	147	39077
39	Cantabria	078	Santiurde de Toranzo	1627	819	808	39078
39	Cantabria	079	Santoña	11556	5833	5723	39079
39	Cantabria	080	San Vicente de la Barquera	4412	2244	2168	39080
39	Cantabria	081	Saro	527	265	262	39081
39	Cantabria	082	Selaya	2010	1024	986	39082
39	Cantabria	083	Soba	1677	876	801	39083
39	Cantabria	084	Solórzano	995	508	487	39084
39	Cantabria	085	Suances	6456	3184	3272	39085
39	Cantabria	086	Tojos (Los)	398	215	183	39086
39	Cantabria	087	Torrelavega	56189	26988	29201	39087
39	Cantabria	088	Tresviso	60	35	25	39088
39	Cantabria	089	Tudanca	269	165	104	39089
39	Cantabria	090	Udías	843	430	413	39090
39	Cantabria	091	Valdáliga	2541	1307	1234	39091
39	Cantabria	092	Valdeolea	1503	768	735	39092
39	Cantabria	093	Valdeprado del Río	312	164	148	39093
39	Cantabria	094	Valderredible	1261	662	599	39094
39	Cantabria	095	Val de San Vicente	2560	1314	1246	39095
39	Cantabria	096	Vega de Liébana	999	541	458	39096
39	Cantabria	097	Vega de Pas	1004	520	484	39097
39	Cantabria	098	Villacarriedo	1758	916	842	39098
39	Cantabria	099	Villaescusa	3177	1565	1612	39099
39	Cantabria	100	Villafufre	1145	599	546	39100
39	Cantabria	101	Villaverde de Trucíos	367	187	180	39101
39	Cantabria	102	Voto	2227	1146	1081	39102
40	Segovia	001	Abades	848	427	421	40001
40	Segovia	002	Adrada de Pirón	60	34	26	40002
40	Segovia	003	Adrados	212	108	104	40003
40	Segovia	004	Aguilafuente	802	391	411	40004
40	Segovia	005	Alconada de Maderuelo	55	32	23	40005
40	Segovia	006	Aldealcorvo	30	14	16	40006
40	Segovia	007	Aldealengua de Pedraza	92	50	42	40007
40	Segovia	008	Aldealengua de Santa María	90	46	44	40008
40	Segovia	009	Aldeanueva de la Serrezuela	49	29	20	40009
40	Segovia	010	Aldeanueva del Codonal	212	110	102	40010
40	Segovia	012	Aldea Real	390	207	183	40012
40	Segovia	013	Aldeasoña	106	50	56	40013
40	Segovia	014	Aldehorno	81	43	38	40014
40	Segovia	015	Aldehuela del Codonal	53	26	27	40015
40	Segovia	016	Aldeonte	91	45	46	40016
40	Segovia	017	Anaya	132	69	63	40017
40	Segovia	018	Añe	121	63	58	40018
40	Segovia	019	Arahuetes	45	24	21	40019
40	Segovia	020	Arcones	248	130	118	40020
40	Segovia	021	Arevalillo de Cega	44	20	24	40021
40	Segovia	022	Armuña	261	146	115	40022
40	Segovia	024	Ayllón	1216	606	610	40024
40	Segovia	025	Barbolla	221	118	103	40025
40	Segovia	026	Basardilla	100	49	51	40026
40	Segovia	028	Bercial	131	61	70	40028
40	Segovia	029	Bercimuel	88	40	48	40029
40	Segovia	030	Bernardos	712	362	350	40030
40	Segovia	031	Bernuy de Porreros	309	158	151	40031
40	Segovia	032	Boceguillas	553	278	275	40032
40	Segovia	033	Brieva	71	44	27	40033
40	Segovia	034	Caballar	96	47	49	40034
40	Segovia	035	Cabañas de Polendos	117	59	58	40035
40	Segovia	036	Cabezuela	721	381	340	40036
40	Segovia	037	Calabazas de Fuentidueña	76	37	39	40037
40	Segovia	039	Campo de San Pedro	385	221	164	40039
40	Segovia	040	Cantalejo	3463	1756	1707	40040
40	Segovia	041	Cantimpalos	1275	653	622	40041
40	Segovia	043	Carbonero el Mayor	2299	1161	1138	40043
40	Segovia	044	Carrascal del Río	210	112	98	40044
40	Segovia	045	Casla	155	82	73	40045
40	Segovia	046	Castillejo de Mesleón	120	60	60	40046
40	Segovia	047	Castro de Fuentidueña	91	50	41	40047
40	Segovia	048	Castrojimeno	45	26	19	40048
40	Segovia	049	Castroserna de Abajo	63	36	27	40049
40	Segovia	051	Castroserracín	67	38	29	40051
40	Segovia	052	Cedillo de la Torre	124	60	64	40052
40	Segovia	053	Cerezo de Abajo	170	83	87	40053
40	Segovia	054	Cerezo de Arriba	201	102	99	40054
40	Segovia	055	Cilleruelo de San Mamés	48	21	27	40055
40	Segovia	056	Cobos de Fuentidueña	68	29	39	40056
40	Segovia	057	Coca	1968	968	1000	40057
40	Segovia	058	Codorniz	471	227	244	40058
40	Segovia	059	Collado Hermoso	152	74	78	40059
40	Segovia	060	Condado de Castilnovo	124	67	57	40060
40	Segovia	061	Corral de Ayllón	109	57	52	40061
40	Segovia	062	Cubillo	55	32	23	40062
40	Segovia	063	Cuéllar	9044	4599	4445	40063
40	Segovia	065	Chañe	720	386	334	40065
40	Segovia	068	Domingo García	49	25	24	40068
40	Segovia	069	Donhierro	105	58	47	40069
40	Segovia	070	Duruelo	136	72	64	40070
40	Segovia	071	Encinas	72	34	38	40071
40	Segovia	072	Encinillas	75	41	34	40072
40	Segovia	073	Escalona del Prado	589	313	276	40073
40	Segovia	074	Escarabajosa de Cabezas	380	202	178	40074
40	Segovia	075	Escobar de Polendos	234	121	113	40075
40	Segovia	076	Espinar (El)	6225	3178	3047	40076
40	Segovia	077	Espirdo	215	119	96	40077
40	Segovia	078	Fresneda de Cuéllar	246	130	116	40078
40	Segovia	079	Fresno de Cantespino	249	133	116	40079
40	Segovia	080	Fresno de la Fuente	78	39	39	40080
40	Segovia	081	Frumales	201	104	97	40081
40	Segovia	082	Fuente de Santa Cruz	194	97	97	40082
40	Segovia	083	Fuente el Olmo de Fuentidueña	146	73	73	40083
40	Segovia	084	Fuente el Olmo de Íscar	106	57	49	40084
40	Segovia	086	Fuentepelayo	953	479	474	40086
40	Segovia	087	Fuentepiñel	181	91	90	40087
40	Segovia	088	Fuenterrebollo	447	223	224	40088
40	Segovia	089	Fuentesaúco de Fuentidueña	325	172	153	40089
40	Segovia	091	Fuentesoto	172	92	80	40091
40	Segovia	092	Fuentidueña	181	93	88	40092
40	Segovia	093	Gallegos	110	55	55	40093
40	Segovia	094	Garcillán	359	191	168	40094
40	Segovia	095	Gomezserracín	662	344	318	40095
40	Segovia	097	Grajera	97	52	45	40097
40	Segovia	099	Honrubia de la Cuesta	74	33	41	40099
40	Segovia	100	Hontalbilla	429	223	206	40100
40	Segovia	101	Hontanares de Eresma	165	92	73	40101
40	Segovia	103	Huertos (Los)	166	79	87	40103
40	Segovia	104	Ituero y Lama	82	47	35	40104
40	Segovia	105	Juarros de Riomoros	76	43	33	40105
40	Segovia	106	Juarros de Voltoya	309	160	149	40106
40	Segovia	107	Labajos	157	88	69	40107
40	Segovia	108	Laguna de Contreras	176	95	81	40108
40	Segovia	109	Languilla	125	73	52	40109
40	Segovia	110	Lastras de Cuéllar	555	298	257	40110
40	Segovia	111	Lastras del Pozo	83	43	40	40111
40	Segovia	112	Lastrilla (La)	1716	845	871	40112
40	Segovia	113	Losa (La)	366	192	174	40113
40	Segovia	115	Maderuelo	163	82	81	40115
40	Segovia	118	Marazuela	82	43	39	40118
40	Segovia	119	Martín Miguel	201	101	100	40119
40	Segovia	120	Martín Muñoz de la Dehesa	188	101	87	40120
40	Segovia	121	Martín Muñoz de las Posadas	493	240	253	40121
40	Segovia	122	Marugán	319	166	153	40122
40	Segovia	123	Matabuena	216	113	103	40123
40	Segovia	124	Mata de Cuéllar	327	180	147	40124
40	Segovia	125	Matilla (La)	116	60	56	40125
40	Segovia	126	Melque de Cercos	119	56	63	40126
40	Segovia	127	Membibre de la Hoz	75	39	36	40127
40	Segovia	128	Migueláñez	179	85	94	40128
40	Segovia	129	Montejo de Arévalo	294	157	137	40129
40	Segovia	130	Montejo de la Vega de la Serrezuela	178	96	82	40130
40	Segovia	131	Monterrubio	66	34	32	40131
40	Segovia	132	Moral de Hornuez	105	60	45	40132
40	Segovia	134	Mozoncillo	1019	529	490	40134
40	Segovia	135	Muñopedro	387	196	191	40135
40	Segovia	136	Muñoveros	194	105	89	40136
40	Segovia	138	Nava de la Asunción	2621	1329	1292	40138
40	Segovia	139	Navafría	368	195	173	40139
40	Segovia	140	Navalilla	150	73	77	40140
40	Segovia	141	Navalmanzano	1127	582	545	40141
40	Segovia	142	Navares de Ayuso	86	43	43	40142
40	Segovia	143	Navares de Enmedio	155	84	71	40143
40	Segovia	144	Navares de las Cuevas	22	12	10	40144
40	Segovia	145	Navas de Oro	1460	738	722	40145
40	Segovia	146	Navas de San Antonio	285	147	138	40146
40	Segovia	148	Nieva	379	202	177	40148
40	Segovia	149	Olombrada	813	425	388	40149
40	Segovia	150	Orejana	115	64	51	40150
40	Segovia	151	Ortigosa de Pestaño	87	45	42	40151
40	Segovia	152	Otero de Herreros	862	418	444	40152
40	Segovia	154	Pajarejos	46	20	26	40154
40	Segovia	155	Palazuelos de Eresma	3123	1602	1521	40155
40	Segovia	156	Pedraza	467	248	219	40156
40	Segovia	157	Pelayos del Arroyo	45	23	22	40157
40	Segovia	158	Perosillo	32	20	12	40158
40	Segovia	159	Pinarejos	197	112	85	40159
40	Segovia	160	Pinarnegrillo	192	99	93	40160
40	Segovia	161	Pradales	73	38	35	40161
40	Segovia	162	Prádena	565	305	260	40162
40	Segovia	163	Puebla de Pedraza	90	46	44	40163
40	Segovia	164	Rapariegos	268	134	134	40164
40	Segovia	165	Rebollo	132	71	61	40165
40	Segovia	166	Remondo	368	172	196	40166
40	Segovia	168	Riaguas de San Bartolomé	95	50	45	40168
40	Segovia	170	Riaza	1680	903	777	40170
40	Segovia	171	Ribota	40	26	14	40171
40	Segovia	172	Riofrío de Riaza	50	26	24	40172
40	Segovia	173	Roda de Eresma	111	55	56	40173
40	Segovia	174	Sacramenia	560	288	272	40174
40	Segovia	176	Samboal	590	300	290	40176
40	Segovia	177	San Cristóbal de Cuéllar	222	110	112	40177
40	Segovia	178	San Cristóbal de la Vega	161	77	84	40178
40	Segovia	179	Sanchonuño	738	360	378	40179
40	Segovia	180	Sangarcía	471	240	231	40180
40	Segovia	181	San Ildefonso	5144	2508	2636	40181
40	Segovia	182	San Martín y Mudrián	284	143	141	40182
40	Segovia	183	San Miguel de Bernuy	175	88	87	40183
40	Segovia	184	San Pedro de Gaíllos	344	171	173	40184
40	Segovia	185	Santa María la Real de Nieva	1439	735	704	40185
40	Segovia	186	Santa Marta del Cerro	51	28	23	40186
40	Segovia	188	Santiuste de Pedraza	102	55	47	40188
40	Segovia	189	Santiuste de San Juan Bautista	775	399	376	40189
40	Segovia	190	Santo Domingo de Pirón	65	32	33	40190
40	Segovia	191	Santo Tomé del Puerto	328	173	155	40191
40	Segovia	192	Sauquillo de Cabezas	245	137	108	40192
40	Segovia	193	Sebúlcor	279	150	129	40193
40	Segovia	194	Segovia	54034	25963	28071	40194
40	Segovia	195	Sepúlveda	1318	674	644	40195
40	Segovia	196	Sequera de Fresno	51	27	24	40196
40	Segovia	198	Sotillo	42	19	23	40198
40	Segovia	199	Sotosalbos	124	69	55	40199
40	Segovia	200	Tabanera la Luenga	67	34	33	40200
40	Segovia	201	Tolocirio	62	27	35	40201
40	Segovia	202	Torreadrada	135	66	69	40202
40	Segovia	203	Torrecaballeros	518	265	253	40203
40	Segovia	204	Torrecilla del Pinar	318	155	163	40204
40	Segovia	205	Torreiglesias	397	205	192	40205
40	Segovia	206	Torre Val de San Pedro	191	106	85	40206
40	Segovia	207	Trescasas	328	169	159	40207
40	Segovia	208	Turégano	1078	541	537	40208
40	Segovia	210	Urueñas	122	67	55	40210
40	Segovia	211	Valdeprados	63	30	33	40211
40	Segovia	212	Valdevacas de Montejo	33	19	14	40212
40	Segovia	213	Valdevacas y Guijar	147	77	70	40213
40	Segovia	214	Valseca	294	151	143	40214
40	Segovia	215	Valtiendas	194	110	84	40215
40	Segovia	216	Valverde del Majano	501	257	244	40216
40	Segovia	218	Valle de Tabladillo	161	81	80	40218
40	Segovia	219	Vallelado	839	426	413	40219
40	Segovia	220	Valleruela de Pedraza	75	42	33	40220
40	Segovia	221	Valleruela de Sepúlveda	75	36	39	40221
40	Segovia	222	Veganzones	286	143	143	40222
40	Segovia	223	Vegas de Matute	242	138	104	40223
40	Segovia	224	Ventosilla y Tejadilla	28	19	9	40224
40	Segovia	225	Villacastín	1506	765	741	40225
40	Segovia	228	Villaverde de Íscar	722	369	353	40228
40	Segovia	229	Villaverde de Montejo	67	35	32	40229
40	Segovia	230	Villeguillo	176	94	82	40230
40	Segovia	231	Yanguas de Eresma	190	92	98	40231
40	Segovia	233	Zarzuela del Monte	531	267	264	40233
40	Segovia	234	Zarzuela del Pinar	602	316	286	40234
40	Segovia	901	Ortigosa del Monte	335	169	166	40901
40	Segovia	902	Cozuelos de Fuentidueña	193	99	94	40902
40	Segovia	903	Marazoleja	151	86	65	40903
40	Segovia	904	Navas de Riofrío	282	136	146	40904
40	Segovia	905	Cuevas de Provanco	211	109	102	40905
41	Sevilla	001	Aguadulce	1958	980	978	41001
41	Sevilla	002	Alanís	2014	1003	1011	41002
41	Sevilla	003	Albaida del Aljarafe	1820	918	902	41003
41	Sevilla	004	Alcalá de Guadaira	57206	28348	28858	41004
41	Sevilla	005	Alcalá del Río	9301	4715	4586	41005
41	Sevilla	006	Alcolea del Río	3392	1665	1727	41006
41	Sevilla	007	Algaba (La)	12916	6497	6419	41007
41	Sevilla	008	Algámitas	1373	714	659	41008
41	Sevilla	009	Almadén de la Plata	1764	899	865	41009
41	Sevilla	010	Almensilla	3110	1580	1530	41010
41	Sevilla	011	Arahal	18501	9151	9350	41011
41	Sevilla	012	Aznalcázar	3518	1774	1744	41012
41	Sevilla	013	Aznalcóllar	5820	2966	2854	41013
41	Sevilla	014	Badolatosa	3171	1642	1529	41014
41	Sevilla	015	Benacazón	5021	2542	2479	41015
41	Sevilla	016	Bollullos de la Mitación	5009	2534	2475	41016
41	Sevilla	017	Bormujos	9462	4689	4773	41017
41	Sevilla	018	Brenes	10666	5327	5339	41018
41	Sevilla	019	Burguillos	3514	1766	1748	41019
41	Sevilla	020	Cabezas de San Juan (Las)	15676	8059	7617	41020
41	Sevilla	021	Camas	25333	12396	12937	41021
41	Sevilla	022	Campana (La)	5169	2593	2576	41022
41	Sevilla	023	Cantillana	8947	4499	4448	41023
41	Sevilla	024	Carmona	25723	12959	12764	41024
41	Sevilla	025	Carrión de los Céspedes	2331	1117	1214	41025
41	Sevilla	026	Casariche	5200	2623	2577	41026
41	Sevilla	027	Castilblanco de los Arroyos	4458	2221	2237	41027
41	Sevilla	028	Castilleja de Guzmán	1447	750	697	41028
41	Sevilla	029	Castilleja de la Cuesta	16059	7894	8165	41029
41	Sevilla	030	Castilleja del Campo	617	307	310	41030
41	Sevilla	031	Castillo de las Guardas (El)	1609	817	792	41031
41	Sevilla	032	Cazalla de la Sierra	5177	2580	2597	41032
41	Sevilla	033	Constantina	7145	3505	3640	41033
41	Sevilla	034	Coria del Río	23935	11981	11954	41034
41	Sevilla	035	Coripe	1541	790	751	41035
41	Sevilla	036	Coronil (El)	5132	2593	2539	41036
41	Sevilla	037	Corrales (Los)	4141	2112	2029	41037
41	Sevilla	038	Dos Hermanas	97324	48254	49070	41038
41	Sevilla	039	Écija	37652	18549	19103	41039
41	Sevilla	040	Espartinas	5092	2601	2491	41040
41	Sevilla	041	Estepa	11721	5777	5944	41041
41	Sevilla	042	Fuentes de Andalucía	7461	3688	3773	41042
41	Sevilla	043	Garrobo (El)	772	386	386	41043
41	Sevilla	044	Gelves	6009	2955	3054	41044
41	Sevilla	045	Gerena	5509	2752	2757	41045
41	Sevilla	046	Gilena	3835	1946	1889	41046
41	Sevilla	047	Gines	9895	4877	5018	41047
41	Sevilla	048	Guadalcanal	2970	1474	1496	41048
41	Sevilla	049	Guillena	8406	4243	4163	41049
41	Sevilla	050	Herrera	6046	2973	3073	41050
41	Sevilla	051	Huévar del Aljarafe	2271	1175	1096	41051
41	Sevilla	052	Lantejuela (La)	3609	1847	1762	41052
41	Sevilla	053	Lebrija	24172	12191	11981	41053
41	Sevilla	054	Lora de Estepa	781	391	390	41054
41	Sevilla	055	Lora del Río	18848	9306	9542	41055
41	Sevilla	056	Luisiana (La)	4344	2215	2129	41056
41	Sevilla	057	Madroño (El)	364	183	181	41057
41	Sevilla	058	Mairena del Alcor	16649	8290	8359	41058
41	Sevilla	059	Mairena del Aljarafe	33914	17022	16892	41059
41	Sevilla	060	Marchena	18086	8903	9183	41060
41	Sevilla	061	Marinaleda	2634	1303	1331	41061
41	Sevilla	062	Martín de la Jara	2747	1440	1307	41062
41	Sevilla	063	Molares (Los)	2674	1344	1330	41063
41	Sevilla	064	Montellano	6829	3451	3378	41064
41	Sevilla	065	Morón de la Frontera	28000	13884	14116	41065
41	Sevilla	066	Navas de la Concepción (Las)	1888	945	943	41066
41	Sevilla	067	Olivares	7793	3918	3875	41067
41	Sevilla	068	Osuna	17290	8540	8750	41068
41	Sevilla	069	Palacios y Villafranca (Los)	32762	16561	16201	41069
41	Sevilla	070	Palomares del Río	3759	1919	1840	41070
41	Sevilla	071	Paradas	7028	3528	3500	41071
41	Sevilla	072	Pedrera	5008	2501	2507	41072
41	Sevilla	073	Pedroso (El)	2380	1178	1202	41073
41	Sevilla	074	Peñaflor	3832	1941	1891	41074
41	Sevilla	075	Pilas	11289	5567	5722	41075
41	Sevilla	076	Pruna	3264	1659	1605	41076
41	Sevilla	077	Puebla de Cazalla (La)	10691	5356	5335	41077
41	Sevilla	078	Puebla de los Infantes (La)	3462	1739	1723	41078
41	Sevilla	079	Puebla del Río (La)	10688	5329	5359	41079
41	Sevilla	080	Real de la Jara (El)	1706	823	883	41080
41	Sevilla	081	Rinconada (La)	28487	14391	14096	41081
41	Sevilla	082	Roda de Andalucía (La)	4193	2073	2120	41082
41	Sevilla	083	Ronquillo (El)	1421	712	709	41083
41	Sevilla	084	Rubio (El)	3719	1858	1861	41084
41	Sevilla	085	Salteras	3064	1529	1535	41085
41	Sevilla	086	San Juan de Aznalfarache	20187	9767	10420	41086
41	Sevilla	087	Sanlúcar la Mayor	10951	5441	5510	41087
41	Sevilla	088	San Nicolás del Puerto	716	368	348	41088
41	Sevilla	089	Santiponce	7000	3509	3491	41089
41	Sevilla	090	Saucejo (El)	4266	2115	2151	41090
41	Sevilla	091	Sevilla	700716	334445	366271	41091
41	Sevilla	092	Tocina	8851	4380	4471	41092
41	Sevilla	093	Tomares	17842	8820	9022	41093
41	Sevilla	094	Umbrete	4901	2460	2441	41094
41	Sevilla	095	Utrera	46084	23070	23014	41095
41	Sevilla	096	Valencina de la Concepción	6750	3379	3371	41096
41	Sevilla	097	Villamanrique de la Condesa	3805	1864	1941	41097
41	Sevilla	098	Villanueva del Ariscal	4750	2303	2447	41098
41	Sevilla	099	Villanueva del Río y Minas	5467	2631	2836	41099
41	Sevilla	100	Villanueva de San Juan	1527	759	768	41100
41	Sevilla	101	Villaverde del Río	6632	3367	3265	41101
41	Sevilla	102	Viso del Alcor (El)	16170	8178	7992	41102
41	Sevilla	901	Cañada Rosal	2988	1478	1510	41901
41	Sevilla	902	Villafranco del Guadalquivir	6057	3035	3022	41902
41	Sevilla	903	Cuervo de Sevilla (El)	7743	3912	3831	41903
42	Soria	001	Abejar	359	189	170	42001
42	Soria	003	Adradas	98	53	45	42003
42	Soria	004	Ágreda	3260	1607	1653	42004
42	Soria	006	Alconaba	179	100	79	42006
42	Soria	007	Alcubilla de Avellaneda	228	113	115	42007
42	Soria	008	Alcubilla de las Peñas	103	52	51	42008
42	Soria	009	Aldealafuente	153	76	77	42009
42	Soria	010	Aldealices	33	16	17	42010
42	Soria	011	Aldealpozo	31	14	17	42011
42	Soria	012	Aldealseñor	51	31	20	42012
42	Soria	013	Aldehuela de Periáñez	43	22	21	42013
42	Soria	014	Aldehuelas (Las)	120	67	53	42014
42	Soria	015	Alentisque	43	19	24	42015
42	Soria	016	Aliud	38	19	19	42016
42	Soria	017	Almajano	177	88	89	42017
42	Soria	018	Almaluez	303	160	143	42018
42	Soria	019	Almarza	615	337	278	42019
42	Soria	020	Almazán	5795	2881	2914	42020
42	Soria	021	Almazul	167	86	81	42021
42	Soria	022	Almenar de Soria	387	207	180	42022
42	Soria	023	Alpanseque	105	53	52	42023
42	Soria	024	Arancón	118	65	53	42024
42	Soria	025	Arcos de Jalón	1856	941	915	42025
42	Soria	026	Arenillas	44	25	19	42026
42	Soria	027	Arévalo de la Sierra	102	56	46	42027
42	Soria	028	Ausejo de la Sierra	61	30	31	42028
42	Soria	029	Baraona	232	126	106	42029
42	Soria	030	Barca	139	79	60	42030
42	Soria	031	Barcones	46	25	21	42031
42	Soria	032	Bayubas de Abajo	278	147	131	42032
42	Soria	033	Bayubas de Arriba	81	40	41	42033
42	Soria	034	Beratón	34	27	7	42034
42	Soria	035	Berlanga de Duero	1148	583	565	42035
42	Soria	036	Blacos	61	38	23	42036
42	Soria	037	Bliecos	57	32	25	42037
42	Soria	038	Borjabad	61	34	27	42038
42	Soria	039	Borobia	381	185	196	42039
42	Soria	041	Buberos	49	24	25	42041
42	Soria	042	Buitrago	55	25	30	42042
42	Soria	043	Burgo de Osma-Ciudad de Osma	4966	2440	2526	42043
42	Soria	044	Cabrejas del Campo	87	49	38	42044
42	Soria	045	Cabrejas del Pinar	466	251	215	42045
42	Soria	046	Calatañazor	75	43	32	42046
42	Soria	048	Caltojar	124	65	59	42048
42	Soria	049	Candilichera	235	117	118	42049
42	Soria	050	Cañamaque	45	26	19	42050
42	Soria	051	Carabantes	37	17	20	42051
42	Soria	052	Caracena	23	16	7	42052
42	Soria	053	Carrascosa de Abajo	39	20	19	42053
42	Soria	054	Carrascosa de la Sierra	14	7	7	42054
42	Soria	055	Casarejos	258	133	125	42055
42	Soria	056	Castilfrío de la Sierra	29	18	11	42056
42	Soria	057	Castilruiz	323	162	161	42057
42	Soria	058	Castillejo de Robledo	193	101	92	42058
42	Soria	059	Centenera de Andaluz	29	10	19	42059
42	Soria	060	Cerbón	50	28	22	42060
42	Soria	061	Cidones	341	190	151	42061
42	Soria	062	Cigudosa	76	45	31	42062
42	Soria	063	Cihuela	105	50	55	42063
42	Soria	064	Ciria	112	52	60	42064
42	Soria	065	Cirujales del Río	41	22	19	42065
42	Soria	068	Coscurita	141	82	59	42068
42	Soria	069	Covaleda	2043	1034	1009	42069
42	Soria	070	Cubilla	73	40	33	42070
42	Soria	071	Cubo de la Solana	250	137	113	42071
42	Soria	073	Cueva de Ágreda	101	51	50	42073
42	Soria	075	Dévanos	133	71	62	42075
42	Soria	076	Deza	388	195	193	42076
42	Soria	078	Duruelo de la Sierra	1452	724	728	42078
42	Soria	079	Escobosa de Almazán	41	24	17	42079
42	Soria	080	Espeja de San Marcelino	259	142	117	42080
42	Soria	081	Espejón	225	111	114	42081
42	Soria	082	Estepa de San Juan	15	8	7	42082
42	Soria	083	Frechilla de Almazán	49	25	24	42083
42	Soria	084	Fresno de Caracena	55	31	24	42084
42	Soria	085	Fuentearmegil	343	184	159	42085
42	Soria	086	Fuentecambrón	76	40	36	42086
42	Soria	087	Fuentecantos	53	27	26	42087
42	Soria	088	Fuentelmonge	139	69	70	42088
42	Soria	089	Fuentelsaz de Soria	60	21	39	42089
42	Soria	090	Fuentepinilla	154	87	67	42090
42	Soria	092	Fuentes de Magaña	99	47	52	42092
42	Soria	093	Fuentestrún	77	45	32	42093
42	Soria	094	Garray	431	231	200	42094
42	Soria	095	Golmayo	765	437	328	42095
42	Soria	096	Gómara	477	246	231	42096
42	Soria	097	Gormaz	17	7	10	42097
42	Soria	098	Herrera de Soria	23	16	7	42098
42	Soria	100	Hinojosa del Campo	48	30	18	42100
42	Soria	103	Langa de Duero	932	505	427	42103
42	Soria	105	Liceras	62	33	29	42105
42	Soria	106	Losilla (La)	20	12	8	42106
42	Soria	107	Magaña	103	52	51	42107
42	Soria	108	Maján	18	10	8	42108
42	Soria	110	Matalebreras	121	63	58	42110
42	Soria	111	Matamala de Almazán	403	206	197	42111
42	Soria	113	Medinaceli	701	354	347	42113
42	Soria	115	Miño de Medinaceli	114	54	60	42115
42	Soria	116	Miño de San Esteban	94	54	40	42116
42	Soria	117	Molinos de Duero	192	103	89	42117
42	Soria	118	Momblona	40	23	17	42118
42	Soria	119	Monteagudo de las Vicarías	304	150	154	42119
42	Soria	120	Montejo de Tiermes	251	140	111	42120
42	Soria	121	Montenegro de Cameros	113	62	51	42121
42	Soria	123	Morón de Almazán	281	132	149	42123
42	Soria	124	Muriel de la Fuente	84	48	36	42124
42	Soria	125	Muriel Viejo	79	36	43	42125
42	Soria	127	Nafría de Ucero	86	43	43	42127
42	Soria	128	Narros	52	27	25	42128
42	Soria	129	Navaleno	959	484	475	42129
42	Soria	130	Nepas	87	51	36	42130
42	Soria	131	Nolay	95	49	46	42131
42	Soria	132	Noviercas	242	117	125	42132
42	Soria	134	Ólvega	3298	1712	1586	42134
42	Soria	135	Oncala	106	59	47	42135
42	Soria	139	Pinilla del Campo	24	13	11	42139
42	Soria	140	Portillo de Soria	21	12	9	42140
42	Soria	141	Póveda de Soria (La)	121	63	58	42141
42	Soria	142	Pozalmuro	108	52	56	42142
42	Soria	144	Quintana Redonda	568	298	270	42144
42	Soria	145	Quintanas de Gormaz	199	104	95	42145
42	Soria	148	Quiñonería	15	5	10	42148
42	Soria	149	Rábanos (Los)	414	237	177	42149
42	Soria	151	Rebollar	52	29	23	42151
42	Soria	152	Recuerda	115	58	57	42152
42	Soria	153	Rello	42	19	23	42153
42	Soria	154	Renieblas	122	65	57	42154
42	Soria	155	Retortillo de Soria	241	132	109	42155
42	Soria	156	Reznos	42	26	16	42156
42	Soria	157	Riba de Escalote (La)	29	17	12	42157
42	Soria	158	Rioseco de Soria	145	72	73	42158
42	Soria	159	Rollamienta	45	26	19	42159
42	Soria	160	Royo (El)	335	166	169	42160
42	Soria	161	Salduero	193	105	88	42161
42	Soria	162	San Esteban de Gormaz	3348	1702	1646	42162
42	Soria	163	San Felices	85	43	42	42163
42	Soria	164	San Leonardo de Yagüe	2070	1057	1013	42164
42	Soria	165	San Pedro Manrique	487	261	226	42165
42	Soria	166	Santa Cruz de Yanguas	61	36	25	42166
42	Soria	167	Santa María de Huerta	449	235	214	42167
42	Soria	168	Santa María de las Hoyas	206	111	95	42168
42	Soria	171	Serón de Nágima	260	135	125	42171
42	Soria	172	Soliedra	40	25	15	42172
42	Soria	173	Soria	34088	16203	17885	42173
42	Soria	174	Sotillo del Rincón	230	117	113	42174
42	Soria	175	Suellacabras	38	21	17	42175
42	Soria	176	Tajahuerce	47	22	25	42176
42	Soria	177	Tajueco	122	64	58	42177
42	Soria	178	Talveila	199	104	95	42178
42	Soria	181	Tardelcuende	636	319	317	42181
42	Soria	182	Taroda	81	41	40	42182
42	Soria	183	Tejado	219	111	108	42183
42	Soria	184	Torlengua	110	54	56	42184
42	Soria	185	Torreblacos	37	19	18	42185
42	Soria	187	Torrubia de Soria	95	53	42	42187
42	Soria	188	Trévago	76	31	45	42188
42	Soria	189	Ucero	111	58	53	42189
42	Soria	190	Vadillo	147	78	69	42190
42	Soria	191	Valdeavellano de Tera	256	127	129	42191
42	Soria	192	Valdegeña	48	28	20	42192
42	Soria	193	Valdelagua del Cerro	27	15	12	42193
42	Soria	194	Valdemaluque	305	152	153	42194
42	Soria	195	Valdenebro	144	75	69	42195
42	Soria	196	Valdeprado	19	9	10	42196
42	Soria	197	Valderrodilla	123	62	61	42197
42	Soria	198	Valtajeros	30	16	14	42198
42	Soria	200	Velamazán	147	82	65	42200
42	Soria	201	Velilla de la Sierra	22	10	12	42201
42	Soria	202	Velilla de los Ajos	45	27	18	42202
42	Soria	204	Viana de Duero	77	47	30	42204
42	Soria	205	Villaciervos	99	60	39	42205
42	Soria	206	Villanueva de Gormaz	19	12	7	42206
42	Soria	207	Villar del Ala	57	26	31	42207
42	Soria	208	Villar del Campo	36	19	17	42208
42	Soria	209	Villar del Río	180	95	85	42209
42	Soria	211	Villares de Soria (Los)	114	56	58	42211
42	Soria	212	Villasayas	99	60	39	42212
42	Soria	213	Villaseca de Arciel	44	25	19	42213
42	Soria	215	Vinuesa	1070	564	506	42215
42	Soria	216	Vizmanos	41	27	14	42216
42	Soria	217	Vozmediano	54	30	24	42217
42	Soria	218	Yanguas	136	67	69	42218
42	Soria	219	Yelo	63	33	30	42219
43	Tarragona	001	Aiguamúrcia	652	339	313	43001
43	Tarragona	002	Albinyana	1380	718	662	43002
43	Tarragona	003	Albiol (L')	175	96	79	43003
43	Tarragona	004	Alcanar	7878	3917	3961	43004
43	Tarragona	005	Alcover	3787	1927	1860	43005
43	Tarragona	006	Aldover	792	377	415	43006
43	Tarragona	007	Aleixar (L')	717	367	350	43007
43	Tarragona	008	Alfara de Carles	365	194	171	43008
43	Tarragona	009	Alforja	1269	648	621	43009
43	Tarragona	010	Alió	372	185	187	43010
43	Tarragona	011	Almoster	823	423	400	43011
43	Tarragona	012	Altafulla	3111	1589	1522	43012
43	Tarragona	013	Ametlla de Mar (L')	4946	2482	2464	43013
43	Tarragona	014	Amposta	16372	8073	8299	43014
43	Tarragona	015	Arbolí	139	70	69	43015
43	Tarragona	016	Arboç (L')	3551	1841	1710	43016
43	Tarragona	017	Argentera (L')	148	85	63	43017
43	Tarragona	018	Arnes	517	268	249	43018
43	Tarragona	019	Ascó	1707	864	843	43019
43	Tarragona	020	Banyeres del Penedès	1694	885	809	43020
43	Tarragona	021	Barberà de la Conca	409	202	207	43021
43	Tarragona	022	Batea	1964	987	977	43022
43	Tarragona	023	Bellmunt del Priorat	310	151	159	43023
43	Tarragona	024	Bellvei	1368	722	646	43024
43	Tarragona	025	Benifallet	883	441	442	43025
43	Tarragona	026	Benissanet	1022	523	499	43026
43	Tarragona	027	Bisbal de Falset (La)	242	120	122	43027
43	Tarragona	028	Bisbal del Penedès (La)	1943	1023	920	43028
43	Tarragona	029	Blancafort	379	196	183	43029
43	Tarragona	030	Bonastre	319	166	153	43030
43	Tarragona	031	Borges del Camp (Les)	1577	797	780	43031
43	Tarragona	032	Bot	830	419	411	43032
43	Tarragona	033	Botarell	624	318	306	43033
43	Tarragona	034	Bràfim	573	279	294	43034
43	Tarragona	035	Cabacés	339	178	161	43035
43	Tarragona	036	Cabra del Camp	601	315	286	43036
43	Tarragona	037	Calafell	12219	6160	6059	43037
43	Tarragona	038	Cambrils	19942	9911	10031	43038
43	Tarragona	039	Capafonts	124	65	59	43039
43	Tarragona	040	Capçanes	401	184	217	43040
43	Tarragona	041	Caseres	325	161	164	43041
43	Tarragona	042	Castellvell del Camp	1062	543	519	43042
43	Tarragona	043	Catllar (El)	2363	1243	1120	43043
43	Tarragona	044	Sénia (La)	5034	2562	2472	43044
43	Tarragona	045	Colldejou	198	108	90	43045
43	Tarragona	046	Conesa	116	63	53	43046
43	Tarragona	047	Constantí	5021	2599	2422	43047
43	Tarragona	048	Corbera d'Ebre	1056	543	513	43048
43	Tarragona	049	Cornudella de Montsant	840	427	413	43049
43	Tarragona	050	Creixell	1837	922	915	43050
43	Tarragona	051	Cunit	5943	3059	2884	43051
43	Tarragona	052	Xerta	1225	608	617	43052
43	Tarragona	053	Duesaigües	199	120	79	43053
43	Tarragona	054	Espluga de Francolí (L')	3654	1802	1852	43054
43	Tarragona	055	Falset	2448	1234	1214	43055
43	Tarragona	056	Fatarella (La)	1244	620	624	43056
43	Tarragona	057	Febró (La)	63	39	24	43057
43	Tarragona	058	Figuera (La)	121	61	60	43058
43	Tarragona	059	Figuerola del Camp	280	134	146	43059
43	Tarragona	060	Flix	4208	2099	2109	43060
43	Tarragona	061	Forès	68	33	35	43061
43	Tarragona	062	Freginals	362	180	182	43062
43	Tarragona	063	Galera (La)	746	367	379	43063
43	Tarragona	064	Gandesa	2564	1284	1280	43064
43	Tarragona	065	Garcia	512	262	250	43065
43	Tarragona	066	Garidells (Els)	162	80	82	43066
43	Tarragona	067	Ginestar	837	423	414	43067
43	Tarragona	068	Godall	721	366	355	43068
43	Tarragona	069	Gratallops	232	123	109	43069
43	Tarragona	070	Guiamets (Els)	304	152	152	43070
43	Tarragona	071	Horta de Sant Joan	1233	653	580	43071
43	Tarragona	072	Lloar (El)	123	61	62	43072
43	Tarragona	073	Llorac	120	58	62	43073
43	Tarragona	074	Llorenç del Penedès	1575	755	820	43074
43	Tarragona	075	Margalef	129	66	63	43075
43	Tarragona	076	Marçà	600	295	305	43076
43	Tarragona	077	Mas de Barberans	699	360	339	43077
43	Tarragona	078	Masdenverge	956	488	468	43078
43	Tarragona	079	Masllorenç	409	206	203	43079
43	Tarragona	080	Masó (La)	275	134	141	43080
43	Tarragona	081	Maspujols	464	243	221	43081
43	Tarragona	082	Masroig (El)	506	246	260	43082
43	Tarragona	083	Milà (El)	162	79	83	43083
43	Tarragona	084	Miravet	788	415	373	43084
43	Tarragona	085	Molar (El)	289	152	137	43085
43	Tarragona	086	Montblanc	6029	2984	3045	43086
43	Tarragona	088	Montbrió del Camp	1459	732	727	43088
43	Tarragona	089	Montferri	157	80	77	43089
43	Tarragona	090	Montmell (El)	408	226	182	43090
43	Tarragona	091	Mont-ral	160	89	71	43091
43	Tarragona	092	Mont-roig del Camp	6683	3402	3281	43092
43	Tarragona	093	Móra d'Ebre	4816	2376	2440	43093
43	Tarragona	094	Móra la Nova	2661	1324	1337	43094
43	Tarragona	095	Morell (El)	2308	1168	1140	43095
43	Tarragona	096	Morera de Montsant (La)	176	101	75	43096
43	Tarragona	097	Nou de Gaià (La)	376	189	187	43097
43	Tarragona	098	Nulles	347	160	187	43098
43	Tarragona	099	Palma d'Ebre (La)	419	200	219	43099
43	Tarragona	100	Pallaresos (Els)	2537	1308	1229	43100
43	Tarragona	101	Passanant	183	109	74	43101
43	Tarragona	102	Paüls	640	324	316	43102
43	Tarragona	103	Perafort	610	312	298	43103
43	Tarragona	104	Perelló (El)	2145	1101	1044	43104
43	Tarragona	105	Piles (Les)	178	98	80	43105
43	Tarragona	106	Pinell de Brai (El)	1074	546	528	43106
43	Tarragona	107	Pira	402	197	205	43107
43	Tarragona	108	Pla de Santa Maria (El)	1651	849	802	43108
43	Tarragona	109	Pobla de Mafumet (La)	1115	558	557	43109
43	Tarragona	110	Pobla de Massaluca (La)	442	227	215	43110
43	Tarragona	111	Pobla de Montornès (La)	1336	721	615	43111
43	Tarragona	112	Poboleda	335	169	166	43112
43	Tarragona	113	Pont d'Armentera (El)	576	297	279	43113
43	Tarragona	114	Porrera	472	254	218	43114
43	Tarragona	115	Pradell de la Teixeta	198	101	97	43115
43	Tarragona	116	Prades	528	267	261	43116
43	Tarragona	117	Prat de Comte	178	85	93	43117
43	Tarragona	118	Pratdip	563	282	281	43118
43	Tarragona	119	Puigpelat	597	300	297	43119
43	Tarragona	120	Querol	305	170	135	43120
43	Tarragona	121	Rasquera	792	402	390	43121
43	Tarragona	122	Renau	61	29	32	43122
43	Tarragona	123	Reus	89179	43499	45680	43123
43	Tarragona	124	Riba (La)	732	380	352	43124
43	Tarragona	125	Riba-roja d'Ebre	1350	696	654	43125
43	Tarragona	126	Riera de Gaià (La)	970	486	484	43126
43	Tarragona	127	Riudecanyes	694	349	345	43127
43	Tarragona	128	Riudecols	997	511	486	43128
43	Tarragona	129	Riudoms	5201	2613	2588	43129
43	Tarragona	130	Rocafort de Queralt	279	148	131	43130
43	Tarragona	131	Roda de Barà	3361	1829	1532	43131
43	Tarragona	132	Rodonyà	420	218	202	43132
43	Tarragona	133	Roquetes	6366	3203	3163	43133
43	Tarragona	134	Rourell (El)	262	139	123	43134
43	Tarragona	135	Salomó	382	194	188	43135
43	Tarragona	136	Sant Carles de la Ràpita	11194	5552	5642	43136
43	Tarragona	137	Sant Jaume dels Domenys	1390	724	666	43137
43	Tarragona	138	Santa Bàrbara	3257	1628	1629	43138
43	Tarragona	139	Santa Coloma de Queralt	2615	1263	1352	43139
43	Tarragona	140	Santa Oliva	2101	1066	1035	43140
43	Tarragona	141	Pontils	148	75	73	43141
43	Tarragona	142	Sarral	1430	745	685	43142
43	Tarragona	143	Savallà del Comtat	75	36	39	43143
43	Tarragona	144	Secuita (La)	1131	572	559	43144
43	Tarragona	145	Selva del Camp (La)	4103	2064	2039	43145
43	Tarragona	146	Senan	31	20	11	43146
43	Tarragona	147	Solivella	622	304	318	43147
43	Tarragona	148	Tarragona	114097	55698	58399	43148
43	Tarragona	149	Tivenys	917	458	459	43149
43	Tarragona	150	Tivissa	1764	876	888	43150
43	Tarragona	151	Torre de Fontaubella (La)	128	63	65	43151
43	Tarragona	152	Torre de l'Espanyol (La)	674	349	325	43152
43	Tarragona	153	Torredembarra	10581	5254	5327	43153
43	Tarragona	154	Torroja del Priorat	139	80	59	43154
43	Tarragona	155	Tortosa	29481	14288	15193	43155
43	Tarragona	156	Ulldecona	5304	2627	2677	43156
43	Tarragona	157	Ulldemolins	495	259	236	43157
43	Tarragona	158	Vallclara	117	62	55	43158
43	Tarragona	159	Vallfogona de Riucorb	164	85	79	43159
43	Tarragona	160	Vallmoll	1168	609	559	43160
43	Tarragona	161	Valls	20382	9994	10388	43161
43	Tarragona	162	Vandellòs i l'Hospitalet de l'Infant	4343	2176	2167	43162
43	Tarragona	163	Vendrell (El)	22543	11310	11233	43163
43	Tarragona	164	Vespella de Gaià	205	116	89	43164
43	Tarragona	165	Vilabella	788	397	391	43165
43	Tarragona	166	Vilallonga del Camp	1237	614	623	43166
43	Tarragona	167	Vilanova d'Escornalbou	449	234	215	43167
43	Tarragona	168	Vilanova de Prades	157	80	77	43168
43	Tarragona	169	Vilaplana	526	264	262	43169
43	Tarragona	170	Vila-rodona	1034	562	472	43170
43	Tarragona	171	Vila-seca	13133	6612	6521	43171
43	Tarragona	172	Vilaverd	354	177	177	43172
43	Tarragona	173	Vilella Alta (La)	128	66	62	43173
43	Tarragona	174	Vilella Baixa (La)	174	94	80	43174
43	Tarragona	175	Vilalba dels Arcs	762	399	363	43175
43	Tarragona	176	Vimbodí	1011	539	472	43176
43	Tarragona	177	Vinebre	443	221	222	43177
43	Tarragona	178	Vinyols i els Arcs	1213	632	581	43178
43	Tarragona	901	Deltebre	10250	5132	5118	43901
43	Tarragona	902	Sant Jaume d'Enveja	3305	1668	1637	43902
43	Tarragona	903	Camarles	2887	1428	1459	43903
43	Tarragona	904	Aldea (L')	3546	1803	1743	43904
43	Tarragona	905	Salou	13059	6629	6430	43905
43	Tarragona	906	Ampolla (L')	1831	906	925	43906
44	Teruel	001	Ababuj	85	48	37	44001
44	Teruel	002	Abejuela	58	40	18	44002
44	Teruel	003	Aguatón	24	10	14	44003
44	Teruel	004	Aguaviva	592	290	302	44004
44	Teruel	005	Aguilar del Alfambra	83	40	43	44005
44	Teruel	006	Alacón	457	234	223	44006
44	Teruel	007	Alba	271	142	129	44007
44	Teruel	008	Albalate del Arzobispo	2283	1115	1168	44008
44	Teruel	009	Albarracín	1055	552	503	44009
44	Teruel	010	Albentosa	257	131	126	44010
44	Teruel	011	Alcaine	74	43	31	44011
44	Teruel	012	Alcalá de la Selva	478	259	219	44012
44	Teruel	013	Alcañiz	13127	6484	6643	44013
44	Teruel	014	Alcorisa	3245	1629	1616	44014
44	Teruel	016	Alfambra	645	330	315	44016
44	Teruel	017	Aliaga	393	208	185	44017
44	Teruel	018	Almohaja	29	18	11	44018
44	Teruel	019	Alobras	92	51	41	44019
44	Teruel	020	Alpeñés	28	18	10	44020
44	Teruel	021	Allepuz	143	75	68	44021
44	Teruel	022	Alloza	772	367	405	44022
44	Teruel	023	Allueva	16	11	5	44023
44	Teruel	024	Anadón	17	9	8	44024
44	Teruel	025	Andorra	8000	4122	3878	44025
44	Teruel	026	Arcos de las Salinas	144	68	76	44026
44	Teruel	027	Arens de Lledó	241	115	126	44027
44	Teruel	028	Argente	262	136	126	44028
44	Teruel	029	Ariño	866	423	443	44029
44	Teruel	031	Azaila	174	97	77	44031
44	Teruel	032	Bádenas	24	12	12	44032
44	Teruel	033	Báguena	500	251	249	44033
44	Teruel	034	Bañón	182	99	83	44034
44	Teruel	035	Barrachina	163	83	80	44035
44	Teruel	036	Bea	45	28	17	44036
44	Teruel	037	Beceite	638	319	319	44037
44	Teruel	038	Belmonte de San José	144	78	66	44038
44	Teruel	039	Bello	393	186	207	44039
44	Teruel	040	Berge	231	117	114	44040
44	Teruel	041	Bezas	70	37	33	44041
44	Teruel	042	Blancas	183	100	83	44042
44	Teruel	043	Blesa	156	95	61	44043
44	Teruel	044	Bordón	148	74	74	44044
44	Teruel	045	Bronchales	457	245	212	44045
44	Teruel	046	Bueña	102	56	46	44046
44	Teruel	047	Burbáguena	326	147	179	44047
44	Teruel	048	Cabra de Mora	115	65	50	44048
44	Teruel	049	Calaceite	1193	616	577	44049
44	Teruel	050	Calamocha	4063	2025	2038	44050
44	Teruel	051	Calanda	3484	1766	1718	44051
44	Teruel	052	Calomarde	82	39	43	44052
44	Teruel	053	Camañas	137	79	58	44053
44	Teruel	054	Camarena de la Sierra	186	104	82	44054
44	Teruel	055	Camarillas	122	66	56	44055
44	Teruel	056	Caminreal	813	405	408	44056
44	Teruel	059	Cantavieja	734	386	348	44059
44	Teruel	060	Cañada de Benatanduz	63	40	23	44060
44	Teruel	061	Cañada de Verich (La)	106	58	48	44061
44	Teruel	062	Cañada Vellida	58	38	20	44062
44	Teruel	063	Cañizar del Olivar	125	64	61	44063
44	Teruel	064	Cascante del Río	121	75	46	44064
44	Teruel	065	Castejón de Tornos	103	50	53	44065
44	Teruel	066	Castel de Cabra	172	90	82	44066
44	Teruel	067	Castelnou	98	51	47	44067
44	Teruel	068	Castelserás	858	454	404	44068
44	Teruel	070	Castellar (El)	97	52	45	44070
44	Teruel	071	Castellote	737	382	355	44071
44	Teruel	074	Cedrillas	527	272	255	44074
44	Teruel	075	Celadas	424	229	195	44075
44	Teruel	076	Cella	2897	1496	1401	44076
44	Teruel	077	Cerollera (La)	111	62	49	44077
44	Teruel	080	Codoñera (La)	344	180	164	44080
44	Teruel	082	Corbalán	76	45	31	44082
44	Teruel	084	Cortes de Aragón	117	58	59	44084
44	Teruel	085	Cosa	104	56	48	44085
44	Teruel	086	Cretas	603	309	294	44086
44	Teruel	087	Crivillén	128	68	60	44087
44	Teruel	088	Cuba (La)	60	29	31	44088
44	Teruel	089	Cubla	50	26	24	44089
44	Teruel	090	Cucalón	76	42	34	44090
44	Teruel	092	Cuervo (El)	123	62	61	44092
44	Teruel	093	Cuevas de Almudén	103	56	47	44093
44	Teruel	094	Cuevas Labradas	162	88	74	44094
44	Teruel	096	Ejulve	229	116	113	44096
44	Teruel	097	Escorihuela	234	115	119	44097
44	Teruel	099	Escucha	1103	583	520	44099
44	Teruel	100	Estercuel	348	182	166	44100
44	Teruel	101	Ferreruela de Huerva	87	47	40	44101
44	Teruel	102	Fonfría	32	18	14	44102
44	Teruel	103	Formiche Alto	199	104	95	44103
44	Teruel	105	Fórnoles	104	49	55	44105
44	Teruel	106	Fortanete	194	105	89	44106
44	Teruel	107	Foz-Calanda	241	131	110	44107
44	Teruel	108	Fresneda (La)	416	217	199	44108
44	Teruel	109	Frías de Albarracín	157	84	73	44109
44	Teruel	110	Fuenferrada	47	26	21	44110
44	Teruel	111	Fuentes Calientes	129	73	56	44111
44	Teruel	112	Fuentes Claras	650	321	329	44112
44	Teruel	113	Fuentes de Rubielos	88	49	39	44113
44	Teruel	114	Fuentespalda	357	179	178	44114
44	Teruel	115	Galve	145	78	67	44115
44	Teruel	116	Gargallo	121	66	55	44116
44	Teruel	117	Gea de Albarracín	453	233	220	44117
44	Teruel	118	Ginebrosa (La)	249	137	112	44118
44	Teruel	119	Griegos	138	81	57	44119
44	Teruel	120	Guadalaviar	287	146	141	44120
44	Teruel	121	Gúdar	74	44	30	44121
44	Teruel	122	Híjar	1901	964	937	44122
44	Teruel	123	Hinojosa de Jarque	177	91	86	44123
44	Teruel	124	Hoz de la Vieja (La)	123	62	61	44124
44	Teruel	125	Huesa del Común	135	78	57	44125
44	Teruel	126	Iglesuela del Cid (La)	499	261	238	44126
44	Teruel	127	Jabaloyas	89	46	43	44127
44	Teruel	128	Jarque de la Val	95	53	42	44128
44	Teruel	129	Jatiel	67	34	33	44129
44	Teruel	130	Jorcas	48	30	18	44130
44	Teruel	131	Josa	39	22	17	44131
44	Teruel	132	Lagueruela	69	36	33	44132
44	Teruel	133	Lanzuela	30	19	11	44133
44	Teruel	135	Libros	161	82	79	44135
44	Teruel	136	Lidón	79	36	43	44136
44	Teruel	137	Linares de Mora	294	164	130	44137
44	Teruel	138	Loscos	217	117	100	44138
44	Teruel	141	Lledó	201	110	91	44141
44	Teruel	142	Maicas	35	15	20	44142
44	Teruel	143	Manzanera	467	259	208	44143
44	Teruel	144	Martín del Río	495	251	244	44144
44	Teruel	145	Mas de las Matas	1488	754	734	44145
44	Teruel	146	Mata de los Olmos (La)	267	124	143	44146
44	Teruel	147	Mazaleón	601	308	293	44147
44	Teruel	148	Mezquita de Jarque	133	72	61	44148
44	Teruel	149	Mirambel	146	83	63	44149
44	Teruel	150	Miravete de la Sierra	49	30	19	44150
44	Teruel	151	Molinos	329	173	156	44151
44	Teruel	152	Monforte de Moyuela	61	35	26	44152
44	Teruel	153	Monreal del Campo	2311	1149	1162	44153
44	Teruel	154	Monroyo	362	193	169	44154
44	Teruel	155	Montalbán	1588	811	777	44155
44	Teruel	156	Monteagudo del Castillo	68	40	28	44156
44	Teruel	157	Monterde de Albarracín	67	36	31	44157
44	Teruel	158	Mora de Rubielos	1371	704	667	44158
44	Teruel	159	Moscardón	55	29	26	44159
44	Teruel	160	Mosqueruela	693	364	329	44160
44	Teruel	161	Muniesa	737	380	357	44161
44	Teruel	163	Noguera de Albarracín	176	91	85	44163
44	Teruel	164	Nogueras	20	15	5	44164
44	Teruel	165	Nogueruelas	223	118	105	44165
44	Teruel	167	Obón	52	26	26	44167
44	Teruel	168	Odón	271	126	145	44168
44	Teruel	169	Ojos Negros	563	295	268	44169
44	Teruel	171	Olba	195	97	98	44171
44	Teruel	172	Oliete	476	242	234	44172
44	Teruel	173	Olmos (Los)	142	73	69	44173
44	Teruel	174	Orihuela del Tremedal	628	310	318	44174
44	Teruel	175	Orrios	191	98	93	44175
44	Teruel	176	Palomar de Arroyos	255	141	114	44176
44	Teruel	177	Pancrudo	167	89	78	44177
44	Teruel	178	Parras de Castellote (Las)	76	41	35	44178
44	Teruel	179	Peñarroya de Tastavins	521	273	248	44179
44	Teruel	180	Peracense	108	58	50	44180
44	Teruel	181	Peralejos	93	48	45	44181
44	Teruel	182	Perales del Alfambra	295	155	140	44182
44	Teruel	183	Pitarque	109	50	59	44183
44	Teruel	184	Plou	47	24	23	44184
44	Teruel	185	Pobo (El)	146	81	65	44185
44	Teruel	187	Portellada (La)	312	163	149	44187
44	Teruel	189	Pozondón	83	43	40	44189
44	Teruel	190	Pozuel del Campo	115	63	52	44190
44	Teruel	191	Puebla de Híjar (La)	1089	542	547	44191
44	Teruel	192	Puebla de Valverde (La)	489	268	221	44192
44	Teruel	193	Puertomingalvo	140	75	65	44193
44	Teruel	194	Ráfales	201	101	100	44194
44	Teruel	195	Rillo	139	75	64	44195
44	Teruel	196	Riodeva	218	104	114	44196
44	Teruel	197	Ródenas	98	48	50	44197
44	Teruel	198	Royuela	238	136	102	44198
44	Teruel	199	Rubiales	58	32	26	44199
44	Teruel	200	Rubielos de la Cérida	62	30	32	44200
44	Teruel	201	Rubielos de Mora	616	310	306	44201
44	Teruel	203	Salcedillo	7	3	4	44203
44	Teruel	204	Saldón	42	24	18	44204
44	Teruel	205	Samper de Calanda	988	472	516	44205
44	Teruel	206	San Agustín	138	69	69	44206
44	Teruel	207	San Martín del Río	288	138	150	44207
44	Teruel	208	Santa Cruz de Nogueras	26	15	11	44208
44	Teruel	209	Santa Eulalia	1230	601	629	44209
44	Teruel	210	Sarrión	1015	529	486	44210
44	Teruel	211	Segura de los Baños	50	25	25	44211
44	Teruel	212	Seno	49	25	24	44212
44	Teruel	213	Singra	93	45	48	44213
44	Teruel	215	Terriente	184	104	80	44215
44	Teruel	216	Teruel	30491	14733	15758	44216
44	Teruel	217	Toril y Masegoso	32	19	13	44217
44	Teruel	218	Tormón	39	20	19	44218
44	Teruel	219	Tornos	249	134	115	44219
44	Teruel	220	Torralba de los Sisones	224	114	110	44220
44	Teruel	221	Torrecilla de Alcañiz	427	225	202	44221
44	Teruel	222	Torrecilla del Rebollar	186	97	89	44222
44	Teruel	223	Torre de Arcas	107	52	55	44223
44	Teruel	224	Torre de las Arcas	34	20	14	44224
44	Teruel	225	Torre del Compte	175	85	90	44225
44	Teruel	226	Torrelacárcel	290	153	137	44226
44	Teruel	227	Torre los Negros	100	49	51	44227
44	Teruel	228	Torremocha de Jiloca	170	82	88	44228
44	Teruel	229	Torres de Albarracín	161	87	74	44229
44	Teruel	230	Torrevelilla	203	103	100	44230
44	Teruel	231	Torrijas	74	33	41	44231
44	Teruel	232	Torrijo del Campo	556	281	275	44232
44	Teruel	234	Tramacastiel	118	58	60	44234
44	Teruel	235	Tramacastilla	124	58	66	44235
44	Teruel	236	Tronchón	95	51	44	44236
44	Teruel	237	Urrea de Gaén	610	300	310	44237
44	Teruel	238	Utrillas	3279	1700	1579	44238
44	Teruel	239	Valacloche	20	13	7	44239
44	Teruel	240	Valbona	187	98	89	44240
44	Teruel	241	Valdealgorfa	736	365	371	44241
44	Teruel	243	Valdecuenca	39	20	19	44243
44	Teruel	244	Valdelinares	119	67	52	44244
44	Teruel	245	Valdeltormo	369	194	175	44245
44	Teruel	246	Valderrobres	1845	952	893	44246
44	Teruel	247	Valjunquera	440	218	222	44247
44	Teruel	249	Vallecillo (El)	69	37	32	44249
44	Teruel	250	Veguillas de la Sierra	28	17	11	44250
44	Teruel	251	Villafranca del Campo	382	190	192	44251
44	Teruel	252	Villahermosa del Campo	70	38	32	44252
44	Teruel	256	Villanueva del Rebollar de la Sierra	52	30	22	44256
44	Teruel	257	Villar del Cobo	223	117	106	44257
44	Teruel	258	Villar del Salz	101	56	45	44258
44	Teruel	260	Villarluengo	201	116	85	44260
44	Teruel	261	Villarquemado	966	490	476	44261
44	Teruel	262	Villarroya de los Pinares	201	105	96	44262
44	Teruel	263	Villastar	341	181	160	44263
44	Teruel	264	Villel	331	170	161	44264
44	Teruel	265	Vinaceite	287	149	138	44265
44	Teruel	266	Visiedo	203	93	110	44266
44	Teruel	267	Vivel del Río Martín	92	49	43	44267
44	Teruel	268	Zoma (La)	31	16	15	44268
45	Toledo	001	Ajofrín	2173	1124	1049	45001
45	Toledo	002	Alameda de la Sagra	2846	1510	1336	45002
45	Toledo	003	Albarreal de Tajo	612	304	308	45003
45	Toledo	004	Alcabón	630	319	311	45004
45	Toledo	005	Alcañizo	326	170	156	45005
45	Toledo	006	Alcaudete de la Jara	1821	873	948	45006
45	Toledo	007	Alcolea de Tajo	778	384	394	45007
45	Toledo	008	Aldea en Cabo	176	94	82	45008
45	Toledo	009	Aldeanueva de Barbarroya	819	417	402	45009
45	Toledo	010	Aldeanueva de San Bartolomé	596	294	302	45010
45	Toledo	011	Almendral de la Cañada	397	206	191	45011
45	Toledo	012	Almonacid de Toledo	797	410	387	45012
45	Toledo	013	Almorox	2196	1141	1055	45013
45	Toledo	014	Añover de Tajo	4542	2359	2183	45014
45	Toledo	015	Arcicóllar	562	276	286	45015
45	Toledo	016	Argés	2477	1225	1252	45016
45	Toledo	017	Azután	344	176	168	45017
45	Toledo	018	Barcience	111	58	53	45018
45	Toledo	019	Bargas	6816	3402	3414	45019
45	Toledo	020	Belvís de la Jara	1688	827	861	45020
45	Toledo	021	Borox	2221	1112	1109	45021
45	Toledo	022	Buenaventura	540	257	283	45022
45	Toledo	023	Burguillos de Toledo	965	492	473	45023
45	Toledo	024	Burujón	1290	660	630	45024
45	Toledo	025	Cabañas de la Sagra	1288	659	629	45025
45	Toledo	026	Cabañas de Yepes	249	129	120	45026
45	Toledo	027	Cabezamesada	482	249	233	45027
45	Toledo	028	Calera y Chozas	3734	1881	1853	45028
45	Toledo	029	Caleruela	304	152	152	45029
45	Toledo	030	Calzada de Oropesa	599	301	298	45030
45	Toledo	031	Camarena	2235	1146	1089	45031
45	Toledo	032	Camarenilla	512	256	256	45032
45	Toledo	033	Campillo de la Jara (El)	520	274	246	45033
45	Toledo	034	Camuñas	1697	862	835	45034
45	Toledo	035	Cardiel de los Montes	158	90	68	45035
45	Toledo	036	Carmena	819	412	407	45036
45	Toledo	037	Carpio de Tajo (El)	2252	1092	1160	45037
45	Toledo	038	Carranque	1746	887	859	45038
45	Toledo	039	Carriches	288	146	142	45039
45	Toledo	040	Casar de Escalona (El)	961	465	496	45040
45	Toledo	041	Casarrubios del Monte	2942	1517	1425	45041
45	Toledo	042	Casasbuenas	227	114	113	45042
45	Toledo	043	Castillo de Bayuela	1011	501	510	45043
45	Toledo	045	Cazalegas	1166	581	585	45045
45	Toledo	046	Cebolla	2809	1395	1414	45046
45	Toledo	047	Cedillo del Condado	1542	795	747	45047
45	Toledo	048	Cerralbos (Los)	454	225	229	45048
45	Toledo	049	Cervera de los Montes	398	210	188	45049
45	Toledo	050	Ciruelos	337	184	153	45050
45	Toledo	051	Cobeja	1804	908	896	45051
45	Toledo	052	Cobisa	1618	842	776	45052
45	Toledo	053	Consuegra	9958	4934	5024	45053
45	Toledo	054	Corral de Almaguer	5622	2813	2809	45054
45	Toledo	055	Cuerva	1311	643	668	45055
45	Toledo	056	Chozas de Canales	1002	502	500	45056
45	Toledo	057	Chueca	263	138	125	45057
45	Toledo	058	Domingo Pérez	479	238	241	45058
45	Toledo	059	Dosbarrios	2097	1060	1037	45059
45	Toledo	060	Erustes	199	101	98	45060
45	Toledo	061	Escalona	2170	1108	1062	45061
45	Toledo	062	Escalonilla	1432	695	737	45062
45	Toledo	063	Espinoso del Rey	631	323	308	45063
45	Toledo	064	Esquivias	3806	1907	1899	45064
45	Toledo	065	Estrella (La)	411	216	195	45065
45	Toledo	066	Fuensalida	7665	3874	3791	45066
45	Toledo	067	Gálvez	3082	1546	1536	45067
45	Toledo	068	Garciotum	155	73	82	45068
45	Toledo	069	Gerindote	1839	936	903	45069
45	Toledo	070	Guadamur	1578	802	776	45070
45	Toledo	071	Guardia (La)	2418	1195	1223	45071
45	Toledo	072	Herencias (Las)	753	389	364	45072
45	Toledo	073	Herreruela de Oropesa	426	210	216	45073
45	Toledo	074	Hinojosa de San Vicente	480	260	220	45074
45	Toledo	075	Hontanar	126	69	57	45075
45	Toledo	076	Hormigos	416	211	205	45076
45	Toledo	077	Huecas	474	247	227	45077
45	Toledo	078	Huerta de Valdecarábanos	1661	817	844	45078
45	Toledo	079	Iglesuela (La)	435	213	222	45079
45	Toledo	080	Illán de Vacas	4	3	1	45080
45	Toledo	081	Illescas	10347	5198	5149	45081
45	Toledo	082	Lagartera	1839	906	933	45082
45	Toledo	083	Layos	268	138	130	45083
45	Toledo	084	Lillo	2905	1459	1446	45084
45	Toledo	085	Lominchar	1198	621	577	45085
45	Toledo	086	Lucillos	499	244	255	45086
45	Toledo	087	Madridejos	10500	5189	5311	45087
45	Toledo	088	Magán	1137	570	567	45088
45	Toledo	089	Malpica de Tajo	1888	957	931	45089
45	Toledo	090	Manzaneque	492	245	247	45090
45	Toledo	091	Maqueda	455	232	223	45091
45	Toledo	092	Marjaliza	325	158	167	45092
45	Toledo	093	Marrupe	141	72	69	45093
45	Toledo	094	Mascaraque	479	231	248	45094
45	Toledo	095	Mata (La)	991	491	500	45095
45	Toledo	096	Mazarambroz	1221	611	610	45096
45	Toledo	097	Mejorada	1124	561	563	45097
45	Toledo	098	Menasalbas	2971	1556	1415	45098
45	Toledo	099	Méntrida	2105	1081	1024	45099
45	Toledo	100	Mesegar de Tajo	230	113	117	45100
45	Toledo	101	Miguel Esteban	4719	2356	2363	45101
45	Toledo	102	Mocejón	4157	2137	2020	45102
45	Toledo	103	Mohedas de la Jara	616	314	302	45103
45	Toledo	104	Montearagón	441	232	209	45104
45	Toledo	105	Montesclaros	463	236	227	45105
45	Toledo	106	Mora	9371	4625	4746	45106
45	Toledo	107	Nambroca	2603	1321	1282	45107
45	Toledo	108	Nava de Ricomalillo (La)	718	361	357	45108
45	Toledo	109	Navahermosa	3886	1971	1915	45109
45	Toledo	110	Navalcán	2288	1201	1087	45110
45	Toledo	111	Navalmoralejo	72	34	38	45111
45	Toledo	112	Navalmorales (Los)	2618	1316	1302	45112
45	Toledo	113	Navalucillos (Los)	2732	1361	1371	45113
45	Toledo	114	Navamorcuende	741	391	350	45114
45	Toledo	115	Noblejas	3060	1558	1502	45115
45	Toledo	116	Noez	817	412	405	45116
45	Toledo	117	Nombela	938	485	453	45117
45	Toledo	118	Novés	1545	784	761	45118
45	Toledo	119	Numancia de la Sagra	2555	1345	1210	45119
45	Toledo	120	Nuño Gómez	202	101	101	45120
45	Toledo	121	Ocaña	6190	3076	3114	45121
45	Toledo	122	Olías del Rey	4287	2163	2124	45122
45	Toledo	123	Ontígola	1250	676	574	45123
45	Toledo	124	Orgaz	2672	1327	1345	45124
45	Toledo	125	Oropesa	2717	1342	1375	45125
45	Toledo	126	Otero	203	95	108	45126
45	Toledo	127	Palomeque	483	252	231	45127
45	Toledo	128	Pantoja	2469	1264	1205	45128
45	Toledo	129	Paredes de Escalona	116	56	60	45129
45	Toledo	130	Parrillas	423	209	214	45130
45	Toledo	131	Pelahustán	342	179	163	45131
45	Toledo	132	Pepino	948	475	473	45132
45	Toledo	133	Polán	3306	1675	1631	45133
45	Toledo	134	Portillo de Toledo	1971	1014	957	45134
45	Toledo	135	Puebla de Almoradiel (La)	5380	2697	2683	45135
45	Toledo	136	Puebla de Montalbán (La)	7111	3574	3537	45136
45	Toledo	137	Pueblanueva (La)	2018	1031	987	45137
45	Toledo	138	Puente del Arzobispo (El)	1566	756	810	45138
45	Toledo	139	Puerto de San Vicente	277	136	141	45139
45	Toledo	140	Pulgar	1268	644	624	45140
45	Toledo	141	Quero	1273	634	639	45141
45	Toledo	142	Quintanar de la Orden	9503	4707	4796	45142
45	Toledo	143	Quismondo	1298	652	646	45143
45	Toledo	144	Real de San Vicente (El)	996	497	499	45144
45	Toledo	145	Recas	2614	1378	1236	45145
45	Toledo	146	Retamoso	160	84	76	45146
45	Toledo	147	Rielves	516	257	259	45147
45	Toledo	148	Robledo del Mazo	518	267	251	45148
45	Toledo	149	Romeral (El)	895	438	457	45149
45	Toledo	150	San Bartolomé de las Abiertas	473	251	222	45150
45	Toledo	151	San Martín de Montalbán	751	365	386	45151
45	Toledo	152	San Martín de Pusa	790	399	391	45152
45	Toledo	153	San Pablo de los Montes	2128	1079	1049	45153
45	Toledo	154	San Román de los Montes	726	377	349	45154
45	Toledo	155	Santa Ana de Pusa	406	209	197	45155
45	Toledo	156	Santa Cruz de la Zarza	4392	2209	2183	45156
45	Toledo	157	Santa Cruz del Retamar	1681	849	832	45157
45	Toledo	158	Santa Olalla	2567	1312	1255	45158
45	Toledo	159	Sartajada	116	69	47	45159
45	Toledo	160	Segurilla	981	488	493	45160
45	Toledo	161	Seseña	4244	2212	2032	45161
45	Toledo	162	Sevilleja de la Jara	1056	555	501	45162
45	Toledo	163	Sonseca	9467	4806	4661	45163
45	Toledo	164	Sotillo de las Palomas	223	111	112	45164
45	Toledo	165	Talavera de la Reina	74241	36167	38074	45165
45	Toledo	166	Tembleque	2099	1063	1036	45166
45	Toledo	167	Toboso (El)	2077	1021	1056	45167
45	Toledo	168	Toledo	68537	32870	35667	45168
45	Toledo	169	Torralba de Oropesa	280	132	148	45169
45	Toledo	170	Torrecilla de la Jara	292	146	146	45170
45	Toledo	171	Torre de Esteban Hambrán (La)	1489	772	717	45171
45	Toledo	172	Torrico	894	464	430	45172
45	Toledo	173	Torrijos	10041	4926	5115	45173
45	Toledo	174	Totanés	363	185	178	45174
45	Toledo	175	Turleque	971	480	491	45175
45	Toledo	176	Ugena	1585	835	750	45176
45	Toledo	177	Urda	2965	1488	1477	45177
45	Toledo	179	Valdeverdeja	786	358	428	45179
45	Toledo	180	Valmojado	2406	1232	1174	45180
45	Toledo	181	Velada	2386	1244	1142	45181
45	Toledo	182	Ventas con Peña Aguilera (Las)	1367	695	672	45182
45	Toledo	183	Ventas de Retamosa (Las)	804	416	388	45183
45	Toledo	184	Ventas de San Julián (Las)	236	106	130	45184
45	Toledo	185	Villacañas	9347	4628	4719	45185
45	Toledo	186	Villa de Don Fadrique (La)	4101	2036	2065	45186
45	Toledo	187	Villafranca de los Caballeros	5335	2636	2699	45187
45	Toledo	188	Villaluenga de la Sagra	2642	1307	1335	45188
45	Toledo	189	Villamiel de Toledo	477	242	235	45189
45	Toledo	190	Villaminaya	644	325	319	45190
45	Toledo	191	Villamuelas	743	368	375	45191
45	Toledo	192	Villanueva de Alcardete	3293	1665	1628	45192
45	Toledo	193	Villanueva de Bogas	819	407	412	45193
45	Toledo	194	Villarejo de Montalbán	100	53	47	45194
45	Toledo	195	Villarrubia de Santiago	2869	1434	1435	45195
45	Toledo	196	Villaseca de la Sagra	1563	773	790	45196
45	Toledo	197	Villasequilla	2319	1196	1123	45197
45	Toledo	198	Villatobas	2220	1128	1092	45198
45	Toledo	199	Viso de San Juan (El)	1170	635	535	45199
45	Toledo	200	Yébenes (Los)	6199	3095	3104	45200
45	Toledo	201	Yeles	1731	912	819	45201
45	Toledo	202	Yepes	4358	2225	2133	45202
45	Toledo	203	Yuncler	1855	932	923	45203
45	Toledo	204	Yunclillos	615	318	297	45204
45	Toledo	205	Yuncos	3760	1979	1781	45205
45	Toledo	901	Santo Domingo-Caudilla	790	394	396	45901
46	Valencia/València	001	Ademuz	1195	608	587	46001
46	Valencia/València	002	Ador	1178	595	583	46002
46	Valencia/València	003	Atzeneta d'Albaida	1238	632	606	46003
46	Valencia/València	004	Agullent	2223	1075	1148	46004
46	Valencia/València	005	Alaquàs	26939	13331	13608	46005
46	Valencia/València	006	Albaida	5828	2874	2954	46006
46	Valencia/València	007	Albal	11973	5964	6009	46007
46	Valencia/València	008	Albalat de la Ribera	3474	1689	1785	46008
46	Valencia/València	009	Albalat dels Sorells	3479	1696	1783	46009
46	Valencia/València	010	Albalat dels Tarongers	709	367	342	46010
46	Valencia/València	011	Alberic	9227	4508	4719	46011
46	Valencia/València	012	Alborache	905	463	442	46012
46	Valencia/València	013	Alboraya	16943	8411	8532	46013
46	Valencia/València	014	Albuixech	3032	1465	1567	46014
46	Valencia/València	015	Alcácer	7229	3634	3595	46015
46	Valencia/València	016	Alcàntera de Xúquer	1405	701	704	46016
46	Valencia/València	017	Alzira	40658	19825	20833	46017
46	Valencia/València	018	Alcublas	854	449	405	46018
46	Valencia/València	019	Alcúdia (l')	10584	5230	5354	46019
46	Valencia/València	020	Alcúdia de Crespins (l')	4223	2075	2148	46020
46	Valencia/València	021	Aldaia	24485	12197	12288	46021
46	Valencia/València	022	Alfafar	18878	9332	9546	46022
46	Valencia/València	023	Alfauir	357	186	171	46023
46	Valencia/València	024	Alfara de Algimia	502	247	255	46024
46	Valencia/València	025	Alfara del Patriarca	2683	1314	1369	46025
46	Valencia/València	026	Alfarp	1334	648	686	46026
46	Valencia/València	027	Alfarrasí	1192	573	619	46027
46	Valencia/València	028	Algar de Palancia	428	215	213	46028
46	Valencia/València	029	Algemesí	25028	12332	12696	46029
46	Valencia/València	030	Algimia de Alfara	856	425	431	46030
46	Valencia/València	031	Alginet	12069	6015	6054	46031
46	Valencia/València	032	Almàssera	5759	2763	2996	46032
46	Valencia/València	033	Almiserà	270	129	141	46033
46	Valencia/València	034	Almoines	1675	823	852	46034
46	Valencia/València	035	Almussafes	7256	3620	3636	46035
46	Valencia/València	036	Alpuente	941	490	451	46036
46	Valencia/València	037	Alquería de la Condesa/Alqueria de la Comtessa (l')	1382	652	730	46037
46	Valencia/València	038	Andilla	460	265	195	46038
46	Valencia/València	039	Anna	2572	1292	1280	46039
46	Valencia/València	040	Antella	1488	737	751	46040
46	Valencia/València	041	Aras de Alpuente	398	222	176	46041
46	Valencia/València	042	Aielo de Malferit	3984	1956	2028	46042
46	Valencia/València	043	Ayelo de Rugat	208	110	98	46043
46	Valencia/València	044	Ayora	5513	2815	2698	46044
46	Valencia/València	045	Barxeta	1612	826	786	46045
46	Valencia/València	046	Barx	1251	609	642	46046
46	Valencia/València	047	Bèlgida	689	335	354	46047
46	Valencia/València	048	Bellreguard	3734	1856	1878	46048
46	Valencia/València	049	Bellús	399	196	203	46049
46	Valencia/València	050	Benagéber	189	103	86	46050
46	Valencia/València	051	Benaguasil	9206	4626	4580	46051
46	Valencia/València	052	Benavites	634	308	326	46052
46	Valencia/València	053	Beneixida	625	301	324	46053
46	Valencia/València	054	Benetússer	13636	6746	6890	46054
46	Valencia/València	055	Beniarjó	1242	617	625	46055
46	Valencia/València	056	Beniatjar	231	115	116	46056
46	Valencia/València	057	Benicolet	496	257	239	46057
46	Valencia/València	058	Benifairó de les Valls	1954	963	991	46058
46	Valencia/València	059	Benifairó de la Valldigna	1635	816	819	46059
46	Valencia/València	060	Benifaió	12059	5930	6129	46060
46	Valencia/València	061	Beniflá	164	74	90	46061
46	Valencia/València	062	Benigánim	5474	2763	2711	46062
46	Valencia/València	063	Benimodo	1807	924	883	46063
46	Valencia/València	064	Benimuslem	547	277	270	46064
46	Valencia/València	065	Beniparrell	1611	832	779	46065
46	Valencia/València	066	Benirredrà	1177	557	620	46066
46	Valencia/València	067	Benisanó	1784	904	880	46067
46	Valencia/València	068	Benisoda	300	167	133	46068
46	Valencia/València	069	Benisuera	188	92	96	46069
46	Valencia/València	070	Bétera	13885	6917	6968	46070
46	Valencia/València	071	Bicorp	676	334	342	46071
46	Valencia/València	072	Bocairent	4508	2227	2281	46072
46	Valencia/València	073	Bolbaite	1411	717	694	46073
46	Valencia/València	074	Bonrepòs i Mirambell	2283	1124	1159	46074
46	Valencia/València	075	Bufali	206	101	105	46075
46	Valencia/València	076	Bugarra	828	409	419	46076
46	Valencia/València	077	Buñol	9301	4628	4673	46077
46	Valencia/València	078	Burjassot	35171	17073	18098	46078
46	Valencia/València	079	Calles	434	235	199	46079
46	Valencia/València	080	Camporrobles	1362	681	681	46080
46	Valencia/València	081	Canals	13080	6484	6596	46081
46	Valencia/València	082	Canet d'En Berenguer	2562	1253	1309	46082
46	Valencia/València	083	Carcaixent	20609	10036	10573	46083
46	Valencia/València	084	Cárcer	2070	992	1078	46084
46	Valencia/València	085	Carlet	13975	6861	7114	46085
46	Valencia/València	086	Carrícola	73	34	39	46086
46	Valencia/València	087	Casas Altas	157	83	74	46087
46	Valencia/València	088	Casas Bajas	286	153	133	46088
46	Valencia/València	089	Casinos	2395	1235	1160	46089
46	Valencia/València	090	Castelló de Rugat	2057	1063	994	46090
46	Valencia/València	091	Castellonet de la Conquesta	154	86	68	46091
46	Valencia/València	092	Castielfabib	519	279	240	46092
46	Valencia/València	093	Catadau	2345	1173	1172	46093
46	Valencia/València	094	Catarroja	20616	10131	10485	46094
46	Valencia/València	095	Caudete de las Fuentes	805	407	398	46095
46	Valencia/València	096	Cerdà	287	142	145	46096
46	Valencia/València	097	Cofrentes	1056	528	528	46097
46	Valencia/València	098	Corbera	3068	1488	1580	46098
46	Valencia/València	099	Cortes de Pallás	792	419	373	46099
46	Valencia/València	100	Cotes	369	168	201	46100
46	Valencia/València	101	Quart de les Valls	1048	493	555	46101
46	Valencia/València	102	Quart de Poblet	26131	12891	13240	46102
46	Valencia/València	103	Quartell	1369	663	706	46103
46	Valencia/València	104	Quatretonda	2549	1313	1236	46104
46	Valencia/València	105	Cullera	20663	10223	10440	46105
46	Valencia/València	106	Chelva	2105	1080	1025	46106
46	Valencia/València	107	Chella	2527	1254	1273	46107
46	Valencia/València	108	Chera	567	299	268	46108
46	Valencia/València	109	Cheste	6915	3516	3399	46109
46	Valencia/València	110	Xirivella	26053	12893	13160	46110
46	Valencia/València	111	Chiva	9721	4875	4846	46111
46	Valencia/València	112	Chulilla	778	385	393	46112
46	Valencia/València	113	Daimús	1674	840	834	46113
46	Valencia/València	114	Domeño	516	264	252	46114
46	Valencia/València	115	Dos Aguas	406	231	175	46115
46	Valencia/València	116	Eliana (l')	13087	6534	6553	46116
46	Valencia/València	117	Emperador	210	106	104	46117
46	Valencia/València	118	Enguera	4703	2324	2379	46118
46	Valencia/València	119	Ènova (l')	1049	528	521	46119
46	Valencia/València	120	Estivella	1114	522	592	46120
46	Valencia/València	121	Estubeny	151	70	81	46121
46	Valencia/València	122	Faura	2830	1418	1412	46122
46	Valencia/València	123	Favara	1755	854	901	46123
46	Valencia/València	124	Fontanars dels Alforins	970	499	471	46124
46	Valencia/València	125	Fortaleny	981	493	488	46125
46	Valencia/València	126	Foios	5372	2600	2772	46126
46	Valencia/València	127	Font d'En Carròs (la)	3236	1608	1628	46127
46	Valencia/València	128	Font de la Figuera (la)	2094	1063	1031	46128
46	Valencia/València	129	Fuenterrobles	728	380	348	46129
46	Valencia/València	130	Gavarda	1237	600	637	46130
46	Valencia/València	131	Gandia	59123	28966	30157	46131
46	Valencia/València	132	Genovés	2383	1183	1200	46132
46	Valencia/València	133	Gestalgar	738	365	373	46133
46	Valencia/València	134	Gilet	1477	737	740	46134
46	Valencia/València	135	Godella	11222	5500	5722	46135
46	Valencia/València	136	Godelleta	2242	1101	1141	46136
46	Valencia/València	137	Granja de la Costera (la)	360	171	189	46137
46	Valencia/València	138	Guadasequies	385	196	189	46138
46	Valencia/València	139	Guadassuar	5331	2651	2680	46139
46	Valencia/València	140	Guardamar	68	36	32	46140
46	Valencia/València	141	Higueruelas	560	289	271	46141
46	Valencia/València	142	Jalance	1073	542	531	46142
46	Valencia/València	143	Xeraco	4982	2503	2479	46143
46	Valencia/València	144	Jarafuel	917	474	443	46144
46	Valencia/València	145	Xàtiva	25478	12387	13091	46145
46	Valencia/València	146	Xeresa	1879	946	933	46146
46	Valencia/València	147	Llíria	16856	8415	8441	46147
46	Valencia/València	148	Loriguilla	1005	511	494	46148
46	Valencia/València	149	Losa del Obispo	450	217	233	46149
46	Valencia/València	150	Llutxent	2412	1221	1191	46150
46	Valencia/València	151	Lugar Nuevo de Fenollet	783	384	399	46151
46	Valencia/València	152	Lugar Nuevo de la Corona	93	45	48	46152
46	Valencia/València	153	Llocnou de Sant Jeroni	568	285	283	46153
46	Valencia/València	154	Llanera de Ranes	992	510	482	46154
46	Valencia/València	155	Llaurí	118	59	59	46155
46	Valencia/València	156	Llombai	2271	1144	1127	46156
46	Valencia/València	157	Llosa de Ranes	3622	1863	1759	46157
46	Valencia/València	158	Macastre	1050	516	534	46158
46	Valencia/València	159	Manises	25939	12774	13165	46159
46	Valencia/València	160	Manuel	2426	1173	1253	46160
46	Valencia/València	161	Marines	1406	738	668	46161
46	Valencia/València	162	Masalavés	1464	751	713	46162
46	Valencia/València	163	Massalfassar	1345	665	680	46163
46	Valencia/València	164	Massamagrell	12766	6261	6505	46164
46	Valencia/València	165	Massanassa	7521	3656	3865	46165
46	Valencia/València	166	Meliana	9051	4416	4635	46166
46	Valencia/València	167	Millares	628	306	322	46167
46	Valencia/València	168	Miramar	1232	611	621	46168
46	Valencia/València	169	Mislata	40616	19876	20740	46169
46	Valencia/València	170	Mogente/Moixent	4269	2163	2106	46170
46	Valencia/València	171	Moncada	18602	9209	9393	46171
46	Valencia/València	172	Monserrat	3157	1624	1533	46172
46	Valencia/València	173	Montaverner	1702	862	840	46173
46	Valencia/València	174	Montesa	1256	629	627	46174
46	Valencia/València	175	Montichelvo	597	301	296	46175
46	Valencia/València	176	Montroy	1538	791	747	46176
46	Valencia/València	177	Museros	4158	2074	2084	46177
46	Valencia/València	178	Náquera	2783	1422	1361	46178
46	Valencia/València	179	Navarrés	2744	1392	1352	46179
46	Valencia/València	180	Novelé/Novetlè	670	326	344	46180
46	Valencia/València	181	Oliva	21001	10342	10659	46181
46	Valencia/València	182	Olocau	884	458	426	46182
46	Valencia/València	183	Olleria (l')	7058	3613	3445	46183
46	Valencia/València	184	Ontinyent	31926	15801	16125	46184
46	Valencia/València	185	Otos	526	266	260	46185
46	Valencia/València	186	Paiporta	18194	9092	9102	46186
46	Valencia/València	187	Palma de Gandía	1575	787	788	46187
46	Valencia/València	188	Palmera	532	269	263	46188
46	Valencia/València	189	Palomar	503	248	255	46189
46	Valencia/València	190	Paterna	47498	23480	24018	46190
46	Valencia/València	191	Pedralba	2109	1085	1024	46191
46	Valencia/València	192	Petrés	810	401	409	46192
46	Valencia/València	193	Picanya	8932	4452	4480	46193
46	Valencia/València	194	Picassent	16005	8104	7901	46194
46	Valencia/València	195	Piles	1981	968	1013	46195
46	Valencia/València	196	Pinet	212	110	102	46196
46	Valencia/València	197	Polinyà de Xúquer	3031	1492	1539	46197
46	Valencia/València	198	Potríes	937	460	477	46198
46	Valencia/València	199	Pobla de Farnals (la)	5473	2756	2717	46199
46	Valencia/València	200	Pobla del Duc (la)	2427	1185	1242	46200
46	Valencia/València	201	Puebla de San Miguel	81	44	37	46201
46	Valencia/València	202	Pobla de Vallbona (la)	11757	6019	5738	46202
46	Valencia/València	203	Pobla Llarga (la)	4373	2151	2222	46203
46	Valencia/València	204	Puig	7195	3534	3661	46204
46	Valencia/València	205	Puçol	14529	7138	7391	46205
46	Valencia/València	206	Quesa	797	403	394	46206
46	Valencia/València	207	Rafelbuñol/Rafelbunyol	5553	2708	2845	46207
46	Valencia/València	208	Rafelcofer	1406	665	741	46208
46	Valencia/València	209	Rafelguaraf	2406	1168	1238	46209
46	Valencia/València	210	Ráfol de Salem	369	173	196	46210
46	Valencia/València	211	Real de Gandía	1789	862	927	46211
46	Valencia/València	212	Real de Montroi	1798	925	873	46212
46	Valencia/València	213	Requena	19092	9571	9521	46213
46	Valencia/València	214	Riba-roja de Túria	12908	6453	6455	46214
46	Valencia/València	215	Riola	1609	804	805	46215
46	Valencia/València	216	Rocafort	5117	2498	2619	46216
46	Valencia/València	217	Rotglá y Corberá	1035	512	523	46217
46	Valencia/València	218	Rótova	1295	658	637	46218
46	Valencia/València	219	Rugat	207	103	104	46219
46	Valencia/València	220	Sagunto/Sagunt	56756	27650	29106	46220
46	Valencia/València	221	Salem	468	236	232	46221
46	Valencia/València	222	San Juan de Énova	349	161	188	46222
46	Valencia/València	223	Sedaví	8353	4081	4272	46223
46	Valencia/València	224	Segart	212	101	111	46224
46	Valencia/València	225	Sellent	471	252	219	46225
46	Valencia/València	226	Sempere	39	20	19	46226
46	Valencia/València	227	Senyera	937	449	488	46227
46	Valencia/València	228	Serra	1915	974	941	46228
46	Valencia/València	229	Siete Aguas	1282	661	621	46229
46	Valencia/València	230	Silla	15614	7875	7739	46230
46	Valencia/València	231	Simat de la Valldigna	3112	1582	1530	46231
46	Valencia/València	232	Sinarcas	1245	643	602	46232
46	Valencia/València	233	Sollana	4463	2174	2289	46233
46	Valencia/València	234	Sot de Chera	340	171	169	46234
46	Valencia/València	235	Sueca	25406	12463	12943	46235
46	Valencia/València	236	Sumacàrcer	1364	688	676	46236
46	Valencia/València	237	Tavernes Blanques	8453	4177	4276	46237
46	Valencia/València	238	Tavernes de la Valldigna	16516	8194	8322	46238
46	Valencia/València	239	Teresa de Cofrentes	695	351	344	46239
46	Valencia/València	240	Terrateig	200	102	98	46240
46	Valencia/València	241	Titaguas	555	300	255	46241
46	Valencia/València	242	Torrebaja	447	229	218	46242
46	Valencia/València	243	Torrella	175	87	88	46243
46	Valencia/València	244	Torrent	64586	32025	32561	46244
46	Valencia/València	245	Torres Torres	435	219	216	46245
46	Valencia/València	246	Tous	1183	578	605	46246
46	Valencia/València	247	Tuéjar	1268	669	599	46247
46	Valencia/València	248	Turís	4733	2409	2324	46248
46	Valencia/València	249	Utiel	11781	5867	5914	46249
46	Valencia/València	250	Valencia	739014	350843	388171	46250
46	Valencia/València	251	Vallada	3151	1584	1567	46251
46	Valencia/València	252	Vallanca	235	115	120	46252
46	Valencia/València	253	Vallés	102	55	47	46253
46	Valencia/València	254	Venta del Moro	1567	797	770	46254
46	Valencia/València	255	Villalonga	3639	1802	1837	46255
46	Valencia/València	256	Vilamarxant	5993	3066	2927	46256
46	Valencia/València	257	Villanueva de Castellón	6950	3420	3530	46257
46	Valencia/València	258	Villar del Arzobispo	3457	1725	1732	46258
46	Valencia/València	259	Villargordo del Cabriel	719	374	345	46259
46	Valencia/València	260	Vinalesa	2341	1112	1229	46260
46	Valencia/València	261	Yátova	1978	1024	954	46261
46	Valencia/València	262	Yesa (La)	283	149	134	46262
46	Valencia/València	263	Zarra	424	229	195	46263
46	Valencia/València	902	Gátova	500	235	265	46902
46	Valencia/València	903	San Antonio de Benagéber	2719	1364	1355	46903
47	Valladolid	001	Adalia	88	44	44	47001
47	Valladolid	002	Aguasal	24	13	11	47002
47	Valladolid	003	Aguilar de Campos	367	193	174	47003
47	Valladolid	004	Alaejos	1614	829	785	47004
47	Valladolid	005	Alcazarén	708	377	331	47005
47	Valladolid	006	Aldea de San Miguel	227	119	108	47006
47	Valladolid	007	Aldeamayor de San Martín	1436	725	711	47007
47	Valladolid	008	Almenara de Adaja	31	15	16	47008
47	Valladolid	009	Amusquillo	173	95	78	47009
47	Valladolid	010	Arroyo de la Encomienda	3635	1877	1758	47010
47	Valladolid	011	Ataquines	870	457	413	47011
47	Valladolid	012	Bahabón	203	102	101	47012
47	Valladolid	013	Barcial de la Loma	160	81	79	47013
47	Valladolid	014	Barruelo del Valle	76	42	34	47014
47	Valladolid	015	Becilla de Valderaduey	423	227	196	47015
47	Valladolid	016	Benafarces	115	58	57	47016
47	Valladolid	017	Bercero	283	150	133	47017
47	Valladolid	018	Berceruelo	44	24	20	47018
47	Valladolid	019	Berrueces	105	60	45	47019
47	Valladolid	020	Bobadilla del Campo	408	211	197	47020
47	Valladolid	021	Bocigas	139	67	72	47021
47	Valladolid	022	Bocos de Duero	85	38	47	47022
47	Valladolid	023	Boecillo	1614	829	785	47023
47	Valladolid	024	Bolaños de Campos	381	193	188	47024
47	Valladolid	025	Brahojos de Medina	182	99	83	47025
47	Valladolid	026	Bustillo de Chaves	95	47	48	47026
47	Valladolid	027	Cabezón de Pisuerga	1816	922	894	47027
47	Valladolid	028	Cabezón de Valderaduey	47	23	24	47028
47	Valladolid	029	Cabreros del Monte	94	51	43	47029
47	Valladolid	030	Campaspero	1452	749	703	47030
47	Valladolid	031	Campillo (El)	239	138	101	47031
47	Valladolid	032	Camporredondo	214	118	96	47032
47	Valladolid	033	Canalejas de Peñafiel	292	147	145	47033
47	Valladolid	034	Canillas de Esgueva	131	69	62	47034
47	Valladolid	035	Carpio	1183	625	558	47035
47	Valladolid	036	Casasola de Arión	374	205	169	47036
47	Valladolid	037	Castrejón de Trabancos	260	139	121	47037
47	Valladolid	038	Castrillo de Duero	199	97	102	47038
47	Valladolid	039	Castrillo-Tejeriego	268	144	124	47039
47	Valladolid	040	Castrobol	88	39	49	47040
47	Valladolid	041	Castrodeza	251	135	116	47041
47	Valladolid	042	Castromembibre	89	48	41	47042
47	Valladolid	043	Castromonte	451	233	218	47043
47	Valladolid	044	Castronuevo de Esgueva	321	167	154	47044
47	Valladolid	045	Castronuño	1072	534	538	47045
47	Valladolid	046	Castroponce	196	103	93	47046
47	Valladolid	047	Castroverde de Cerrato	266	155	111	47047
47	Valladolid	048	Ceinos de Campos	275	144	131	47048
47	Valladolid	049	Cervillego de la Cruz	156	77	79	47049
47	Valladolid	050	Cigales	2802	1371	1431	47050
47	Valladolid	051	Ciguñuela	372	198	174	47051
47	Valladolid	052	Cistérniga	3780	1968	1812	47052
47	Valladolid	053	Cogeces de Íscar	150	80	70	47053
47	Valladolid	054	Cogeces del Monte	916	497	419	47054
47	Valladolid	055	Corcos	270	141	129	47055
47	Valladolid	056	Corrales de Duero	139	82	57	47056
47	Valladolid	057	Cubillas de Santa Marta	281	151	130	47057
47	Valladolid	058	Cuenca de Campos	292	146	146	47058
47	Valladolid	059	Curiel de Duero	128	72	56	47059
47	Valladolid	060	Encinas de Esgueva	370	195	175	47060
47	Valladolid	061	Esguevillas de Esgueva	423	214	209	47061
47	Valladolid	062	Fombellida	282	147	135	47062
47	Valladolid	063	Fompedraza	143	77	66	47063
47	Valladolid	064	Fontihoyuelo	42	27	15	47064
47	Valladolid	065	Fresno el Viejo	1267	641	626	47065
47	Valladolid	066	Fuensaldaña	1002	496	506	47066
47	Valladolid	067	Fuente el Sol	303	157	146	47067
47	Valladolid	068	Fuente-Olmedo	68	34	34	47068
47	Valladolid	069	Gallegos de Hornija	148	72	76	47069
47	Valladolid	070	Gatón de Campos	42	26	16	47070
47	Valladolid	071	Geria	472	258	214	47071
47	Valladolid	073	Herrín de Campos	205	95	110	47073
47	Valladolid	074	Hornillos de Eresma	162	85	77	47074
47	Valladolid	075	Íscar	6145	3104	3041	47075
47	Valladolid	076	Laguna de Duero	16977	8585	8392	47076
47	Valladolid	077	Langayo	462	246	216	47077
47	Valladolid	078	Lomoviejo	266	131	135	47078
47	Valladolid	079	Llano de Olmedo	96	50	46	47079
47	Valladolid	080	Manzanillo	71	37	34	47080
47	Valladolid	081	Marzales	79	39	40	47081
47	Valladolid	082	Matapozuelos	1005	504	501	47082
47	Valladolid	083	Matilla de los Caños	105	62	43	47083
47	Valladolid	084	Mayorga	1671	803	868	47084
47	Valladolid	085	Medina del Campo	20047	9806	10241	47085
47	Valladolid	086	Medina de Rioseco	4902	2393	2509	47086
47	Valladolid	087	Megeces	462	227	235	47087
47	Valladolid	088	Melgar de Abajo	175	89	86	47088
47	Valladolid	089	Melgar de Arriba	299	149	150	47089
47	Valladolid	090	Mojados	2565	1277	1288	47090
47	Valladolid	091	Monasterio de Vega	105	58	47	47091
47	Valladolid	092	Montealegre de Campos	169	94	75	47092
47	Valladolid	093	Montemayor de Pililla	1049	557	492	47093
47	Valladolid	094	Moral de la Reina	226	115	111	47094
47	Valladolid	095	Moraleja de las Panaderas	32	20	12	47095
47	Valladolid	096	Morales de Campos	196	98	98	47096
47	Valladolid	097	Mota del Marqués	448	215	233	47097
47	Valladolid	098	Mucientes	617	310	307	47098
47	Valladolid	099	Mudarra (La)	260	140	120	47099
47	Valladolid	100	Muriel	214	107	107	47100
47	Valladolid	101	Nava del Rey	2267	1118	1149	47101
47	Valladolid	102	Nueva Villa de las Torres	407	228	179	47102
47	Valladolid	103	Olivares de Duero	334	186	148	47103
47	Valladolid	104	Olmedo	3434	1659	1775	47104
47	Valladolid	105	Olmos de Esgueva	186	103	83	47105
47	Valladolid	106	Olmos de Peñafiel	85	43	42	47106
47	Valladolid	109	Palazuelo de Vedija	254	128	126	47109
47	Valladolid	110	Parrilla (La)	632	304	328	47110
47	Valladolid	111	Pedraja de Portillo (La)	1055	532	523	47111
47	Valladolid	112	Pedrajas de San Esteban	3237	1631	1606	47112
47	Valladolid	113	Pedrosa del Rey	236	127	109	47113
47	Valladolid	114	Peñafiel	5099	2542	2557	47114
47	Valladolid	115	Peñaflor de Hornija	454	242	212	47115
47	Valladolid	116	Pesquera de Duero	535	283	252	47116
47	Valladolid	117	Piña de Esgueva	406	210	196	47117
47	Valladolid	118	Piñel de Abajo	216	116	100	47118
47	Valladolid	119	Piñel de Arriba	149	74	75	47119
47	Valladolid	121	Pollos	815	419	396	47121
47	Valladolid	122	Portillo	2512	1275	1237	47122
47	Valladolid	123	Pozal de Gallinas	499	266	233	47123
47	Valladolid	124	Pozaldez	513	252	261	47124
47	Valladolid	125	Pozuelo de la Orden	79	45	34	47125
47	Valladolid	126	Puras	60	28	32	47126
47	Valladolid	127	Quintanilla de Arriba	226	120	106	47127
47	Valladolid	128	Quintanilla del Molar	85	36	49	47128
47	Valladolid	129	Quintanilla de Onésimo	1179	605	574	47129
47	Valladolid	130	Quintanilla de Trigueros	113	58	55	47130
47	Valladolid	131	Rábano	249	123	126	47131
47	Valladolid	132	Ramiro	81	46	35	47132
47	Valladolid	133	Renedo de Esgueva	935	493	442	47133
47	Valladolid	134	Roales de Campos	260	133	127	47134
47	Valladolid	135	Robladillo	106	52	54	47135
47	Valladolid	137	Roturas	30	15	15	47137
47	Valladolid	138	Rubí de Bracamonte	333	172	161	47138
47	Valladolid	139	Rueda	1436	731	705	47139
47	Valladolid	140	Saelices de Mayorga	196	97	99	47140
47	Valladolid	141	Salvador de Zapardiel	199	109	90	47141
47	Valladolid	142	San Cebrián de Mazote	218	118	100	47142
47	Valladolid	143	San Llorente	203	110	93	47143
47	Valladolid	144	San Martín de Valvení	108	61	47	47144
47	Valladolid	145	San Miguel del Arroyo	795	419	376	47145
47	Valladolid	146	San Miguel del Pino	231	122	109	47146
47	Valladolid	147	San Pablo de la Moraleja	178	95	83	47147
47	Valladolid	148	San Pedro de Latarce	649	352	297	47148
47	Valladolid	149	San Pelayo	45	24	21	47149
47	Valladolid	150	San Román de Hornija	434	213	221	47150
47	Valladolid	151	San Salvador	49	25	24	47151
47	Valladolid	152	Santa Eufemia del Arroyo	135	66	69	47152
47	Valladolid	153	Santervás de Campos	166	90	76	47153
47	Valladolid	154	Santibáñez de Valcorba	214	108	106	47154
47	Valladolid	155	Santovenia de Pisuerga	2278	1155	1123	47155
47	Valladolid	156	San Vicente del Palacio	244	125	119	47156
47	Valladolid	157	Sardón de Duero	629	319	310	47157
47	Valladolid	158	Seca (La)	1050	561	489	47158
47	Valladolid	159	Serrada	1059	545	514	47159
47	Valladolid	160	Siete Iglesias de Trabancos	611	321	290	47160
47	Valladolid	161	Simancas	3453	1765	1688	47161
47	Valladolid	162	Tamariz de Campos	97	51	46	47162
47	Valladolid	163	Tiedra	407	204	203	47163
47	Valladolid	164	Tordehumos	558	281	277	47164
47	Valladolid	165	Tordesillas	8066	4085	3981	47165
47	Valladolid	166	Torrecilla de la Abadesa	367	188	179	47166
47	Valladolid	167	Torrecilla de la Orden	378	189	189	47167
47	Valladolid	168	Torrecilla de la Torre	36	21	15	47168
47	Valladolid	169	Torre de Esgueva	100	49	51	47169
47	Valladolid	170	Torre de Peñafiel	53	28	25	47170
47	Valladolid	171	Torrelobatón	576	285	291	47171
47	Valladolid	172	Torrescárcela	163	86	77	47172
47	Valladolid	173	Traspinedo	831	431	400	47173
47	Valladolid	174	Trigueros del Valle	296	152	144	47174
47	Valladolid	175	Tudela de Duero	6353	3263	3090	47175
47	Valladolid	176	Unión de Campos (La)	306	153	153	47176
47	Valladolid	177	Urones de Castroponce	151	83	68	47177
47	Valladolid	178	Urueña	212	109	103	47178
47	Valladolid	179	Valbuena de Duero	521	271	250	47179
47	Valladolid	180	Valdearcos de la Vega	141	69	72	47180
47	Valladolid	181	Valdenebro de los Valles	235	120	115	47181
47	Valladolid	182	Valdestillas	1549	774	775	47182
47	Valladolid	183	Valdunquillo	228	108	120	47183
47	Valladolid	184	Valoria la Buena	648	333	315	47184
47	Valladolid	185	Valverde de Campos	119	64	55	47185
47	Valladolid	186	Valladolid	319129	153292	165837	47186
47	Valladolid	187	Vega de Ruiponce	137	66	71	47187
47	Valladolid	188	Vega de Valdetronco	190	103	87	47188
47	Valladolid	189	Velascálvaro	194	101	93	47189
47	Valladolid	190	Velilla	152	78	74	47190
47	Valladolid	191	Velliza	171	101	70	47191
47	Valladolid	192	Ventosa de la Cuesta	154	86	68	47192
47	Valladolid	193	Viana de Cega	1564	798	766	47193
47	Valladolid	194	Viloria	380	202	178	47194
47	Valladolid	195	Villabáñez	477	260	217	47195
47	Valladolid	196	Villabaruz de Campos	49	24	25	47196
47	Valladolid	197	Villabrágima	1223	638	585	47197
47	Valladolid	198	Villacarralón	114	57	57	47198
47	Valladolid	199	Villacid de Campos	122	65	57	47199
47	Valladolid	200	Villaco	131	78	53	47200
47	Valladolid	203	Villafrades de Campos	114	48	66	47203
47	Valladolid	204	Villafranca de Duero	373	190	183	47204
47	Valladolid	205	Villafrechós	532	276	256	47205
47	Valladolid	206	Villafuerte	154	77	77	47206
47	Valladolid	207	Villagarcía de Campos	440	233	207	47207
47	Valladolid	208	Villagómez la Nueva	98	47	51	47208
47	Valladolid	209	Villalán de Campos	55	28	27	47209
47	Valladolid	210	Villalar de los Comuneros	498	238	260	47210
47	Valladolid	211	Villalba de la Loma	47	27	20	47211
47	Valladolid	212	Villalba de los Alcores	581	309	272	47212
47	Valladolid	213	Villalbarba	167	83	84	47213
47	Valladolid	214	Villalón de Campos	2101	1020	1081	47214
47	Valladolid	215	Villamuriel de Campos	93	44	49	47215
47	Valladolid	216	Villán de Tordesillas	182	92	90	47216
47	Valladolid	217	Villanubla	926	490	436	47217
47	Valladolid	218	Villanueva de Duero	1006	519	487	47218
47	Valladolid	219	Villanueva de la Condesa	40	24	16	47219
47	Valladolid	220	Villanueva de los Caballeros	269	129	140	47220
47	Valladolid	221	Villanueva de los Infantes	147	77	70	47221
47	Valladolid	222	Villanueva de San Mancio	115	62	53	47222
47	Valladolid	223	Villardefrades	230	119	111	47223
47	Valladolid	224	Villarmentero de Esgueva	127	63	64	47224
47	Valladolid	225	Villasexmir	121	62	59	47225
47	Valladolid	226	Villavaquerín	220	117	103	47226
47	Valladolid	227	Villavellid	73	40	33	47227
47	Valladolid	228	Villaverde de Medina	582	311	271	47228
47	Valladolid	229	Villavicencio de los Caballeros	326	147	179	47229
47	Valladolid	230	Wamba	376	194	182	47230
47	Valladolid	231	Zaratán	1400	722	678	47231
47	Valladolid	232	Zarza (La)	156	79	77	47232
48	Vizcaya	001	Abadiño	6851	3427	3424	48001
48	Vizcaya	002	Abanto y Ciérvana/Abanto Zierbena	8989	4435	4554	48002
48	Vizcaya	003	Amorebieta-Etxano	16216	8092	8124	48003
48	Vizcaya	004	Amoroto	365	194	171	48004
48	Vizcaya	005	Arakaldo	90	53	37	48005
48	Vizcaya	006	Arantzazu	276	133	143	48006
48	Vizcaya	007	Munitibar-Arbatzegi Gerrikaitz	383	204	179	48007
48	Vizcaya	008	Arcentales	679	370	309	48008
48	Vizcaya	009	Arrankudiaga	745	351	394	48009
48	Vizcaya	010	Arrieta	509	258	251	48010
48	Vizcaya	011	Arrigorriaga	10662	5253	5409	48011
48	Vizcaya	012	Bakio	1614	818	796	48012
48	Vizcaya	013	Barakaldo	97281	47518	49763	48013
48	Vizcaya	014	Barrika	1159	590	569	48014
48	Vizcaya	015	Basauri	47036	23266	23770	48015
48	Vizcaya	016	Berango	4929	2437	2492	48016
48	Vizcaya	017	Bermeo	16972	8335	8637	48017
48	Vizcaya	018	Berriatua	940	488	452	48018
48	Vizcaya	019	Berriz	4139	2090	2049	48019
48	Vizcaya	020	Bilbao	354271	167846	186425	48020
48	Vizcaya	021	Busturia	1673	841	832	48021
48	Vizcaya	022	Carranza	2998	1568	1430	48022
48	Vizcaya	023	Artea	641	310	331	48023
48	Vizcaya	024	Zeanuri	1154	594	560	48024
48	Vizcaya	025	Zeberio	959	502	457	48025
48	Vizcaya	026	Dima	1055	539	516	48026
48	Vizcaya	027	Durango	24742	12065	12677	48027
48	Vizcaya	028	Ea	814	404	410	48028
48	Vizcaya	029	"Etxebarri	 Anteiglesia de San Esteban/Etxebarri Doneztebeko Elizatea"	6690	3413	3277	48029
48	Vizcaya	030	Etxebarria	808	420	388	48030
48	Vizcaya	031	Elantxobe	466	211	255	48031
48	Vizcaya	032	Elorrio	7166	3578	3588	48032
48	Vizcaya	033	Ereño	255	126	129	48033
48	Vizcaya	034	Ermua	17140	8742	8398	48034
48	Vizcaya	035	Fruiz	341	166	175	48035
48	Vizcaya	036	Galdakao	29387	14572	14815	48036
48	Vizcaya	037	Galdames	805	425	380	48037
48	Vizcaya	038	Gamiz-Fika	1138	581	557	48038
48	Vizcaya	039	Garay	241	121	120	48039
48	Vizcaya	040	Gatika	1217	624	593	48040
48	Vizcaya	041	Gautegiz Arteaga	834	422	412	48041
48	Vizcaya	042	Gordexola	1437	717	720	48042
48	Vizcaya	043	Gorliz	4179	2084	2095	48043
48	Vizcaya	044	Getxo	83789	40070	43719	48044
48	Vizcaya	045	Güeñes	5896	2897	2999	48045
48	Vizcaya	046	Gernika-Lumo	15427	7510	7917	48046
48	Vizcaya	047	Guizaburuaga	140	69	71	48047
48	Vizcaya	048	Ibarrangelu	522	246	276	48048
48	Vizcaya	049	Ispaster	613	323	290	48049
48	Vizcaya	050	Izurtza	262	130	132	48050
48	Vizcaya	051	Lanestosa	287	146	141	48051
48	Vizcaya	052	Larrabetzu	1537	769	768	48052
48	Vizcaya	053	Laukiz	958	495	463	48053
48	Vizcaya	054	Leioa	27925	13769	14156	48054
48	Vizcaya	055	Lemoa	2544	1258	1286	48055
48	Vizcaya	056	Lemoiz	882	467	415	48056
48	Vizcaya	057	Lekeitio	7423	3662	3761	48057
48	Vizcaya	058	Mallabia	1119	590	529	48058
48	Vizcaya	059	Mañaria	465	242	223	48059
48	Vizcaya	060	Markina-Xemein	4661	2313	2348	48060
48	Vizcaya	061	Maruri-Jatabe	630	307	323	48061
48	Vizcaya	062	Mendata	335	180	155	48062
48	Vizcaya	063	Mendexa	338	182	156	48063
48	Vizcaya	064	Meñaka	514	257	257	48064
48	Vizcaya	065	Ugao-Miraballes	4122	2072	2050	48065
48	Vizcaya	066	Morga	398	217	181	48066
48	Vizcaya	067	Muxika	1361	708	653	48067
48	Vizcaya	068	Mundaka	1806	850	956	48068
48	Vizcaya	069	Mungia	13647	6708	6939	48069
48	Vizcaya	070	Aulesti	651	335	316	48070
48	Vizcaya	071	Muskiz	6208	3052	3156	48071
48	Vizcaya	072	Otxandio	1010	536	474	48072
48	Vizcaya	073	Ondarroa	9925	4957	4968	48073
48	Vizcaya	074	Orduña	3916	2001	1915	48074
48	Vizcaya	075	Orozko	2031	1024	1007	48075
48	Vizcaya	076	Sukarrieta	313	163	150	48076
48	Vizcaya	077	Plentzia	3556	1716	1840	48077
48	Vizcaya	078	Portugalete	52681	25720	26961	48078
48	Vizcaya	079	Errigoiti	464	259	205	48079
48	Vizcaya	080	Valle de Trápaga-Trapagaran	12450	6145	6305	48080
48	Vizcaya	081	Lezama	2124	1069	1055	48081
48	Vizcaya	082	Santurtzi	47999	23506	24493	48082
48	Vizcaya	083	Ortuella	8819	4315	4504	48083
48	Vizcaya	084	Sestao	32852	15996	16856	48084
48	Vizcaya	085	Sopelana	10097	5035	5062	48085
48	Vizcaya	086	Sopuerta	2237	1135	1102	48086
48	Vizcaya	087	Trucios-Turtzioz	546	267	279	48087
48	Vizcaya	088	Ubide	171	84	87	48088
48	Vizcaya	089	Urduliz	2999	1510	1489	48089
48	Vizcaya	090	Balmaseda	7007	3380	3627	48090
48	Vizcaya	091	Atxondo	1461	744	717	48091
48	Vizcaya	092	Bedia	950	472	478	48092
48	Vizcaya	093	Areatza	1044	470	574	48093
48	Vizcaya	094	Igorre	3917	1956	1961	48094
48	Vizcaya	095	Zaldibar	2896	1405	1491	48095
48	Vizcaya	096	Zalla	7725	3809	3916	48096
48	Vizcaya	097	Zaratamo	1662	843	819	48097
48	Vizcaya	901	Derio	4700	2363	2337	48901
48	Vizcaya	902	Erandio	22853	11262	11591	48902
48	Vizcaya	903	Loiu	1885	938	947	48903
48	Vizcaya	904	Sondika	3929	1903	2026	48904
48	Vizcaya	905	Zamudio	2900	1455	1445	48905
48	Vizcaya	906	Forua	979	493	486	48906
48	Vizcaya	907	Kortezubi	387	202	185	48907
48	Vizcaya	908	Murueta	223	117	106	48908
48	Vizcaya	909	Nabarniz	231	111	120	48909
48	Vizcaya	910	Iurreta	4310	2138	2172	48910
48	Vizcaya	911	Ajangiz	418	213	205	48911
48	Vizcaya	912	Alonsotegi	2760	1331	1429	48912
48	Vizcaya	913	Zierbena	1206	642	564	48913
48	Vizcaya	914	Arratzu	390	188	202	48914
49	Zamora	002	Abezames	110	56	54	49002
49	Zamora	003	Alcañices	1130	568	562	49003
49	Zamora	004	Alcubilla de Nogales	204	98	106	49004
49	Zamora	005	Alfaraz de Sayago	210	114	96	49005
49	Zamora	006	Algodre	195	99	96	49006
49	Zamora	007	Almaraz de Duero	471	238	233	49007
49	Zamora	008	Almeida de Sayago	694	349	345	49008
49	Zamora	009	Andavías	510	251	259	49009
49	Zamora	010	Arcenillas	305	151	154	49010
49	Zamora	011	Arcos de la Polvorosa	301	159	142	49011
49	Zamora	012	Argañín	100	45	55	49012
49	Zamora	013	Argujillo	380	196	184	49013
49	Zamora	014	Arquillinos	179	92	87	49014
49	Zamora	015	Arrabalde	391	189	202	49015
49	Zamora	016	Aspariegos	370	184	186	49016
49	Zamora	017	Asturianos	361	182	179	49017
49	Zamora	018	Ayoó de Vidriales	473	235	238	49018
49	Zamora	019	Barcial del Barco	308	173	135	49019
49	Zamora	020	Belver de los Montes	473	249	224	49020
49	Zamora	021	Benavente	16763	8119	8644	49021
49	Zamora	022	Benegiles	418	222	196	49022
49	Zamora	023	Bermillo de Sayago	1436	746	690	49023
49	Zamora	024	Bóveda de Toro (La)	1003	505	498	49024
49	Zamora	025	Bretó	246	129	117	49025
49	Zamora	026	Bretocino	329	173	156	49026
49	Zamora	027	Brime de Sog	252	114	138	49027
49	Zamora	028	Brime de Urz	154	84	70	49028
49	Zamora	029	Burganes de Valverde	908	466	442	49029
49	Zamora	030	Bustillo del Oro	157	78	79	49030
49	Zamora	031	Cabañas de Sayago	196	92	104	49031
49	Zamora	032	Calzadilla de Tera	508	249	259	49032
49	Zamora	033	Camarzana de Tera	1057	523	534	49033
49	Zamora	034	Cañizal	626	331	295	49034
49	Zamora	035	Cañizo	328	163	165	49035
49	Zamora	036	Carbajales de Alba	678	334	344	49036
49	Zamora	037	Carbellino	272	138	134	49037
49	Zamora	038	Casaseca de Campeán	158	85	73	49038
49	Zamora	039	Casaseca de las Chanas	371	185	186	49039
49	Zamora	040	Castrillo de la Guareña	159	77	82	49040
49	Zamora	041	Castrogonzalo	571	307	264	49041
49	Zamora	042	Castronuevo	352	180	172	49042
49	Zamora	043	Castroverde de Campos	415	211	204	49043
49	Zamora	044	Cazurra	97	54	43	49044
49	Zamora	046	Cerecinos de Campos	432	222	210	49046
49	Zamora	047	Cerecinos del Carrizal	154	83	71	49047
49	Zamora	048	Cernadilla	177	85	92	49048
49	Zamora	050	Cobreros	797	397	400	49050
49	Zamora	052	Coomonte	334	174	160	49052
49	Zamora	053	Coreses	1199	609	590	49053
49	Zamora	054	Corrales	1141	546	595	49054
49	Zamora	055	Cotanes del Monte	162	84	78	49055
49	Zamora	056	Cubillos	397	202	195	49056
49	Zamora	057	Cubo de Benavente	180	95	85	49057
49	Zamora	058	Cubo de Tierra del Vino (El)	475	246	229	49058
49	Zamora	059	Cuelgamures	143	80	63	49059
49	Zamora	061	Entrala	165	83	82	49061
49	Zamora	062	Espadañedo	222	109	113	49062
49	Zamora	063	Faramontanos de Tábara	509	257	252	49063
49	Zamora	064	Fariza	722	362	360	49064
49	Zamora	065	Fermoselle	1646	824	822	49065
49	Zamora	066	Ferreras de Abajo	629	304	325	49066
49	Zamora	067	Ferreras de Arriba	525	264	261	49067
49	Zamora	068	Ferreruela	666	347	319	49068
49	Zamora	069	Figueruela de Arriba	572	280	292	49069
49	Zamora	071	Fonfría	1189	613	576	49071
49	Zamora	075	Fresno de la Polvorosa	216	101	115	49075
49	Zamora	076	Fresno de la Ribera	419	227	192	49076
49	Zamora	077	Fresno de Sayago	268	133	135	49077
49	Zamora	078	Friera de Valverde	276	143	133	49078
49	Zamora	079	Fuente Encalada	151	76	75	49079
49	Zamora	080	Fuentelapeña	1051	537	514	49080
49	Zamora	081	Fuentesaúco	1888	944	944	49081
49	Zamora	082	Fuentes de Ropel	575	293	282	49082
49	Zamora	083	Fuentesecas	89	41	48	49083
49	Zamora	084	Fuentespreadas	407	223	184	49084
49	Zamora	085	Galende	1363	665	698	49085
49	Zamora	086	Gallegos del Pan	167	88	79	49086
49	Zamora	087	Gallegos del Río	850	452	398	49087
49	Zamora	088	Gamones	99	58	41	49088
49	Zamora	090	Gema	270	133	137	49090
49	Zamora	091	Granja de Moreruela	385	189	196	49091
49	Zamora	092	Granucillo	257	130	127	49092
49	Zamora	093	Guarrate	377	200	177	49093
49	Zamora	094	Hermisende	444	241	203	49094
49	Zamora	095	Hiniesta (La)	383	187	196	49095
49	Zamora	096	Jambrina	269	130	139	49096
49	Zamora	097	Justel	170	92	78	49097
49	Zamora	098	Losacino	346	186	160	49098
49	Zamora	099	Losacio	161	85	76	49099
49	Zamora	100	Lubián	378	184	194	49100
49	Zamora	101	Luelmo	255	131	124	49101
49	Zamora	102	Maderal (El)	302	154	148	49102
49	Zamora	103	Madridanos	566	280	286	49103
49	Zamora	104	Mahide	567	295	272	49104
49	Zamora	105	Maire de Castroponce	250	128	122	49105
49	Zamora	107	Malva	228	116	112	49107
49	Zamora	108	Manganeses de la Lampreana	786	395	391	49108
49	Zamora	109	Manganeses de la Polvorosa	876	429	447	49109
49	Zamora	110	Manzanal de Arriba	460	231	229	49110
49	Zamora	111	Manzanal del Barco	200	105	95	49111
49	Zamora	112	Manzanal de los Infantes	194	102	92	49112
49	Zamora	113	Matilla de Arzón	261	142	119	49113
49	Zamora	114	Matilla la Seca	70	34	36	49114
49	Zamora	115	Mayalde	245	121	124	49115
49	Zamora	116	Melgar de Tera	595	290	305	49116
49	Zamora	117	Micereces de Tera	649	332	317	49117
49	Zamora	118	Milles de la Polvorosa	279	139	140	49118
49	Zamora	119	Molacillos	307	161	146	49119
49	Zamora	120	Molezuelas de la Carballeda	118	60	58	49120
49	Zamora	121	Mombuey	476	234	242	49121
49	Zamora	122	Monfarracinos	588	317	271	49122
49	Zamora	123	Montamarta	685	333	352	49123
49	Zamora	124	Moral de Sayago	386	208	178	49124
49	Zamora	125	Moraleja del Vino	1259	664	595	49125
49	Zamora	126	Moraleja de Sayago	297	158	139	49126
49	Zamora	127	Morales del Vino	1634	840	794	49127
49	Zamora	128	Morales de Rey	760	365	395	49128
49	Zamora	129	Morales de Toro	1082	541	541	49129
49	Zamora	130	Morales de Valverde	302	142	160	49130
49	Zamora	131	Moralina	378	193	185	49131
49	Zamora	132	Moreruela de los Infanzones	480	252	228	49132
49	Zamora	133	Moreruela de Tábara	531	279	252	49133
49	Zamora	134	Muelas de los Caballeros	255	135	120	49134
49	Zamora	135	Muelas del Pan	922	455	467	49135
49	Zamora	136	Muga de Sayago	504	244	260	49136
49	Zamora	137	Navianos de Valverde	258	139	119	49137
49	Zamora	138	Olmillos de Castro	427	223	204	49138
49	Zamora	139	Otero de Bodas	283	154	129	49139
49	Zamora	141	Pajares de la Lampreana	500	252	248	49141
49	Zamora	142	Palacios del Pan	248	109	139	49142
49	Zamora	143	Palacios de Sanabria	356	171	185	49143
49	Zamora	145	Pedralba de la Pradería	305	143	162	49145
49	Zamora	146	Pego (El)	456	232	224	49146
49	Zamora	147	Peleagonzalo	446	228	218	49147
49	Zamora	148	Peleas de Abajo	265	120	145	49148
49	Zamora	149	Peñausende	576	291	285	49149
49	Zamora	150	Peque	218	108	110	49150
49	Zamora	151	Perdigón (El)	773	396	377	49151
49	Zamora	152	Pereruela	741	372	369	49152
49	Zamora	153	Perilla de Castro	264	132	132	49153
49	Zamora	154	Pías	237	118	119	49154
49	Zamora	155	Piedrahita de Castro	150	82	68	49155
49	Zamora	156	Pinilla de Toro	381	187	194	49156
49	Zamora	157	Pino	247	134	113	49157
49	Zamora	158	Piñero (El)	312	165	147	49158
49	Zamora	159	Pobladura del Valle	334	165	169	49159
49	Zamora	160	Pobladura de Valderaduey	80	37	43	49160
49	Zamora	162	Porto	338	180	158	49162
49	Zamora	163	Pozoantiguo	333	169	164	49163
49	Zamora	164	Pozuelo de Tábara	246	121	125	49164
49	Zamora	165	Prado	103	52	51	49165
49	Zamora	166	Puebla de Sanabria	1645	787	858	49166
49	Zamora	167	Pueblica de Valverde	324	163	161	49167
49	Zamora	168	Quintanilla del Monte	151	68	83	49168
49	Zamora	169	Quintanilla del Olmo	62	29	33	49169
49	Zamora	170	Quintanilla de Urz	153	79	74	49170
49	Zamora	171	Quiruelas de Vidriales	981	463	518	49171
49	Zamora	172	Rabanales	847	436	411	49172
49	Zamora	173	Rábano de Aliste	480	242	238	49173
49	Zamora	174	Requejo	213	94	119	49174
49	Zamora	175	Revellinos	342	186	156	49175
49	Zamora	176	Riofrío de Aliste	1088	568	520	49176
49	Zamora	177	Rionegro del Puente	402	197	205	49177
49	Zamora	178	Roales	392	201	191	49178
49	Zamora	179	Robleda-Cervantes	447	213	234	49179
49	Zamora	180	Roelos de Sayago	164	87	77	49180
49	Zamora	181	Rosinos de la Requejada	528	256	272	49181
49	Zamora	183	Salce	149	79	70	49183
49	Zamora	184	Samir de los Caños	234	122	112	49184
49	Zamora	185	San Agustín del Pozo	211	112	99	49185
49	Zamora	186	San Cebrián de Castro	379	178	201	49186
49	Zamora	187	San Cristóbal de Entreviñas	1633	825	808	49187
49	Zamora	188	San Esteban del Molar	183	101	82	49188
49	Zamora	189	San Justo	370	179	191	49189
49	Zamora	190	San Martín de Valderaduey	98	48	50	49190
49	Zamora	191	San Miguel de la Ribera	402	200	202	49191
49	Zamora	192	San Miguel del Valle	225	105	120	49192
49	Zamora	193	San Pedro de Ceque	703	344	359	49193
49	Zamora	194	San Pedro de la Nave-Almendra	530	259	271	49194
49	Zamora	197	Santa Clara de Avedillo	261	128	133	49197
49	Zamora	199	Santa Colomba de las Monjas	331	168	163	49199
49	Zamora	200	Santa Cristina de la Polvorosa	1279	661	618	49200
49	Zamora	201	Santa Croya de Tera	484	242	242	49201
49	Zamora	202	Santa Eufemia del Barco	297	165	132	49202
49	Zamora	203	Santa María de la Vega	503	262	241	49203
49	Zamora	204	Santa María de Valverde	99	45	54	49204
49	Zamora	205	Santibáñez de Tera	605	298	307	49205
49	Zamora	206	Santibáñez de Vidriales	1404	695	709	49206
49	Zamora	207	Santovenia	431	205	226	49207
49	Zamora	208	San Vicente de la Cabeza	628	326	302	49208
49	Zamora	209	San Vitero	727	380	347	49209
49	Zamora	210	Sanzoles	707	364	343	49210
49	Zamora	214	Tábara	964	493	471	49214
49	Zamora	216	Tapioles	247	132	115	49216
49	Zamora	219	Toro	9325	4524	4801	49219
49	Zamora	220	Torre del Valle (La)	192	105	87	49220
49	Zamora	221	Torregamones	331	162	169	49221
49	Zamora	222	Torres del Carrizal	521	270	251	49222
49	Zamora	223	Trabazos	949	474	475	49223
49	Zamora	224	Trefacio	240	118	122	49224
49	Zamora	225	Uña de Quintana	231	112	119	49225
49	Zamora	226	Vadillo de la Guareña	378	198	180	49226
49	Zamora	227	Valcabado	360	180	180	49227
49	Zamora	228	Valdefinjas	103	59	44	49228
49	Zamora	229	Valdescorriel	198	105	93	49229
49	Zamora	230	Vallesa de la Guareña	183	100	83	49230
49	Zamora	231	Vega de Tera	523	249	274	49231
49	Zamora	232	Vega de Villalobos	160	70	90	49232
49	Zamora	233	Vegalatrave	150	77	73	49233
49	Zamora	234	Venialbo	544	283	261	49234
49	Zamora	235	Vezdemarbán	700	341	359	49235
49	Zamora	236	Vidayanes	116	56	60	49236
49	Zamora	237	Videmala	205	98	107	49237
49	Zamora	238	Villabrázaro	378	186	192	49238
49	Zamora	239	Villabuena del Puente	987	521	466	49239
49	Zamora	240	Villadepera	278	133	145	49240
49	Zamora	241	Villaescusa	379	193	186	49241
49	Zamora	242	Villafáfila	673	334	339	49242
49	Zamora	243	Villaferrueña	159	81	78	49243
49	Zamora	244	Villageriz	72	39	33	49244
49	Zamora	245	Villalazán	394	192	202	49245
49	Zamora	246	Villalba de la Lampreana	323	168	155	49246
49	Zamora	247	Villalcampo	677	339	338	49247
49	Zamora	248	Villalobos	318	148	170	49248
49	Zamora	249	Villalonso	127	64	63	49249
49	Zamora	250	Villalpando	1731	855	876	49250
49	Zamora	251	Villalube	318	159	159	49251
49	Zamora	252	Villamayor de Campos	557	284	273	49252
49	Zamora	255	Villamor de los Escuderos	587	296	291	49255
49	Zamora	256	Villanázar	382	182	200	49256
49	Zamora	257	Villanueva de Azoague	368	188	180	49257
49	Zamora	258	Villanueva de Campeán	189	94	95	49258
49	Zamora	259	Villanueva de las Peras	191	95	96	49259
49	Zamora	260	Villanueva del Campo	1085	540	545	49260
49	Zamora	261	Villaralbo	1617	813	804	49261
49	Zamora	262	Villardeciervos	514	240	274	49262
49	Zamora	263	Villar de Fallaves	108	56	52	49263
49	Zamora	264	Villar del Buey	864	462	402	49264
49	Zamora	265	Villardiegua de la Ribera	177	86	91	49265
49	Zamora	266	Villárdiga	110	57	53	49266
49	Zamora	267	Villardondiego	131	70	61	49267
49	Zamora	268	Villarrín de Campos	651	343	308	49268
49	Zamora	269	Villaseco del Pan	324	156	168	49269
49	Zamora	270	Villavendimio	203	114	89	49270
49	Zamora	271	Villaveza del Agua	280	146	134	49271
49	Zamora	272	Villaveza de Valverde	148	76	72	49272
49	Zamora	273	Viñas	293	146	147	49273
49	Zamora	275	Zamora	65226	30954	34272	49275
50	Zaragoza	001	Abanto	184	100	84	50001
50	Zaragoza	002	Acered	271	138	133	50002
50	Zaragoza	003	Agón	182	99	83	50003
50	Zaragoza	004	Aguarón	751	372	379	50004
50	Zaragoza	005	Aguilón	276	133	143	50005
50	Zaragoza	006	Ainzón	1228	634	594	50006
50	Zaragoza	007	Aladrén	77	43	34	50007
50	Zaragoza	008	Alagón	5621	2807	2814	50008
50	Zaragoza	009	Alarba	158	88	70	50009
50	Zaragoza	010	Alberite de San Juan	97	55	42	50010
50	Zaragoza	011	Albeta	119	58	61	50011
50	Zaragoza	012	Alborge	141	73	68	50012
50	Zaragoza	013	Alcalá de Ebro	296	139	157	50013
50	Zaragoza	014	Alcalá de Moncayo	147	77	70	50014
50	Zaragoza	015	Alconchel de Ariza	162	87	75	50015
50	Zaragoza	016	Aldehuela de Liestos	58	30	28	50016
50	Zaragoza	017	Alfajarín	1495	759	736	50017
50	Zaragoza	018	Alfamén	1315	699	616	50018
50	Zaragoza	019	Alforque	88	48	40	50019
50	Zaragoza	020	Alhama de Aragón	1178	568	610	50020
50	Zaragoza	021	Almochuel	50	27	23	50021
50	Zaragoza	022	Almolda (La)	691	346	345	50022
50	Zaragoza	023	Almonacid de la Cuba	339	168	171	50023
50	Zaragoza	024	Almonacid de la Sierra	859	448	411	50024
50	Zaragoza	025	Almunia de Doña Godina (La)	5591	2856	2735	50025
50	Zaragoza	026	Alpartir	603	323	280	50026
50	Zaragoza	027	Ambel	357	161	196	50027
50	Zaragoza	028	Anento	107	66	41	50028
50	Zaragoza	029	Aniñón	907	479	428	50029
50	Zaragoza	030	Añón de Moncayo	304	177	127	50030
50	Zaragoza	031	Aranda de Moncayo	247	133	114	50031
50	Zaragoza	032	Arándiga	503	258	245	50032
50	Zaragoza	033	Ardisa	79	44	35	50033
50	Zaragoza	034	Ariza	1334	683	651	50034
50	Zaragoza	035	Artieda	100	57	43	50035
50	Zaragoza	036	Asín	101	51	50	50036
50	Zaragoza	037	Atea	239	134	105	50037
50	Zaragoza	038	Ateca	1986	972	1014	50038
50	Zaragoza	039	Azuara	716	381	335	50039
50	Zaragoza	040	Badules	121	66	55	50040
50	Zaragoza	041	Bagüés	46	24	22	50041
50	Zaragoza	042	Balconchán	26	13	13	50042
50	Zaragoza	043	Bárboles	326	172	154	50043
50	Zaragoza	044	Bardallur	297	143	154	50044
50	Zaragoza	045	Belchite	1643	862	781	50045
50	Zaragoza	046	Belmonte de Gracián	282	151	131	50046
50	Zaragoza	047	Berdejo	49	26	23	50047
50	Zaragoza	048	Berrueco	39	22	17	50048
50	Zaragoza	050	Bijuesca	129	73	56	50050
50	Zaragoza	051	Biota	1222	625	597	50051
50	Zaragoza	052	Bisimbre	128	57	71	50052
50	Zaragoza	053	Boquiñeni	992	499	493	50053
50	Zaragoza	054	Bordalba	100	58	42	50054
50	Zaragoza	055	Borja	4256	2079	2177	50055
50	Zaragoza	056	Botorrita	489	261	228	50056
50	Zaragoza	057	Brea de Aragón	2009	997	1012	50057
50	Zaragoza	058	Bubierca	108	53	55	50058
50	Zaragoza	059	Bujaraloz	986	521	465	50059
50	Zaragoza	060	Bulbuente	263	146	117	50060
50	Zaragoza	061	Bureta	320	159	161	50061
50	Zaragoza	062	Burgo de Ebro (El)	1550	792	758	50062
50	Zaragoza	063	Buste (El)	111	56	55	50063
50	Zaragoza	064	Cabañas de Ebro	550	285	265	50064
50	Zaragoza	065	Cabolafuente	87	50	37	50065
50	Zaragoza	066	Cadrete	1679	895	784	50066
50	Zaragoza	067	Calatayud	17876	8623	9253	50067
50	Zaragoza	068	Calatorao	2725	1413	1312	50068
50	Zaragoza	069	Calcena	90	48	42	50069
50	Zaragoza	070	Calmarza	98	50	48	50070
50	Zaragoza	071	Campillo de Aragón	183	102	81	50071
50	Zaragoza	072	Carenas	220	112	108	50072
50	Zaragoza	073	Cariñena	2875	1477	1398	50073
50	Zaragoza	074	Caspe	7727	3782	3945	50074
50	Zaragoza	075	Castejón de Alarba	116	64	52	50075
50	Zaragoza	076	Castejón de las Armas	135	66	69	50076
50	Zaragoza	077	Castejón de Valdejasa	336	174	162	50077
50	Zaragoza	078	Castiliscar	408	211	197	50078
50	Zaragoza	079	Cervera de la Cañada	341	167	174	50079
50	Zaragoza	080	Cerveruela	14	12	2	50080
50	Zaragoza	081	Cetina	730	359	371	50081
50	Zaragoza	082	Cimballa	165	82	83	50082
50	Zaragoza	083	Cinco Olivas	137	67	70	50083
50	Zaragoza	084	Clarés de Ribota	107	56	51	50084
50	Zaragoza	085	Codo	278	136	142	50085
50	Zaragoza	086	Codos	283	164	119	50086
50	Zaragoza	087	Contamina	59	32	27	50087
50	Zaragoza	088	Cosuenda	415	219	196	50088
50	Zaragoza	089	Cuarte de Huerva	1847	958	889	50089
50	Zaragoza	090	Cubel	237	116	121	50090
50	Zaragoza	091	Cuerlas (Las)	97	48	49	50091
50	Zaragoza	092	Chiprana	377	186	191	50092
50	Zaragoza	093	Chodes	121	58	63	50093
50	Zaragoza	094	Daroca	2286	1148	1138	50094
50	Zaragoza	095	Ejea de los Caballeros	15532	7895	7637	50095
50	Zaragoza	096	Embid de Ariza	70	36	34	50096
50	Zaragoza	098	Encinacorba	304	163	141	50098
50	Zaragoza	099	Épila	3971	2043	1928	50099
50	Zaragoza	100	Erla	466	223	243	50100
50	Zaragoza	101	Escatrón	1282	626	656	50101
50	Zaragoza	102	Fabara	1218	637	581	50102
50	Zaragoza	104	Farlete	461	232	229	50104
50	Zaragoza	105	Fayón	385	204	181	50105
50	Zaragoza	106	Fayos (Los)	191	101	90	50106
50	Zaragoza	107	Figueruelas	1011	511	500	50107
50	Zaragoza	108	Fombuena	19	13	6	50108
50	Zaragoza	109	Frago (El)	122	75	47	50109
50	Zaragoza	110	Frasno (El)	561	299	262	50110
50	Zaragoza	111	Fréscano	252	123	129	50111
50	Zaragoza	113	Fuendejalón	872	437	435	50113
50	Zaragoza	114	Fuendetodos	199	100	99	50114
50	Zaragoza	115	Fuentes de Ebro	3848	1989	1859	50115
50	Zaragoza	116	Fuentes de Jiloca	353	187	166	50116
50	Zaragoza	117	Gallocanta	167	86	81	50117
50	Zaragoza	118	Gallur	2921	1483	1438	50118
50	Zaragoza	119	Gelsa	1253	632	621	50119
50	Zaragoza	120	Godojos	68	33	35	50120
50	Zaragoza	121	Gotor	380	204	176	50121
50	Zaragoza	122	Grisel	70	41	29	50122
50	Zaragoza	123	Grisén	479	243	236	50123
50	Zaragoza	124	Herrera de los Navarros	616	324	292	50124
50	Zaragoza	125	Ibdes	558	285	273	50125
50	Zaragoza	126	Illueca	3295	1614	1681	50126
50	Zaragoza	128	Isuerre	62	38	24	50128
50	Zaragoza	129	Jaraba	321	173	148	50129
50	Zaragoza	130	Jarque	583	314	269	50130
50	Zaragoza	131	Jaulín	300	154	146	50131
50	Zaragoza	132	Joyosa (La)	382	200	182	50132
50	Zaragoza	133	Lagata	140	77	63	50133
50	Zaragoza	134	Langa del Castillo	197	91	106	50134
50	Zaragoza	135	Layana	139	68	71	50135
50	Zaragoza	136	Lécera	837	405	432	50136
50	Zaragoza	137	Leciñena	1367	686	681	50137
50	Zaragoza	138	Lechón	53	32	21	50138
50	Zaragoza	139	Letux	478	242	236	50139
50	Zaragoza	140	Litago	182	100	82	50140
50	Zaragoza	141	Lituénigo	118	57	61	50141
50	Zaragoza	142	Lobera de Onsella	54	32	22	50142
50	Zaragoza	143	Longares	915	501	414	50143
50	Zaragoza	144	Longás	52	32	20	50144
50	Zaragoza	146	Lucena de Jalón	251	127	124	50146
50	Zaragoza	147	Luceni	1056	524	532	50147
50	Zaragoza	148	Luesia	443	230	213	50148
50	Zaragoza	149	Luesma	23	13	10	50149
50	Zaragoza	150	Lumpiaque	917	475	442	50150
50	Zaragoza	151	Luna	928	489	439	50151
50	Zaragoza	152	Maella	1996	1003	993	50152
50	Zaragoza	153	Magallón	1201	650	551	50153
50	Zaragoza	154	Mainar	183	101	82	50154
50	Zaragoza	155	Malanquilla	126	65	61	50155
50	Zaragoza	156	Maleján	296	152	144	50156
50	Zaragoza	157	Malón	455	234	221	50157
50	Zaragoza	159	Maluenda	973	469	504	50159
50	Zaragoza	160	Mallén	2983	1527	1456	50160
50	Zaragoza	161	Manchones	153	75	78	50161
50	Zaragoza	162	Mara	205	103	102	50162
50	Zaragoza	163	María de Huerva	1121	559	562	50163
50	Zaragoza	164	Mediana de Aragón	514	258	256	50164
50	Zaragoza	165	Mequinenza	2478	1235	1243	50165
50	Zaragoza	166	Mesones de Isuela	374	183	191	50166
50	Zaragoza	167	Mezalocha	319	178	141	50167
50	Zaragoza	168	Mianos	45	24	21	50168
50	Zaragoza	169	Miedes de Aragón	512	268	244	50169
50	Zaragoza	170	Monegrillo	534	290	244	50170
50	Zaragoza	171	Moneva	145	71	74	50171
50	Zaragoza	172	Monreal de Ariza	299	155	144	50172
50	Zaragoza	173	Monterde	264	136	128	50173
50	Zaragoza	174	Montón	140	72	68	50174
50	Zaragoza	175	Morata de Jalón	1540	764	776	50175
50	Zaragoza	176	Morata de Jiloca	330	175	155	50176
50	Zaragoza	177	Morés	487	256	231	50177
50	Zaragoza	178	Moros	510	251	259	50178
50	Zaragoza	179	Moyuela	353	184	169	50179
50	Zaragoza	180	Mozota	114	57	57	50180
50	Zaragoza	181	Muel	1123	562	561	50181
50	Zaragoza	182	Muela (La)	1351	708	643	50182
50	Zaragoza	183	Munébrega	463	243	220	50183
50	Zaragoza	184	Murero	149	85	64	50184
50	Zaragoza	185	Murillo de Gállego	133	79	54	50185
50	Zaragoza	186	Navardún	62	32	30	50186
50	Zaragoza	187	Nigüella	122	67	55	50187
50	Zaragoza	188	Nombrevilla	66	39	27	50188
50	Zaragoza	189	Nonaspe	1080	547	533	50189
50	Zaragoza	190	Novallas	731	357	374	50190
50	Zaragoza	191	Novillas	670	343	327	50191
50	Zaragoza	192	Nuévalos	344	197	147	50192
50	Zaragoza	193	Nuez de Ebro	592	313	279	50193
50	Zaragoza	194	Olvés	169	90	79	50194
50	Zaragoza	195	Orcajo	47	24	23	50195
50	Zaragoza	196	Orera	126	63	63	50196
50	Zaragoza	197	Orés	101	60	41	50197
50	Zaragoza	198	Oseja	50	29	21	50198
50	Zaragoza	199	Osera de Ebro	354	170	184	50199
50	Zaragoza	200	Paniza	697	351	346	50200
50	Zaragoza	201	Paracuellos de Jiloca	500	230	270	50201
50	Zaragoza	202	Paracuellos de la Ribera	291	134	157	50202
50	Zaragoza	203	Pastriz	1043	511	532	50203
50	Zaragoza	204	Pedrola	2637	1340	1297	50204
50	Zaragoza	205	Pedrosas (Las)	96	47	49	50205
50	Zaragoza	206	Perdiguera	508	261	247	50206
50	Zaragoza	207	Piedratajada	133	67	66	50207
50	Zaragoza	208	Pina de Ebro	2239	1112	1127	50208
50	Zaragoza	209	Pinseque	1606	805	801	50209
50	Zaragoza	210	Pintanos (Los)	89	45	44	50210
50	Zaragoza	211	Plasencia de Jalón	366	198	168	50211
50	Zaragoza	212	Pleitas	61	37	24	50212
50	Zaragoza	213	Plenas	137	68	69	50213
50	Zaragoza	214	Pomer	27	18	9	50214
50	Zaragoza	215	Pozuel de Ariza	24	16	8	50215
50	Zaragoza	216	Pozuelo de Aragón	339	186	153	50216
50	Zaragoza	217	Pradilla de Ebro	647	338	309	50217
50	Zaragoza	218	Puebla de Albortón	148	80	68	50218
50	Zaragoza	219	Puebla de Alfindén (La)	1907	974	933	50219
50	Zaragoza	220	Puendeluna	60	35	25	50220
50	Zaragoza	221	Purujosa	40	30	10	50221
50	Zaragoza	222	Quinto	2110	1054	1056	50222
50	Zaragoza	223	Remolinos	1244	620	624	50223
50	Zaragoza	224	Retascón	78	44	34	50224
50	Zaragoza	225	Ricla	2083	1120	963	50225
50	Zaragoza	227	Romanos	143	81	62	50227
50	Zaragoza	228	Rueda de Jalón	353	181	172	50228
50	Zaragoza	229	Ruesca	89	46	43	50229
50	Zaragoza	230	Sádaba	1666	835	831	50230
50	Zaragoza	231	Salillas de Jalón	352	186	166	50231
50	Zaragoza	232	Salvatierra de Esca	278	142	136	50232
50	Zaragoza	233	Samper del Salz	142	73	69	50233
50	Zaragoza	234	San Martín de la Virgen de Moncayo	305	161	144	50234
50	Zaragoza	235	San Mateo de Gállego	2137	1096	1041	50235
50	Zaragoza	236	Santa Cruz de Grío	232	128	104	50236
50	Zaragoza	237	Santa Cruz de Moncayo	121	58	63	50237
50	Zaragoza	238	Santa Eulalia de Gállego	127	61	66	50238
50	Zaragoza	239	Santed	80	38	42	50239
50	Zaragoza	240	Sástago	1444	726	718	50240
50	Zaragoza	241	Sabiñán	931	450	481	50241
50	Zaragoza	242	Sediles	102	52	50	50242
50	Zaragoza	243	Sestrica	478	243	235	50243
50	Zaragoza	244	Sierra de Luna	250	127	123	50244
50	Zaragoza	245	Sigüés	187	94	93	50245
50	Zaragoza	246	Sisamón	82	49	33	50246
50	Zaragoza	247	Sobradiel	641	319	322	50247
50	Zaragoza	248	Sos del Rey Católico	774	395	379	50248
50	Zaragoza	249	Tabuenca	480	262	218	50249
50	Zaragoza	250	Talamantes	70	42	28	50250
50	Zaragoza	251	Tarazona	10416	5026	5390	50251
50	Zaragoza	252	Tauste	6932	3454	3478	50252
50	Zaragoza	253	Terrer	625	300	325	50253
50	Zaragoza	254	Tierga	253	141	112	50254
50	Zaragoza	255	Tobed	281	142	139	50255
50	Zaragoza	256	Torralba de los Frailes	105	51	54	50256
50	Zaragoza	257	Torralba de Ribota	220	120	100	50257
50	Zaragoza	258	Torralbilla	76	38	38	50258
50	Zaragoza	259	Torrehermosa	114	62	52	50259
50	Zaragoza	260	Torrelapaja	45	22	23	50260
50	Zaragoza	261	Torrellas	305	154	151	50261
50	Zaragoza	262	Torres de Berrellén	1400	709	691	50262
50	Zaragoza	263	Torrijo de la Cañada	386	211	175	50263
50	Zaragoza	264	Tosos	200	103	97	50264
50	Zaragoza	265	Trasmoz	60	32	28	50265
50	Zaragoza	266	Trasobares	226	118	108	50266
50	Zaragoza	267	Uncastillo	889	435	454	50267
50	Zaragoza	268	Undués de Lerda	48	29	19	50268
50	Zaragoza	269	Urrea de Jalón	334	171	163	50269
50	Zaragoza	270	Urriés	77	45	32	50270
50	Zaragoza	271	Used	383	207	176	50271
50	Zaragoza	272	Utebo	10719	5427	5292	50272
50	Zaragoza	273	Valdehorna	59	30	29	50273
50	Zaragoza	274	Val de San Martín	84	39	45	50274
50	Zaragoza	275	Valmadrid	67	39	28	50275
50	Zaragoza	276	Valpalmas	200	98	102	50276
50	Zaragoza	277	Valtorres	90	43	47	50277
50	Zaragoza	278	Velilla de Ebro	276	134	142	50278
50	Zaragoza	279	Velilla de Jiloca	116	59	57	50279
50	Zaragoza	280	Vera de Moncayo	482	250	232	50280
50	Zaragoza	281	Vierlas	108	55	53	50281
50	Zaragoza	282	Vilueña (La)	101	43	58	50282
50	Zaragoza	283	Villadoz	83	47	36	50283
50	Zaragoza	284	Villafeliche	245	121	124	50284
50	Zaragoza	285	Villafranca de Ebro	680	331	349	50285
50	Zaragoza	286	Villalba de Perejil	114	60	54	50286
50	Zaragoza	287	Villalengua	428	225	203	50287
50	Zaragoza	288	Villanueva de Gállego	3134	1587	1547	50288
50	Zaragoza	289	Villanueva de Jiloca	115	57	58	50289
50	Zaragoza	290	Villanueva de Huerva	598	310	288	50290
50	Zaragoza	291	Villar de los Navarros	175	80	95	50291
50	Zaragoza	292	Villarreal de Huerva	182	100	82	50292
50	Zaragoza	293	Villarroya de la Sierra	683	348	335	50293
50	Zaragoza	294	Villarroya del Campo	86	43	43	50294
50	Zaragoza	295	Vistabella	34	19	15	50295
50	Zaragoza	296	Zaida (La)	596	294	302	50296
50	Zaragoza	297	Zaragoza	604631	290842	313789	50297
50	Zaragoza	298	Zuera	5448	2798	2650	50298
50	Zaragoza	901	Biel	240	133	107	50901
50	Zaragoza	902	Marracos	130	66	64	50902
51	Ceuta	001	Ceuta	75241	38497	36744	51001
52	Melilla	001	Melilla	66263	33976	32287	52001
