CPRO	PROVINCIA	CMUN	cod_ine	NOMBRE	POB00	VARONES	MUJERES	tasa_varones	tasa_mujeres
01	Álava	001	01001	Alegría-Dulantzi	1401	731	670	52.1770164168451	47.8229835831549
01	Álava	002	01002	Amurrio	9720	4839	4881	49.783950617284	50.2160493827161
01	Álava	003	01003	Aramaio	1416	747	669	52.7542372881356	47.2457627118644
01	Álava	004	01004	Artziniega	1338	669	669	50	50
01	Álava	006	01006	Armiñón	146	76	70	52.0547945205479	47.9452054794521
01	Álava	008	01008	Arrazua-Ubarrundia	726	388	338	53.4435261707989	46.5564738292011
01	Álava	009	01009	Asparrena	1578	784	794	49.6831432192649	50.3168567807351
01	Álava	010	01010	Ayala/Aiara	2064	1028	1036	49.8062015503876	50.1937984496124
01	Álava	011	01011	Baños de Ebro/Mañueta	328	181	147	55.1829268292683	44.8170731707317
01	Álava	013	01013	Barrundia	610	342	268	56.0655737704918	43.9344262295082
01	Álava	014	01014	Berantevilla	430	222	208	51.6279069767442	48.3720930232558
01	Álava	016	01016	Bernedo	547	314	233	57.4040219378428	42.5959780621572
01	Álava	017	01017	Campezo/Kanpezu	1060	560	500	52.8301886792453	47.1698113207547
01	Álava	018	01018	Zigoitia	1242	690	552	55.5555555555556	44.4444444444444
01	Álava	019	01019	Kripan	188	99	89	52.6595744680851	47.3404255319149
01	Álava	020	01020	Kuartango	374	211	163	56.4171122994653	43.5828877005348
01	Álava	021	01021	Elburgo/Burgelu	319	174	145	54.5454545454545	45.4545454545455
01	Álava	022	01022	Elciego	925	464	461	50.1621621621622	49.8378378378378
01	Álava	023	01023	Elvillar/Bilar	363	194	169	53.4435261707989	46.5564738292011
01	Álava	027	01027	Iruraiz-Gauna	431	234	197	54.292343387471	45.707656612529
01	Álava	028	01028	Labastida	1243	665	578	53.4995977473854	46.5004022526146
01	Álava	030	01030	Lagrán	202	107	95	52.970297029703	47.029702970297
01	Álava	031	01031	Laguardia	1412	730	682	51.699716713881	48.300283286119
01	Álava	032	01032	Lanciego/Lantziego	652	343	309	52.6073619631902	47.3926380368098
01	Álava	033	01033	Lapuebla de Labarca	865	440	425	50.8670520231214	49.1329479768786
01	Álava	034	01034	Leza	208	114	94	54.8076923076923	45.1923076923077
01	Álava	036	01036	Llodio	19260	9623	9637	49.9636552440291	50.0363447559709
01	Álava	037	01037	Arraia-Maeztu	698	375	323	53.7249283667622	46.2750716332378
01	Álava	039	01039	Moreda de Álava	290	157	133	54.1379310344828	45.8620689655172
01	Álava	041	01041	Navaridas	209	116	93	55.5023923444976	44.4976076555024
01	Álava	042	01042	Okondo	832	426	406	51.2019230769231	48.7980769230769
01	Álava	043	01043	Oyón/Oion	2328	1177	1151	50.5584192439863	49.4415807560138
01	Álava	044	01044	Peñacerrada-Urizaharra	251	137	114	54.5816733067729	45.4183266932271
01	Álava	046	01046	Ribera Alta	543	323	220	59.4843462246777	40.5156537753223
01	Álava	047	01047	Ribera Baja/Erribera Beitia	596	328	268	55.0335570469799	44.9664429530201
01	Álava	049	01049	Añana	190	101	89	53.1578947368421	46.8421052631579
01	Álava	051	01051	Salvatierra o Agurain	4014	1995	2019	49.7010463378176	50.2989536621824
01	Álava	052	01052	Samaniego	312	158	154	50.6410256410256	49.3589743589744
01	Álava	053	01053	San Millán/Donemiliaga	689	377	312	54.7169811320755	45.2830188679245
01	Álava	054	01054	Urkabustaiz	871	477	394	54.7646383467279	45.2353616532721
01	Álava	055	01055	Valdegovía	929	502	427	54.0365984930032	45.9634015069968
01	Álava	056	01056	Harana/Valle de Arana	348	192	156	55.1724137931034	44.8275862068966
01	Álava	057	01057	Villabuena de Álava/Eskuernaga	335	166	169	49.5522388059702	50.4477611940299
01	Álava	058	01058	Legutiano	1377	720	657	52.2875816993464	47.7124183006536
01	Álava	059	01059	Vitoria-Gasteiz	217358	106791	110567	49.1313869284774	50.8686130715226
01	Álava	060	01060	Yécora	265	130	135	49.0566037735849	50.9433962264151
01	Álava	061	01061	Zalduondo	138	75	63	54.3478260869565	45.6521739130435
01	Álava	062	01062	Zambrana	364	196	168	53.8461538461539	46.1538461538462
01	Álava	063	01063	Zuia	1725	878	847	50.8985507246377	49.1014492753623
01	Álava	901	01901	Iruña Oka/Iruña de Oca	1823	958	865	52.5507405375754	47.4492594624246
01	Álava	902	01902	Lantarón	964	545	419	56.5352697095436	43.4647302904564
02	Albacete	001	02001	Abengibre	976	479	497	49.077868852459	50.922131147541
02	Albacete	002	02002	Alatoz	661	345	316	52.1936459909229	47.8063540090772
02	Albacete	003	02003	Albacete	149667	73284	76383	48.9647016376355	51.0352983623644
02	Albacete	004	02004	Albatana	872	435	437	49.8853211009174	50.1146788990826
02	Albacete	005	02005	Alborea	814	422	392	51.8427518427519	48.1572481572482
02	Albacete	006	02006	Alcadozo	776	399	377	51.4175257731959	48.5824742268041
02	Albacete	007	02007	Alcalá del Júcar	1507	774	733	51.3603185136032	48.6396814863968
02	Albacete	008	02008	Alcaraz	1738	833	905	47.9286536248562	52.0713463751438
02	Albacete	009	02009	Almansa	23775	11686	12089	49.1524710830705	50.8475289169296
02	Albacete	010	02010	Alpera	2349	1213	1136	51.6389953171562	48.3610046828438
02	Albacete	011	02011	Ayna	980	497	483	50.7142857142857	49.2857142857143
02	Albacete	012	02012	Balazote	2273	1151	1122	50.6379234491861	49.3620765508139
02	Albacete	013	02013	Balsa de Ves	259	140	119	54.0540540540541	45.945945945946
02	Albacete	014	02014	Ballestero (El)	565	286	279	50.6194690265487	49.3805309734513
02	Albacete	015	02015	Barrax	1938	963	975	49.6904024767802	50.3095975232198
02	Albacete	016	02016	Bienservida	912	467	445	51.2061403508772	48.7938596491228
02	Albacete	017	02017	Bogarra	1296	681	615	52.5462962962963	47.4537037037037
02	Albacete	018	02018	Bonete	1217	615	602	50.5341002465078	49.4658997534922
02	Albacete	019	02019	Bonillo (El)	3260	1649	1611	50.5828220858896	49.4171779141104
02	Albacete	020	02020	Carcelén	673	358	315	53.1946508172363	46.8053491827637
02	Albacete	021	02021	Casas de Juan Núñez	1275	658	617	51.6078431372549	48.3921568627451
02	Albacete	022	02022	Casas de Lázaro	445	243	202	54.6067415730337	45.3932584269663
02	Albacete	023	02023	Casas de Ves	891	465	426	52.1885521885522	47.8114478114478
02	Albacete	024	02024	Casas-Ibáñez	4155	2097	2058	50.4693140794224	49.5306859205776
02	Albacete	025	02025	Caudete	8995	4502	4493	50.0500277932185	49.9499722067815
02	Albacete	026	02026	Cenizate	1076	558	518	51.8587360594796	48.1412639405204
02	Albacete	027	02027	Corral-Rubio	476	244	232	51.2605042016807	48.7394957983193
02	Albacete	028	02028	Cotillas	207	102	105	49.2753623188406	50.7246376811594
02	Albacete	029	02029	Chinchilla de Monte-Aragón	3205	1665	1540	51.9500780031201	48.0499219968799
02	Albacete	030	02030	Elche de la Sierra	3898	1927	1971	49.4356080041047	50.5643919958953
02	Albacete	031	02031	Férez	821	411	410	50.0609013398295	49.9390986601705
02	Albacete	032	02032	Fuensanta	378	199	179	52.6455026455027	47.3544973544974
02	Albacete	033	02033	Fuente-Álamo	2480	1269	1211	51.1693548387097	48.8306451612903
02	Albacete	034	02034	Fuentealbilla	1809	914	895	50.5251520176893	49.4748479823107
02	Albacete	035	02035	Gineta (La)	2043	1000	1043	48.9476260401371	51.052373959863
02	Albacete	036	02036	Golosalvo	112	53	59	47.3214285714286	52.6785714285714
02	Albacete	037	02037	Hellín	26581	13152	13429	49.4789511305068	50.5210488694932
02	Albacete	038	02038	Herrera (La)	411	209	202	50.8515815085158	49.1484184914842
02	Albacete	039	02039	Higueruela	1319	667	652	50.5686125852919	49.4313874147081
02	Albacete	040	02040	Hoya-Gonzalo	791	407	384	51.4538558786346	48.5461441213654
02	Albacete	041	02041	Jorquera	577	311	266	53.8994800693241	46.1005199306759
02	Albacete	042	02042	Letur	1317	642	675	48.74715261959	51.25284738041
02	Albacete	043	02043	Lezuza	1762	923	839	52.383654937571	47.6163450624291
02	Albacete	044	02044	Liétor	1635	843	792	51.5596330275229	48.4403669724771
02	Albacete	045	02045	Madrigueras	4520	2277	2243	50.3761061946903	49.6238938053097
02	Albacete	046	02046	Mahora	1348	666	682	49.406528189911	50.593471810089
02	Albacete	047	02047	Masegoso	160	94	66	58.75	41.25
02	Albacete	048	02048	Minaya	1764	896	868	50.7936507936508	49.2063492063492
02	Albacete	049	02049	Molinicos	1332	684	648	51.3513513513514	48.6486486486487
02	Albacete	050	02050	Montalvos	143	72	71	50.3496503496504	49.6503496503497
02	Albacete	051	02051	Montealegre del Castillo	2160	1080	1080	50	50
02	Albacete	052	02052	Motilleja	508	249	259	49.0157480314961	50.9842519685039
02	Albacete	053	02053	Munera	4031	2035	1996	50.4837509302902	49.5162490697098
02	Albacete	054	02054	Navas de Jorquera	545	277	268	50.8256880733945	49.1743119266055
02	Albacete	055	02055	Nerpio	1763	945	818	53.6018150879183	46.3981849120817
02	Albacete	056	02056	Ontur	2416	1190	1226	49.2549668874172	50.7450331125828
02	Albacete	057	02057	Ossa de Montiel	2774	1371	1403	49.4232155731795	50.5767844268205
02	Albacete	058	02058	Paterna del Madera	538	281	257	52.2304832713755	47.7695167286245
02	Albacete	059	02059	Peñascosa	401	206	195	51.3715710723192	48.6284289276808
02	Albacete	060	02060	Peñas de San Pedro	1230	644	586	52.3577235772358	47.6422764227642
02	Albacete	061	02061	Pétrola	937	479	458	51.1205976520811	48.8794023479189
02	Albacete	062	02062	Povedilla	719	378	341	52.5730180806676	47.4269819193324
02	Albacete	063	02063	Pozohondo	1860	956	904	51.3978494623656	48.6021505376344
02	Albacete	064	02064	Pozo-Lorente	524	260	264	49.618320610687	50.381679389313
02	Albacete	065	02065	Pozuelo	708	372	336	52.5423728813559	47.4576271186441
02	Albacete	066	02066	Recueja (La)	340	169	171	49.7058823529412	50.2941176470588
02	Albacete	067	02067	Riópar	1511	769	742	50.8934480476506	49.1065519523494
02	Albacete	068	02068	Robledo	413	218	195	52.7845036319613	47.2154963680387
02	Albacete	069	02069	Roda (La)	13651	6819	6832	49.9523844407003	50.0476155592997
02	Albacete	070	02070	Salobre	604	303	301	50.1655629139073	49.8344370860927
02	Albacete	071	02071	San Pedro	1344	686	658	51.0416666666667	48.9583333333333
02	Albacete	072	02072	Socovos	2021	1040	981	51.4596734289956	48.5403265710045
02	Albacete	073	02073	Tarazona de la Mancha	6074	3015	3059	49.6378004609812	50.3621995390188
02	Albacete	074	02074	Tobarra	7485	3755	3730	50.1670006680027	49.8329993319973
02	Albacete	075	02075	Valdeganga	1966	984	982	50.0508646998983	49.9491353001017
02	Albacete	076	02076	Vianos	505	244	261	48.3168316831683	51.6831683168317
02	Albacete	077	02077	Villa de Ves	68	32	36	47.0588235294118	52.9411764705882
02	Albacete	078	02078	Villalgordo del Júcar	1295	645	650	49.8069498069498	50.1930501930502
02	Albacete	079	02079	Villamalea	3515	1799	1716	51.1806543385491	48.8193456614509
02	Albacete	080	02080	Villapalacios	828	418	410	50.4830917874396	49.5169082125604
02	Albacete	081	02081	Villarrobledo	22276	10879	11397	48.837313700844	51.162686299156
02	Albacete	082	02082	Villatoya	191	100	91	52.3560209424084	47.6439790575916
02	Albacete	083	02083	Villavaliente	282	149	133	52.8368794326241	47.1631205673759
02	Albacete	084	02084	Villaverde de Guadalimar	528	276	252	52.2727272727273	47.7272727272727
02	Albacete	085	02085	Viveros	538	290	248	53.9033457249071	46.0966542750929
02	Albacete	086	02086	Yeste	4280	2171	2109	50.7242990654206	49.2757009345794
03	Alicante/Alacant	001	03001	Adsubia	547	280	267	51.1882998171846	48.8117001828154
03	Alicante/Alacant	002	03002	Agost	4095	2037	2058	49.7435897435897	50.2564102564103
03	Alicante/Alacant	003	03003	Agres	639	340	299	53.20813771518	46.79186228482
03	Alicante/Alacant	004	03004	Aigües	581	299	282	51.4629948364888	48.5370051635112
03	Alicante/Alacant	005	03005	Albatera	8811	4447	4364	50.4710021563954	49.5289978436046
03	Alicante/Alacant	006	03006	Alcalalí	981	503	478	51.2742099898063	48.7257900101937
03	Alicante/Alacant	007	03007	Alcocer de Planes	129	54	75	41.8604651162791	58.1395348837209
03	Alicante/Alacant	008	03008	Alcoleja	257	123	134	47.8599221789883	52.1400778210117
03	Alicante/Alacant	009	03009	Alcoy/Alcoi	60423	29138	31285	48.2233586548169	51.7766413451831
03	Alicante/Alacant	010	03010	Alfafara	394	188	206	47.7157360406091	52.2842639593909
03	Alicante/Alacant	011	03011	Alfàs del Pi (l')	14139	6865	7274	48.5536459438433	51.4463540561567
03	Alicante/Alacant	012	03012	Algorfa	1243	628	615	50.5229283990346	49.4770716009654
03	Alicante/Alacant	013	03013	Algueña	1447	715	732	49.4125777470629	50.5874222529371
03	Alicante/Alacant	014	03014	Alicante/Alacant	276886	132771	144115	47.9515035068584	52.0484964931416
03	Alicante/Alacant	015	03015	Almoradí	13807	6944	6863	50.2933294705584	49.7066705294416
03	Alicante/Alacant	016	03016	Almudaina	117	61	56	52.1367521367522	47.8632478632479
03	Alicante/Alacant	017	03017	Alqueria d'Asnar (l')	418	204	214	48.8038277511962	51.1961722488038
03	Alicante/Alacant	018	03018	Altea	15579	7661	7918	49.175171705501	50.824828294499
03	Alicante/Alacant	019	03019	Aspe	16593	8277	8316	49.8824805640933	50.1175194359067
03	Alicante/Alacant	020	03020	Balones	183	87	96	47.5409836065574	52.4590163934426
03	Alicante/Alacant	021	03021	Banyeres de Mariola	6906	3430	3476	49.6669562699102	50.3330437300898
03	Alicante/Alacant	022	03022	Benasau	189	94	95	49.7354497354497	50.2645502645503
03	Alicante/Alacant	023	03023	Beneixama	1795	895	900	49.8607242339833	50.1392757660167
03	Alicante/Alacant	024	03024	Benejúzar	4942	2441	2501	49.3929583164711	50.6070416835289
03	Alicante/Alacant	025	03025	Benferri	1055	550	505	52.132701421801	47.8672985781991
03	Alicante/Alacant	026	03026	Beniarbeig	1172	578	594	49.3174061433447	50.6825938566553
03	Alicante/Alacant	027	03027	Beniardá	205	98	107	47.8048780487805	52.1951219512195
03	Alicante/Alacant	028	03028	Beniarrés	1397	698	699	49.9642090193271	50.0357909806729
03	Alicante/Alacant	029	03029	Benichembla	392	200	192	51.0204081632653	48.9795918367347
03	Alicante/Alacant	030	03030	Benidoleig	860	420	440	48.8372093023256	51.1627906976744
03	Alicante/Alacant	031	03031	Benidorm	54321	26627	27694	49.0178752232102	50.9821247767898
03	Alicante/Alacant	032	03032	Benifallim	148	68	80	45.945945945946	54.0540540540541
03	Alicante/Alacant	033	03033	Benifato	148	72	76	48.6486486486487	51.3513513513514
03	Alicante/Alacant	034	03034	Benijófar	1866	917	949	49.1425509110397	50.8574490889603
03	Alicante/Alacant	035	03035	Benilloba	922	467	455	50.6507592190889	49.3492407809111
03	Alicante/Alacant	036	03036	Benillup	93	47	46	50.5376344086022	49.4623655913979
03	Alicante/Alacant	037	03037	Benimantell	415	200	215	48.1927710843374	51.8072289156626
03	Alicante/Alacant	038	03038	Benimarfull	410	190	220	46.3414634146342	53.6585365853659
03	Alicante/Alacant	039	03039	Benimassot	173	89	84	51.4450867052023	48.5549132947977
03	Alicante/Alacant	040	03040	Benimeli	326	162	164	49.6932515337423	50.3067484662577
03	Alicante/Alacant	041	03041	Benissa	10078	4984	5094	49.4542567969835	50.5457432030165
03	Alicante/Alacant	042	03042	Benitachell/Poble Nou de Benitatxell (el)	2312	1178	1134	50.9515570934256	49.0484429065744
03	Alicante/Alacant	043	03043	Biar	3562	1733	1829	48.6524424480629	51.3475575519371
03	Alicante/Alacant	044	03044	Bigastro	4910	2467	2443	50.2443991853361	49.755600814664
03	Alicante/Alacant	045	03045	Bolulla	324	154	170	47.5308641975309	52.4691358024691
03	Alicante/Alacant	046	03046	Busot	1717	872	845	50.7862550960978	49.2137449039022
03	Alicante/Alacant	047	03047	Calpe/Calp	16733	8392	8341	50.1523934739736	49.8476065260264
03	Alicante/Alacant	048	03048	Callosa d'En Sarrià	6488	3239	3249	49.922934648582	50.077065351418
03	Alicante/Alacant	049	03049	Callosa de Segura	15409	7695	7714	49.9383477188656	50.0616522811344
03	Alicante/Alacant	050	03050	Campello (el)	18366	9103	9263	49.5644125013612	50.4355874986388
03	Alicante/Alacant	051	03051	Campo de Mirra/Camp de Mirra (el)	397	195	202	49.1183879093199	50.8816120906801
03	Alicante/Alacant	052	03052	Cañada	1132	534	598	47.1731448763251	52.8268551236749
03	Alicante/Alacant	053	03053	Castalla	7631	3792	3839	49.6920456034596	50.3079543965404
03	Alicante/Alacant	054	03054	Castell de Castells	466	228	238	48.9270386266094	51.0729613733906
03	Alicante/Alacant	055	03055	Catral	5012	2496	2516	49.8004788507582	50.1995211492418
03	Alicante/Alacant	056	03056	Cocentaina	10468	5123	5345	48.9396255254108	51.0603744745892
03	Alicante/Alacant	057	03057	Confrides	325	185	140	56.9230769230769	43.0769230769231
03	Alicante/Alacant	058	03058	Cox	5825	2967	2858	50.9356223175966	49.0643776824034
03	Alicante/Alacant	059	03059	Crevillente	24690	12415	12275	50.2835155933576	49.7164844066424
03	Alicante/Alacant	060	03060	Quatretondeta	179	91	88	50.8379888268156	49.1620111731844
03	Alicante/Alacant	061	03061	Daya Nueva	1193	621	572	52.0536462699078	47.9463537300922
03	Alicante/Alacant	062	03062	Daya Vieja	190	98	92	51.5789473684211	48.421052631579
03	Alicante/Alacant	063	03063	Dénia	30693	15013	15680	48.9134330303327	51.0865669696674
03	Alicante/Alacant	064	03064	Dolores	6276	3209	3067	51.1312938177183	48.8687061822817
03	Alicante/Alacant	065	03065	Elche/Elx	195791	96779	99012	49.4297490691605	50.5702509308395
03	Alicante/Alacant	066	03066	Elda	51501	25085	26416	48.7077920817072	51.2922079182929
03	Alicante/Alacant	067	03067	Facheca	134	68	66	50.7462686567164	49.2537313432836
03	Alicante/Alacant	068	03068	Famorca	63	30	33	47.6190476190476	52.3809523809524
03	Alicante/Alacant	069	03069	Finestrat	2169	1080	1089	49.792531120332	50.2074688796681
03	Alicante/Alacant	070	03070	Formentera del Segura	2093	1018	1075	48.6383182035356	51.3616817964644
03	Alicante/Alacant	071	03071	Gata de Gorgos	5032	2501	2531	49.7019077901431	50.2980922098569
03	Alicante/Alacant	072	03072	Gaianes	298	134	164	44.9664429530201	55.0335570469799
03	Alicante/Alacant	073	03073	Gorga	265	137	128	51.6981132075472	48.3018867924528
03	Alicante/Alacant	074	03074	Granja de Rocamora	1963	979	984	49.872643912379	50.127356087621
03	Alicante/Alacant	075	03075	Guadalest	181	92	89	50.828729281768	49.171270718232
03	Alicante/Alacant	076	03076	Guardamar del Segura	9326	4636	4690	49.7104868110658	50.2895131889342
03	Alicante/Alacant	077	03077	Hondón de las Nieves	1611	794	817	49.2861576660459	50.7138423339541
03	Alicante/Alacant	078	03078	Hondón de los Frailes	563	288	275	51.1545293072824	48.8454706927176
03	Alicante/Alacant	079	03079	Ibi	21293	10552	10741	49.5561921758324	50.4438078241676
03	Alicante/Alacant	080	03080	Jacarilla	1556	780	776	50.1285347043702	49.8714652956298
03	Alicante/Alacant	081	03081	Jalón/Xaló	2086	1031	1055	49.424736337488	50.575263662512
03	Alicante/Alacant	082	03082	Jávea/Xàbia	23133	11454	11679	49.5136817533394	50.4863182466606
03	Alicante/Alacant	083	03083	Jijona/Xixona	7337	3440	3897	46.8856480850484	53.1143519149516
03	Alicante/Alacant	084	03084	Lorcha/Orxa (l')	788	396	392	50.253807106599	49.746192893401
03	Alicante/Alacant	085	03085	Llíber	550	276	274	50.1818181818182	49.8181818181818
03	Alicante/Alacant	086	03086	Millena	182	88	94	48.3516483516484	51.6483516483517
03	Alicante/Alacant	088	03088	Monforte del Cid	5260	2708	2552	51.4828897338403	48.5171102661597
03	Alicante/Alacant	089	03089	Monóvar/Monòver	11922	5853	6069	49.0941117262204	50.9058882737796
03	Alicante/Alacant	090	03090	Mutxamel	14693	7320	7373	49.8196420063976	50.1803579936024
03	Alicante/Alacant	091	03091	Murla	333	138	195	41.4414414414414	58.5585585585586
03	Alicante/Alacant	092	03092	Muro de Alcoy	7252	3572	3680	49.2553778268064	50.7446221731936
03	Alicante/Alacant	093	03093	Novelda	23830	11768	12062	49.3831305077633	50.6168694922367
03	Alicante/Alacant	094	03094	Nucia (la)	8616	4282	4334	49.6982358402971	50.3017641597029
03	Alicante/Alacant	095	03095	Ondara	5310	2661	2649	50.1129943502825	49.8870056497175
03	Alicante/Alacant	096	03096	Onil	6829	3405	3424	49.8608873920047	50.1391126079953
03	Alicante/Alacant	097	03097	Orba	1659	807	852	48.6437613019892	51.3562386980109
03	Alicante/Alacant	098	03098	Orxeta	427	214	213	50.1170960187354	49.8829039812646
03	Alicante/Alacant	099	03099	Orihuela	53478	26516	26962	49.5830060959647	50.4169939040353
03	Alicante/Alacant	100	03100	Parcent	857	426	431	49.708284714119	50.291715285881
03	Alicante/Alacant	101	03101	Pedreguer	5952	2917	3035	49.0087365591398	50.9912634408602
03	Alicante/Alacant	102	03102	Pego	10103	5146	4957	50.9353657329506	49.0646342670494
03	Alicante/Alacant	103	03103	Penàguila	391	192	199	49.1048593350384	50.8951406649616
03	Alicante/Alacant	104	03104	Petrer	28765	14359	14406	49.9183034938293	50.0816965061707
03	Alicante/Alacant	105	03105	Pinoso	6186	3058	3128	49.4342062722276	50.5657937277724
03	Alicante/Alacant	106	03106	Planes	815	404	411	49.5705521472393	50.4294478527607
03	Alicante/Alacant	107	03107	Polop	2136	1037	1099	48.5486891385768	51.4513108614232
03	Alicante/Alacant	109	03109	Rafal	3201	1590	1611	49.6719775070291	50.3280224929709
03	Alicante/Alacant	110	03110	Ràfol d'Almúnia. el	402	198	204	49.2537313432836	50.7462686567164
03	Alicante/Alacant	111	03111	Redován	5450	2798	2652	51.3394495412844	48.6605504587156
03	Alicante/Alacant	112	03112	Relleu	795	396	399	49.811320754717	50.188679245283
03	Alicante/Alacant	113	03113	Rojales	7321	3585	3736	48.9687201202022	51.0312798797978
03	Alicante/Alacant	114	03114	Romana (la)	1995	1000	995	50.125313283208	49.874686716792
03	Alicante/Alacant	115	03115	Sagra	399	197	202	49.3734335839599	50.6265664160401
03	Alicante/Alacant	116	03116	Salinas	1215	615	600	50.6172839506173	49.3827160493827
03	Alicante/Alacant	117	03117	Sanet y Negrals	547	249	298	45.5210237659964	54.4789762340037
03	Alicante/Alacant	118	03118	San Fulgencio	3706	1858	1848	50.1349163518619	49.8650836481382
03	Alicante/Alacant	119	03119	San Juan de Alicante	16895	8257	8638	48.8724474696656	51.1275525303344
03	Alicante/Alacant	120	03120	San Miguel de Salinas	3893	1981	1912	50.8862060107886	49.1137939892114
03	Alicante/Alacant	121	03121	Santa Pola	18922	9416	9506	49.76218158757	50.23781841243
03	Alicante/Alacant	122	03122	San Vicente del Raspeig/Sant Vicent del Raspeig	37883	18836	19047	49.7215109679804	50.2784890320196
03	Alicante/Alacant	123	03123	Sax	8625	4331	4294	50.2144927536232	49.7855072463768
03	Alicante/Alacant	124	03124	Sella	591	298	293	50.4230118443317	49.5769881556684
03	Alicante/Alacant	125	03125	Senija	509	261	248	51.2770137524558	48.7229862475442
03	Alicante/Alacant	127	03127	Tárbena	693	347	346	50.0721500721501	49.9278499278499
03	Alicante/Alacant	128	03128	Teulada	9328	4616	4712	49.4854202401372	50.5145797598628
03	Alicante/Alacant	129	03129	Tibi	1205	625	580	51.8672199170125	48.1327800829876
03	Alicante/Alacant	130	03130	Tollos	42	26	16	61.9047619047619	38.0952380952381
03	Alicante/Alacant	131	03131	Tormos	303	146	157	48.1848184818482	51.8151815181518
03	Alicante/Alacant	132	03132	Torremanzanas/Torre de les Maçanes (la)	720	363	357	50.4166666666667	49.5833333333333
03	Alicante/Alacant	133	03133	Torrevieja	50189	24782	25407	49.3773536033792	50.6226463966208
03	Alicante/Alacant	134	03134	Vall d'Alcalà (la)	181	92	89	50.828729281768	49.171270718232
03	Alicante/Alacant	135	03135	Vall de Ebo	355	176	179	49.5774647887324	50.4225352112676
03	Alicante/Alacant	136	03136	Vall de Gallinera	578	304	274	52.5951557093426	47.4048442906574
03	Alicante/Alacant	137	03137	Vall de Laguart	912	427	485	46.8201754385965	53.1798245614035
03	Alicante/Alacant	138	03138	Verger (el)	3642	1753	1889	48.1328940142779	51.8671059857221
03	Alicante/Alacant	139	03139	Villajoyosa/Vila Joiosa (la)	23704	11688	12016	49.3081336483294	50.6918663516706
03	Alicante/Alacant	140	03140	Villena	31760	15680	16080	49.3702770780856	50.6297229219144
03	Alicante/Alacant	901	03901	Poblets (els)	1688	813	875	48.1635071090047	51.8364928909953
03	Alicante/Alacant	902	03902	Pilar de la Horadada	11495	6136	5359	53.3797303175294	46.6202696824706
03	Alicante/Alacant	903	03903	Montesinos (Los)	2617	1328	1289	50.7451280091708	49.2548719908292
03	Alicante/Alacant	904	03904	San Isidro	1274	658	616	51.6483516483517	48.3516483516484
04	Almería	001	04001	Abla	1516	743	773	49.0105540897098	50.9894459102902
04	Almería	002	04002	Abrucena	1455	716	739	49.2096219931271	50.7903780068729
04	Almería	003	04003	Adra	21505	10784	10721	50.1464775633574	49.8535224366426
04	Almería	004	04004	Albánchez	586	292	294	49.8293515358362	50.1706484641638
04	Almería	005	04005	Alboloduy	812	386	426	47.5369458128079	52.4630541871921
04	Almería	006	04006	Albox	9599	4801	4798	50.0156266277737	49.9843733722263
04	Almería	007	04007	Alcolea	903	455	448	50.3875968992248	49.6124031007752
04	Almería	008	04008	Alcóntar	656	341	315	51.9817073170732	48.0182926829268
04	Almería	009	04009	Alcudia de Monteagud	209	102	107	48.8038277511962	51.1961722488038
04	Almería	010	04010	Alhabia	672	327	345	48.6607142857143	51.3392857142857
04	Almería	011	04011	Alhama de Almería	3165	1580	1585	49.9210110584518	50.0789889415482
04	Almería	012	04012	Alicún	236	114	122	48.3050847457627	51.6949152542373
04	Almería	013	04013	Almería	168945	81981	86964	48.5252596999023	51.4747403000977
04	Almería	014	04014	Almócita	175	90	85	51.4285714285714	48.5714285714286
04	Almería	015	04015	Alsodux	104	53	51	50.9615384615385	49.0384615384615
04	Almería	016	04016	Antas	2729	1352	1377	49.5419567607182	50.4580432392818
04	Almería	017	04017	Arboleas	1540	767	773	49.8051948051948	50.1948051948052
04	Almería	018	04018	Armuña de Almanzora	322	159	163	49.3788819875776	50.6211180124224
04	Almería	019	04019	Bacares	291	151	140	51.8900343642612	48.1099656357388
04	Almería	020	04020	Bayárcal	320	171	149	53.4375	46.5625
04	Almería	021	04021	Bayarque	238	115	123	48.3193277310924	51.6806722689076
04	Almería	022	04022	Bédar	572	300	272	52.4475524475525	47.5524475524476
04	Almería	023	04023	Beires	142	69	73	48.5915492957747	51.4084507042254
04	Almería	024	04024	Benahadux	2814	1348	1466	47.9033404406539	52.0966595593461
04	Almería	026	04026	Benitagla	92	50	42	54.3478260869565	45.6521739130435
04	Almería	027	04027	Benizalón	304	158	146	51.9736842105263	48.0263157894737
04	Almería	028	04028	Bentarique	317	167	150	52.6813880126183	47.3186119873817
04	Almería	029	04029	Berja	13279	6409	6870	48.2641765193162	51.7358234806838
04	Almería	030	04030	Canjáyar	1667	851	816	51.0497900419916	48.9502099580084
04	Almería	031	04031	Cantoria	3147	1576	1571	50.07944073721	49.92055926279
04	Almería	032	04032	Carboneras	6530	3340	3190	51.1485451761103	48.8514548238897
04	Almería	033	04033	Castro de Filabres	170	83	87	48.8235294117647	51.1764705882353
04	Almería	034	04034	Cóbdar	227	115	112	50.6607929515419	49.3392070484582
04	Almería	035	04035	Cuevas del Almanzora	9645	4834	4811	50.1192327630897	49.8807672369103
04	Almería	036	04036	Chercos	300	160	140	53.3333333333333	46.6666666666667
04	Almería	037	04037	Chirivel	1792	890	902	49.6651785714286	50.3348214285714
04	Almería	038	04038	Dalías	3634	1789	1845	49.2294991744634	50.7705008255366
04	Almería	041	04041	Enix	289	154	135	53.2871972318339	46.7128027681661
04	Almería	043	04043	Felix	571	290	281	50.7880910683012	49.2119089316988
04	Almería	044	04044	Fines	1741	891	850	51.1774842044802	48.8225157955198
04	Almería	045	04045	Fiñana	2537	1242	1295	48.955459203784	51.044540796216
04	Almería	046	04046	Fondón	943	486	457	51.5376458112407	48.4623541887593
04	Almería	047	04047	Gádor	2593	1299	1294	50.0964134207482	49.9035865792518
04	Almería	048	04048	Gallardos (Los)	1798	914	884	50.8342602892102	49.1657397107898
04	Almería	049	04049	Garrucha	5292	2702	2590	51.0582010582011	48.9417989417989
04	Almería	050	04050	Gérgal	1059	531	528	50.1416430594901	49.8583569405099
04	Almería	051	04051	Huécija	558	280	278	50.179211469534	49.820788530466
04	Almería	052	04052	Huércal de Almería	6766	3411	3355	50.4138338752587	49.5861661247414
04	Almería	053	04053	Huércal-Overa	13999	6878	7121	49.1320808629188	50.8679191370812
04	Almería	054	04054	Illar	474	229	245	48.3122362869198	51.6877637130802
04	Almería	055	04055	Instinción	538	259	279	48.1412639405204	51.8587360594796
04	Almería	056	04056	Laroya	107	55	52	51.4018691588785	48.5981308411215
04	Almería	057	04057	Láujar de Andarax	1833	896	937	48.8816148390617	51.1183851609384
04	Almería	058	04058	Líjar	509	255	254	50.098231827112	49.901768172888
04	Almería	059	04059	Lubrín	1707	812	895	47.568834212068	52.431165787932
04	Almería	060	04060	Lucainena de las Torres	656	330	326	50.3048780487805	49.6951219512195
04	Almería	061	04061	Lúcar	767	375	392	48.8917861799218	51.1082138200782
04	Almería	062	04062	Macael	5767	2920	2847	50.6329113924051	49.3670886075949
04	Almería	063	04063	María	1654	850	804	51.3905683192261	48.6094316807739
04	Almería	064	04064	Mojácar	4825	2389	2436	49.5129533678757	50.4870466321244
04	Almería	065	04065	Nacimiento	515	258	257	50.0970873786408	49.9029126213592
04	Almería	066	04066	Níjar	16269	8549	7720	52.547790275985	47.452209724015
04	Almería	067	04067	Ohanes	765	384	381	50.1960784313726	49.8039215686275
04	Almería	068	04068	Olula de Castro	192	100	92	52.0833333333333	47.9166666666667
04	Almería	069	04069	Olula del Río	5927	2941	2986	49.6203813058883	50.3796186941117
04	Almería	070	04070	Oria	2129	1082	1047	50.8219821512447	49.1780178487553
04	Almería	071	04071	Padules	481	243	238	50.5197505197505	49.4802494802495
04	Almería	072	04072	Partaloa	384	188	196	48.9583333333333	51.0416666666667
04	Almería	073	04073	Paterna del Río	393	203	190	51.6539440203562	48.3460559796438
04	Almería	074	04074	Pechina	2763	1410	1353	51.0314875135722	48.9685124864278
04	Almería	075	04075	Pulpí	5477	2693	2784	49.1692532408253	50.8307467591747
04	Almería	076	04076	Purchena	1600	783	817	48.9375	51.0625
04	Almería	077	04077	Rágol	390	174	216	44.6153846153846	55.3846153846154
04	Almería	078	04078	Rioja	1191	590	601	49.5382031905961	50.4617968094039
04	Almería	079	04079	Roquetas de Mar	44370	22866	21504	51.5348208248817	48.4651791751183
04	Almería	080	04080	Santa Cruz de Marchena	208	93	115	44.7115384615385	55.2884615384615
04	Almería	081	04081	Santa Fe de Mondújar	473	235	238	49.6828752642706	50.3171247357294
04	Almería	082	04082	Senés	325	165	160	50.7692307692308	49.2307692307692
04	Almería	083	04083	Serón	2555	1241	1314	48.5714285714286	51.4285714285714
04	Almería	084	04084	Sierro	471	233	238	49.4692144373673	50.5307855626327
04	Almería	085	04085	Somontín	509	247	262	48.5265225933202	51.4734774066798
04	Almería	086	04086	Sorbas	2693	1364	1329	50.6498329001114	49.3501670998886
04	Almería	087	04087	Suflí	256	133	123	51.953125	48.046875
04	Almería	088	04088	Tabernas	3210	1618	1592	50.404984423676	49.595015576324
04	Almería	089	04089	Taberno	974	478	496	49.0759753593429	50.9240246406571
04	Almería	090	04090	Tahal	407	215	192	52.8255528255528	47.1744471744472
04	Almería	091	04091	Terque	430	218	212	50.6976744186047	49.3023255813954
04	Almería	092	04092	Tíjola	3757	1845	1912	49.1083311152515	50.8916688847485
04	Almería	093	04093	Turre	2331	1149	1182	49.2921492921493	50.7078507078507
04	Almería	094	04094	Turrillas	250	131	119	52.4	47.6
04	Almería	095	04095	Uleila del Campo	977	502	475	51.381780962129	48.618219037871
04	Almería	096	04096	Urrácal	349	168	181	48.1375358166189	51.8624641833811
04	Almería	097	04097	Velefique	314	160	154	50.9554140127389	49.0445859872611
04	Almería	098	04098	Vélez-Blanco	2061	1060	1001	51.4313440077632	48.5686559922368
04	Almería	099	04099	Vélez-Rubio	6519	3141	3378	48.1822365393465	51.8177634606535
04	Almería	100	04100	Vera	6930	3475	3455	50.1443001443001	49.8556998556999
04	Almería	101	04101	Viator	3567	1749	1818	49.0328006728343	50.9671993271657
04	Almería	102	04102	Vícar	15940	8490	7450	53.2622333751568	46.7377666248432
04	Almería	103	04103	Zurgena	2079	1015	1064	48.8215488215488	51.1784511784512
04	Almería	901	04901	Tres Villas (Las)	607	317	290	52.2240527182866	47.7759472817133
04	Almería	902	04902	Ejido (El)	53008	27910	25098	52.6524298219137	47.3475701780863
04	Almería	903	04903	Mojonera (La)	6590	3501	3089	53.1259484066768	46.8740515933232
05	Ávila	001	05001	Adanero	341	189	152	55.425219941349	44.574780058651
05	Ávila	002	05002	Adrada (La)	1958	1009	949	51.5321756894791	48.4678243105209
05	Ávila	005	05005	Albornos	247	138	109	55.8704453441296	44.1295546558704
05	Ávila	007	05007	Aldeanueva de Santa Cruz	193	101	92	52.3316062176166	47.6683937823834
05	Ávila	008	05008	Aldeaseca	337	170	167	50.4451038575668	49.5548961424332
05	Ávila	010	05010	Aldehuela (La)	275	136	139	49.4545454545455	50.5454545454546
05	Ávila	012	05012	Amavida	198	102	96	51.5151515151515	48.4848484848485
05	Ávila	013	05013	Arenal (El)	1056	510	546	48.2954545454546	51.7045454545455
05	Ávila	014	05014	Arenas de San Pedro	6464	3186	3278	49.2883663366337	50.7116336633663
05	Ávila	015	05015	Arevalillo	135	66	69	48.8888888888889	51.1111111111111
05	Ávila	016	05016	Arévalo	7446	3594	3852	48.2675261885576	51.7324738114424
05	Ávila	017	05017	Aveinte	134	72	62	53.7313432835821	46.2686567164179
05	Ávila	018	05018	Avellaneda	37	18	19	48.6486486486487	51.3513513513514
05	Ávila	019	05019	Ávila	47843	22996	24847	48.0655477290304	51.9344522709696
05	Ávila	021	05021	Barco de Ávila (El)	2606	1276	1330	48.9639293937068	51.0360706062932
05	Ávila	022	05022	Barraco (El)	2047	1033	1014	50.4640937957987	49.5359062042013
05	Ávila	023	05023	Barromán	257	144	113	56.0311284046693	43.9688715953307
05	Ávila	024	05024	Becedas	416	218	198	52.4038461538462	47.5961538461539
05	Ávila	025	05025	Becedillas	159	84	75	52.8301886792453	47.1698113207547
05	Ávila	026	05026	Bercial de Zapardiel	321	153	168	47.6635514018692	52.3364485981308
05	Ávila	027	05027	Berlanas (Las)	336	172	164	51.1904761904762	48.8095238095238
05	Ávila	029	05029	Bernuy-Zapardiel	223	127	96	56.9506726457399	43.0493273542601
05	Ávila	030	05030	Berrocalejo de Aragona	48	28	20	58.3333333333333	41.6666666666667
05	Ávila	033	05033	Blascomillán	289	139	150	48.0968858131488	51.9031141868512
05	Ávila	034	05034	Blasconuño de Matacabras	18	10	8	55.5555555555556	44.4444444444444
05	Ávila	035	05035	Blascosancho	161	79	82	49.0683229813665	50.9316770186335
05	Ávila	036	05036	Bohodón (El)	199	102	97	51.2562814070352	48.7437185929648
05	Ávila	037	05037	Bohoyo	452	227	225	50.2212389380531	49.7787610619469
05	Ávila	038	05038	Bonilla de la Sierra	195	106	89	54.3589743589744	45.6410256410256
05	Ávila	039	05039	Brabos	71	40	31	56.3380281690141	43.6619718309859
05	Ávila	040	05040	Bularros	115	63	52	54.7826086956522	45.2173913043478
05	Ávila	041	05041	Burgohondo	1200	615	585	51.25	48.75
05	Ávila	042	05042	Cabezas de Alambre	221	116	105	52.4886877828054	47.5113122171946
05	Ávila	043	05043	Cabezas del Pozo	159	83	76	52.2012578616352	47.7987421383648
05	Ávila	044	05044	Cabezas del Villar	497	255	242	51.307847082495	48.692152917505
05	Ávila	045	05045	Cabizuela	150	76	74	50.6666666666667	49.3333333333333
05	Ávila	046	05046	Canales	64	34	30	53.125	46.875
05	Ávila	047	05047	Candeleda	5115	2632	2483	51.4565004887586	48.5434995112414
05	Ávila	048	05048	Cantiveros	188	95	93	50.531914893617	49.468085106383
05	Ávila	049	05049	Cardeñosa	567	301	266	53.0864197530864	46.9135802469136
05	Ávila	051	05051	Carrera (La)	283	138	145	48.7632508833922	51.2367491166078
05	Ávila	052	05052	Casas del Puerto de Villatoro	102	54	48	52.9411764705882	47.0588235294118
05	Ávila	053	05053	Casasola	161	84	77	52.1739130434783	47.8260869565217
05	Ávila	054	05054	Casavieja	1582	827	755	52.275600505689	47.724399494311
05	Ávila	055	05055	Casillas	817	422	395	51.6523867809058	48.3476132190943
05	Ávila	056	05056	Castellanos de Zapardiel	150	82	68	54.6666666666667	45.3333333333333
05	Ávila	057	05057	Cebreros	3260	1614	1646	49.5092024539877	50.4907975460123
05	Ávila	058	05058	Cepeda la Mora	148	78	70	52.7027027027027	47.2972972972973
05	Ávila	059	05059	Cillán	146	77	69	52.7397260273973	47.2602739726027
05	Ávila	060	05060	Cisla	191	93	98	48.6910994764398	51.3089005235602
05	Ávila	061	05061	Colilla (La)	222	111	111	50	50
05	Ávila	062	05062	Collado de Contreras	269	145	124	53.9033457249071	46.0966542750929
05	Ávila	063	05063	Collado del Mirón	86	46	40	53.4883720930233	46.5116279069767
05	Ávila	064	05064	Constanzana	188	104	84	55.3191489361702	44.6808510638298
05	Ávila	065	05065	Crespos	723	372	351	51.4522821576763	48.5477178423237
05	Ávila	066	05066	Cuevas del Valle	640	346	294	54.0625	45.9375
05	Ávila	067	05067	Chamartín	114	66	48	57.8947368421053	42.1052631578947
05	Ávila	069	05069	Donjimeno	138	73	65	52.8985507246377	47.1014492753623
05	Ávila	070	05070	Donvidas	68	33	35	48.5294117647059	51.4705882352941
05	Ávila	072	05072	Espinosa de los Caballeros	110	63	47	57.2727272727273	42.7272727272727
05	Ávila	073	05073	Flores de Ávila	434	226	208	52.073732718894	47.926267281106
05	Ávila	074	05074	Fontiveros	1032	525	507	50.8720930232558	49.1279069767442
05	Ávila	075	05075	Fresnedilla	101	43	58	42.5742574257426	57.4257425742574
05	Ávila	076	05076	Fresno (El)	492	250	242	50.8130081300813	49.1869918699187
05	Ávila	077	05077	Fuente el Saúz	306	160	146	52.2875816993464	47.7124183006536
05	Ávila	078	05078	Fuentes de Año	194	102	92	52.5773195876289	47.4226804123711
05	Ávila	079	05079	Gallegos de Altamiros	97	52	45	53.6082474226804	46.3917525773196
05	Ávila	080	05080	Gallegos de Sobrinos	108	52	56	48.1481481481482	51.8518518518519
05	Ávila	081	05081	Garganta del Villar	76	42	34	55.2631578947369	44.7368421052632
05	Ávila	082	05082	Gavilanes	728	412	316	56.5934065934066	43.4065934065934
05	Ávila	083	05083	Gemuño	218	105	113	48.1651376146789	51.8348623853211
05	Ávila	084	05084	Gilbuena	135	76	59	56.2962962962963	43.7037037037037
05	Ávila	085	05085	Gil García	63	29	34	46.031746031746	53.968253968254
05	Ávila	086	05086	Gimialcón	115	64	51	55.6521739130435	44.3478260869565
05	Ávila	087	05087	Gotarrendura	174	63	111	36.2068965517241	63.7931034482759
05	Ávila	088	05088	Grandes y San Martín	49	24	25	48.9795918367347	51.0204081632653
05	Ávila	089	05089	Guisando	644	345	299	53.5714285714286	46.4285714285714
05	Ávila	090	05090	Gutierre-Muñoz	132	64	68	48.4848484848485	51.5151515151515
05	Ávila	092	05092	Hernansancho	230	121	109	52.6086956521739	47.3913043478261
05	Ávila	093	05093	Herradón de Pinares	504	254	250	50.3968253968254	49.6031746031746
05	Ávila	094	05094	Herreros de Suso	224	108	116	48.2142857142857	51.7857142857143
05	Ávila	095	05095	Higuera de las Dueñas	327	183	144	55.9633027522936	44.0366972477064
05	Ávila	096	05096	Hija de Dios (La)	111	61	50	54.954954954955	45.0450450450451
05	Ávila	097	05097	Horcajada (La)	799	390	409	48.811013767209	51.188986232791
05	Ávila	099	05099	Horcajo de las Torres	794	427	367	53.7783375314861	46.2216624685139
05	Ávila	100	05100	Hornillo (El)	411	212	199	51.5815085158151	48.4184914841849
05	Ávila	101	05101	Hoyocasero	366	190	176	51.9125683060109	48.0874316939891
05	Ávila	102	05102	Hoyo de Pinares (El)	2359	1208	1151	51.2081390419669	48.7918609580331
05	Ávila	103	05103	Hoyorredondo	122	66	56	54.0983606557377	45.9016393442623
05	Ávila	104	05104	Hoyos del Collado	49	31	18	63.265306122449	36.734693877551
05	Ávila	105	05105	Hoyos del Espino	439	241	198	54.8974943052392	45.1025056947608
05	Ávila	106	05106	Hoyos de Miguel Muñoz	54	28	26	51.8518518518519	48.1481481481482
05	Ávila	107	05107	Hurtumpascual	114	64	50	56.140350877193	43.859649122807
05	Ávila	108	05108	Junciana	101	55	46	54.4554455445545	45.5445544554456
05	Ávila	109	05109	Langa	577	299	278	51.8197573656846	48.1802426343154
05	Ávila	110	05110	Lanzahíta	909	469	440	51.5951595159516	48.4048404840484
05	Ávila	112	05112	Losar del Barco (El)	139	72	67	51.7985611510791	48.2014388489209
05	Ávila	113	05113	Llanos de Tormes (Los)	128	66	62	51.5625	48.4375
05	Ávila	114	05114	Madrigal de las Altas Torres	1985	1015	970	51.1335012594458	48.8664987405542
05	Ávila	115	05115	Maello	645	319	326	49.4573643410853	50.5426356589147
05	Ávila	116	05116	Malpartida de Corneja	205	102	103	49.7560975609756	50.2439024390244
05	Ávila	117	05117	Mamblas	281	157	124	55.8718861209964	44.1281138790036
05	Ávila	118	05118	Mancera de Arriba	148	76	72	51.3513513513514	48.6486486486487
05	Ávila	119	05119	Manjabálago	70	36	34	51.4285714285714	48.5714285714286
05	Ávila	120	05120	Marlín	48	26	22	54.1666666666667	45.8333333333333
05	Ávila	121	05121	Martiherrero	201	105	96	52.2388059701493	47.7611940298507
05	Ávila	122	05122	Martínez	234	124	110	52.991452991453	47.008547008547
05	Ávila	123	05123	Mediana de Voltoya	108	59	49	54.6296296296296	45.3703703703704
05	Ávila	124	05124	Medinilla	210	104	106	49.5238095238095	50.4761904761905
05	Ávila	125	05125	Mengamuñoz	73	33	40	45.2054794520548	54.7945205479452
05	Ávila	126	05126	Mesegar de Corneja	119	62	57	52.1008403361345	47.8991596638655
05	Ávila	127	05127	Mijares	981	500	481	50.9683995922528	49.0316004077472
05	Ávila	128	05128	Mingorría	522	260	262	49.8084291187739	50.1915708812261
05	Ávila	129	05129	Mirón (El)	248	145	103	58.4677419354839	41.5322580645161
05	Ávila	130	05130	Mironcillo	138	73	65	52.8985507246377	47.1014492753623
05	Ávila	131	05131	Mirueña de los Infanzones	189	94	95	49.7354497354497	50.2645502645503
05	Ávila	132	05132	Mombeltrán	1169	610	559	52.1813515825492	47.8186484174508
05	Ávila	133	05133	Monsalupe	97	45	52	46.3917525773196	53.6082474226804
05	Ávila	134	05134	Moraleja de Matacabras	77	38	39	49.3506493506493	50.6493506493506
05	Ávila	135	05135	Muñana	576	297	279	51.5625	48.4375
05	Ávila	136	05136	Muñico	139	71	68	51.0791366906475	48.9208633093525
05	Ávila	138	05138	Muñogalindo	445	247	198	55.5056179775281	44.4943820224719
05	Ávila	139	05139	Muñogrande	107	56	51	52.3364485981308	47.6635514018692
05	Ávila	140	05140	Muñomer del Peco	132	71	61	53.7878787878788	46.2121212121212
05	Ávila	141	05141	Muñopepe	106	61	45	57.5471698113208	42.4528301886793
05	Ávila	142	05142	Muñosancho	167	76	91	45.5089820359281	54.4910179640719
05	Ávila	143	05143	Muñotello	128	66	62	51.5625	48.4375
05	Ávila	144	05144	Narrillos del Álamo	164	84	80	51.219512195122	48.7804878048781
05	Ávila	145	05145	Narrillos del Rebollar	75	38	37	50.6666666666667	49.3333333333333
05	Ávila	147	05147	Narros del Castillo	240	132	108	55	45
05	Ávila	148	05148	Narros del Puerto	49	27	22	55.1020408163265	44.8979591836735
05	Ávila	149	05149	Narros de Saldueña	171	96	75	56.140350877193	43.859649122807
05	Ávila	151	05151	Navacepedilla de Corneja	144	80	64	55.5555555555556	44.4444444444444
05	Ávila	152	05152	Nava de Arévalo	986	517	469	52.4340770791075	47.5659229208925
05	Ávila	153	05153	Nava del Barco	172	88	84	51.1627906976744	48.8372093023256
05	Ávila	154	05154	Navadijos	60	37	23	61.6666666666667	38.3333333333333
05	Ávila	155	05155	Navaescurial	84	48	36	57.1428571428571	42.8571428571429
05	Ávila	156	05156	Navahondilla	140	81	59	57.8571428571429	42.1428571428571
05	Ávila	157	05157	Navalacruz	313	152	161	48.5623003194888	51.4376996805112
05	Ávila	158	05158	Navalmoral	594	304	290	51.1784511784512	48.8215488215488
05	Ávila	159	05159	Navalonguilla	442	226	216	51.131221719457	48.868778280543
05	Ávila	160	05160	Navalosa	484	254	230	52.4793388429752	47.5206611570248
05	Ávila	161	05161	Navalperal de Pinares	842	411	431	48.812351543943	51.187648456057
05	Ávila	162	05162	Navalperal de Tormes	143	80	63	55.944055944056	44.0559440559441
05	Ávila	163	05163	Navaluenga	2015	1017	998	50.4714640198511	49.5285359801489
05	Ávila	164	05164	Navaquesera	62	23	39	37.0967741935484	62.9032258064516
05	Ávila	165	05165	Navarredonda de Gredos	493	252	241	51.1156186612576	48.8843813387424
05	Ávila	166	05166	Navarredondilla	320	158	162	49.375	50.625
05	Ávila	167	05167	Navarrevisca	381	192	189	50.3937007874016	49.6062992125984
05	Ávila	168	05168	Navas del Marqués (Las)	4272	2145	2127	50.2106741573034	49.7893258426966
05	Ávila	169	05169	Navatalgordo	423	214	209	50.5910165484634	49.4089834515366
05	Ávila	170	05170	Navatejares	96	41	55	42.7083333333333	57.2916666666667
05	Ávila	171	05171	Neila de San Miguel	118	64	54	54.2372881355932	45.7627118644068
05	Ávila	172	05172	Niharra	198	101	97	51.010101010101	48.989898989899
05	Ávila	173	05173	Ojos-Albos	65	35	30	53.8461538461539	46.1538461538462
05	Ávila	174	05174	Orbita	106	54	52	50.9433962264151	49.0566037735849
05	Ávila	175	05175	Oso (El)	226	128	98	56.6371681415929	43.3628318584071
05	Ávila	176	05176	Padiernos	242	127	115	52.4793388429752	47.5206611570248
05	Ávila	177	05177	Pajares de Adaja	196	99	97	50.5102040816327	49.4897959183674
05	Ávila	178	05178	Palacios de Goda	510	253	257	49.6078431372549	50.3921568627451
05	Ávila	179	05179	Papatrigo	347	178	169	51.2968299711816	48.7031700288184
05	Ávila	180	05180	Parral (El)	132	71	61	53.7878787878788	46.2121212121212
05	Ávila	181	05181	Pascualcobo	54	32	22	59.2592592592593	40.7407407407407
05	Ávila	182	05182	Pedro Bernardo	1289	666	623	51.6679596586501	48.3320403413499
05	Ávila	183	05183	Pedro-Rodríguez	221	104	117	47.0588235294118	52.9411764705882
05	Ávila	184	05184	Peguerinos	309	163	146	52.7508090614887	47.2491909385113
05	Ávila	185	05185	Peñalba de Ávila	131	74	57	56.4885496183206	43.5114503816794
05	Ávila	186	05186	Piedrahíta	2169	1042	1127	48.040571692024	51.959428307976
05	Ávila	187	05187	Piedralaves	2102	1061	1041	50.4757373929591	49.5242626070409
05	Ávila	188	05188	Poveda	84	48	36	57.1428571428571	42.8571428571429
05	Ávila	189	05189	Poyales del Hoyo	698	355	343	50.8595988538682	49.1404011461318
05	Ávila	190	05190	Pozanco	56	31	25	55.3571428571429	44.6428571428571
05	Ávila	191	05191	Pradosegar	171	89	82	52.046783625731	47.953216374269
05	Ávila	192	05192	Puerto Castilla	145	86	59	59.3103448275862	40.6896551724138
05	Ávila	193	05193	Rasueros	340	180	160	52.9411764705882	47.0588235294118
05	Ávila	194	05194	Riocabado	205	112	93	54.6341463414634	45.3658536585366
05	Ávila	195	05195	Riofrío	315	174	141	55.2380952380952	44.7619047619048
05	Ávila	196	05196	Rivilla de Barajas	79	40	39	50.6329113924051	49.3670886075949
05	Ávila	197	05197	Salobral	127	64	63	50.3937007874016	49.6062992125984
05	Ávila	198	05198	Salvadiós	123	62	61	50.4065040650407	49.5934959349593
05	Ávila	199	05199	San Bartolomé de Béjar	76	35	41	46.0526315789474	53.9473684210526
05	Ávila	200	05200	San Bartolomé de Corneja	106	56	50	52.8301886792453	47.1698113207547
05	Ávila	201	05201	San Bartolomé de Pinares	741	391	350	52.7665317139001	47.2334682860999
05	Ávila	204	05204	Sanchidrián	791	403	388	50.9481668773704	49.0518331226296
05	Ávila	205	05205	Sanchorreja	141	73	68	51.7730496453901	48.2269503546099
05	Ávila	206	05206	San Esteban de los Patos	46	24	22	52.1739130434783	47.8260869565217
05	Ávila	207	05207	San Esteban del Valle	872	449	423	51.4908256880734	48.5091743119266
05	Ávila	208	05208	San Esteban de Zapardiel	70	36	34	51.4285714285714	48.5714285714286
05	Ávila	209	05209	San García de Ingelmos	167	90	77	53.8922155688623	46.1077844311377
05	Ávila	210	05210	San Juan de la Encinilla	131	61	70	46.5648854961832	53.4351145038168
05	Ávila	211	05211	San Juan de la Nava	695	359	336	51.6546762589928	48.3453237410072
05	Ávila	212	05212	San Juan del Molinillo	347	197	150	56.7723342939481	43.2276657060519
05	Ávila	213	05213	San Juan del Olmo	174	100	74	57.4712643678161	42.5287356321839
05	Ávila	214	05214	San Lorenzo de Tormes	62	32	30	51.6129032258065	48.3870967741936
05	Ávila	215	05215	San Martín de la Vega del Alberche	297	168	129	56.5656565656566	43.4343434343434
05	Ávila	216	05216	San Martín del Pimpollar	328	176	152	53.6585365853659	46.3414634146342
05	Ávila	217	05217	San Miguel de Corneja	106	46	60	43.3962264150943	56.6037735849057
05	Ávila	218	05218	San Miguel de Serrezuela	209	114	95	54.5454545454545	45.4545454545455
05	Ávila	219	05219	San Pascual	56	35	21	62.5	37.5
05	Ávila	220	05220	San Pedro del Arroyo	493	253	240	51.3184584178499	48.6815415821501
05	Ávila	221	05221	Santa Cruz del Valle	623	322	301	51.685393258427	48.314606741573
05	Ávila	222	05222	Santa Cruz de Pinares	218	117	101	53.6697247706422	46.3302752293578
05	Ávila	224	05224	Santa María del Arroyo	131	66	65	50.381679389313	49.618320610687
05	Ávila	225	05225	Santa María del Berrocal	543	257	286	47.329650092081	52.670349907919
05	Ávila	226	05226	Santa María de los Caballeros	148	74	74	50	50
05	Ávila	227	05227	Santa María del Tiétar	402	212	190	52.7363184079602	47.2636815920398
05	Ávila	228	05228	Santiago del Collado	279	171	108	61.2903225806452	38.7096774193548
05	Ávila	229	05229	Santo Domingo de las Posadas	84	39	45	46.4285714285714	53.5714285714286
05	Ávila	230	05230	Santo Tomé de Zabarcos	119	65	54	54.6218487394958	45.3781512605042
05	Ávila	231	05231	San Vicente de Arévalo	228	114	114	50	50
05	Ávila	232	05232	Serrada (La)	151	77	74	50.9933774834437	49.0066225165563
05	Ávila	233	05233	Serranillos	415	215	200	51.8072289156626	48.1927710843374
05	Ávila	234	05234	Sigeres	77	38	39	49.3506493506493	50.6493506493506
05	Ávila	235	05235	Sinlabajos	241	125	116	51.8672199170125	48.1327800829876
05	Ávila	236	05236	Solana de Ávila	207	109	98	52.6570048309179	47.3429951690821
05	Ávila	237	05237	Solana de Rioalmar	298	159	139	53.3557046979866	46.6442953020134
05	Ávila	238	05238	Solosancho	1047	546	501	52.1489971346705	47.8510028653295
05	Ávila	239	05239	Sotalbo	267	142	125	53.1835205992509	46.8164794007491
05	Ávila	240	05240	Sotillo de la Adrada	3575	1773	1802	49.5944055944056	50.4055944055944
05	Ávila	241	05241	Tiemblo (El)	3658	1839	1819	50.2733734281028	49.7266265718972
05	Ávila	242	05242	Tiñosillos	770	412	358	53.5064935064935	46.4935064935065
05	Ávila	243	05243	Tolbaños	136	66	70	48.5294117647059	51.4705882352941
05	Ávila	244	05244	Tormellas	106	56	50	52.8301886792453	47.1698113207547
05	Ávila	245	05245	Tornadizos de Ávila	354	173	181	48.8700564971751	51.1299435028249
05	Ávila	246	05246	Tórtoles	126	64	62	50.7936507936508	49.2063492063492
05	Ávila	247	05247	Torre (La)	427	234	193	54.8009367681499	45.1990632318501
05	Ávila	249	05249	Umbrías	167	87	80	52.0958083832335	47.9041916167665
05	Ávila	251	05251	Vadillo de la Sierra	153	82	71	53.5947712418301	46.4052287581699
05	Ávila	252	05252	Valdecasa	114	61	53	53.5087719298246	46.4912280701754
05	Ávila	253	05253	Vega de Santa María	143	79	64	55.2447552447552	44.7552447552448
05	Ávila	254	05254	Velayos	260	126	134	48.4615384615385	51.5384615384615
05	Ávila	256	05256	Villaflor	167	87	80	52.0958083832335	47.9041916167665
05	Ávila	257	05257	Villafranca de la Sierra	218	115	103	52.7522935779817	47.2477064220183
05	Ávila	258	05258	Villanueva de Gómez	150	71	79	47.3333333333333	52.6666666666667
05	Ávila	259	05259	Villanueva del Aceral	186	83	103	44.6236559139785	55.3763440860215
05	Ávila	260	05260	Villanueva del Campillo	201	102	99	50.7462686567164	49.2537313432836
05	Ávila	261	05261	Villar de Corneja	77	37	40	48.0519480519481	51.9480519480519
05	Ávila	262	05262	Villarejo del Valle	514	270	244	52.5291828793774	47.4708171206226
05	Ávila	263	05263	Villatoro	235	133	102	56.5957446808511	43.4042553191489
05	Ávila	264	05264	Viñegra de Moraña	90	48	42	53.3333333333333	46.6666666666667
05	Ávila	265	05265	Vita	124	76	48	61.2903225806452	38.7096774193548
05	Ávila	266	05266	Zapardiel de la Cañada	186	92	94	49.4623655913979	50.5376344086022
05	Ávila	267	05267	Zapardiel de la Ribera	139	70	69	50.3597122302158	49.6402877697842
05	Ávila	901	05901	San Juan de Gredos	399	208	191	52.1303258145363	47.8696741854637
05	Ávila	902	05902	Santa María del Cubillo	394	225	169	57.1065989847716	42.8934010152284
05	Ávila	903	05903	Diego del Carpio	311	162	149	52.0900321543408	47.9099678456592
05	Ávila	904	05904	Santiago del Tormes	266	139	127	52.2556390977444	47.7443609022556
05	Ávila	905	05905	Villanueva de Ávila	497	254	243	51.1066398390342	48.8933601609658
06	Badajoz	001	06001	Acedera	969	506	463	52.218782249742	47.781217750258
06	Badajoz	002	06002	Aceuchal	5304	2626	2678	49.5098039215686	50.4901960784314
06	Badajoz	003	06003	Ahillones	1200	588	612	49	51
06	Badajoz	004	06004	Alange	2057	1054	1003	51.2396694214876	48.7603305785124
06	Badajoz	005	06005	Albuera (La)	1804	919	885	50.9423503325942	49.0576496674058
06	Badajoz	006	06006	Alburquerque	5645	2831	2814	50.1505757307352	49.8494242692648
06	Badajoz	007	06007	Alconchel	2106	1047	1059	49.7150997150997	50.2849002849003
06	Badajoz	008	06008	Alconera	721	357	364	49.5145631067961	50.4854368932039
06	Badajoz	009	06009	Aljucén	255	142	113	55.6862745098039	44.3137254901961
06	Badajoz	010	06010	Almendral	1478	731	747	49.4587280108254	50.5412719891746
06	Badajoz	011	06011	Almendralejo	27610	13507	14103	48.9206809127128	51.0793190872872
06	Badajoz	012	06012	Arroyo de San Serván	3970	2040	1930	51.3853904282116	48.6146095717884
06	Badajoz	013	06013	Atalaya	369	174	195	47.1544715447155	52.8455284552846
06	Badajoz	014	06014	Azuaga	8735	4431	4304	50.7269605037207	49.2730394962793
06	Badajoz	015	06015	Badajoz	136136	66030	70106	48.5029676206147	51.4970323793853
06	Badajoz	016	06016	Barcarrota	3742	1908	1834	50.9887760555853	49.0112239444148
06	Badajoz	017	06017	Baterno	403	208	195	51.6129032258065	48.3870967741936
06	Badajoz	018	06018	Benquerencia de la Serena	1033	522	511	50.5324298160697	49.4675701839303
06	Badajoz	019	06019	Berlanga	2694	1313	1381	48.7379361544172	51.2620638455828
06	Badajoz	020	06020	Bienvenida	2364	1221	1143	51.6497461928934	48.3502538071066
06	Badajoz	021	06021	Bodonal de la Sierra	1265	649	616	51.304347826087	48.695652173913
06	Badajoz	022	06022	Burguillos del Cerro	3321	1606	1715	48.3589280337248	51.6410719662752
06	Badajoz	023	06023	Cabeza del Buey	5982	2941	3041	49.164159144099	50.835840855901
06	Badajoz	024	06024	Cabeza la Vaca	1646	821	825	49.8784933171324	50.1215066828676
06	Badajoz	025	06025	Calamonte	6002	3003	2999	50.0333222259247	49.9666777740753
06	Badajoz	026	06026	Calera de León	1112	568	544	51.0791366906475	48.9208633093525
06	Badajoz	027	06027	Calzadilla de los Barros	848	423	425	49.8820754716981	50.1179245283019
06	Badajoz	028	06028	Campanario	5675	2763	2912	48.6872246696035	51.3127753303965
06	Badajoz	029	06029	Campillo de Llerena	1745	859	886	49.2263610315186	50.7736389684814
06	Badajoz	030	06030	Capilla	225	111	114	49.3333333333333	50.6666666666667
06	Badajoz	031	06031	Carmonita	652	337	315	51.6871165644172	48.3128834355828
06	Badajoz	032	06032	Carrascalejo (El)	73	41	32	56.1643835616438	43.8356164383562
06	Badajoz	033	06033	Casas de Don Pedro	1737	853	884	49.1076568796776	50.8923431203224
06	Badajoz	034	06034	Casas de Reina	249	118	131	47.3895582329317	52.6104417670683
06	Badajoz	035	06035	Castilblanco	1385	685	700	49.4584837545126	50.5415162454874
06	Badajoz	036	06036	Castuera	7215	3561	3654	49.3555093555094	50.6444906444906
06	Badajoz	037	06037	Codosera (La)	2397	1264	1133	52.73258239466	47.26741760534
06	Badajoz	038	06038	Cordobilla de Lácara	1038	524	514	50.4816955684008	49.5183044315992
06	Badajoz	039	06039	Coronada (La)	2447	1219	1228	49.8161013485901	50.1838986514099
06	Badajoz	040	06040	Corte de Peleas	1289	643	646	49.8836307214895	50.1163692785105
06	Badajoz	041	06041	Cristina	555	294	261	52.972972972973	47.027027027027
06	Badajoz	042	06042	Cheles	1326	660	666	49.7737556561086	50.2262443438914
06	Badajoz	043	06043	Don Álvaro	677	331	346	48.8921713441654	51.1078286558346
06	Badajoz	044	06044	Don Benito	31454	15536	15918	49.3927640363706	50.6072359636294
06	Badajoz	045	06045	Entrín Bajo	670	327	343	48.8059701492537	51.1940298507463
06	Badajoz	046	06046	Esparragalejo	1536	753	783	49.0234375	50.9765625
06	Badajoz	047	06047	Esparragosa de la Serena	1127	557	570	49.4232475598935	50.5767524401065
06	Badajoz	048	06048	Esparragosa de Lares	1167	559	608	47.9005998286204	52.0994001713796
06	Badajoz	049	06049	Feria	1435	707	728	49.2682926829268	50.7317073170732
06	Badajoz	050	06050	Fregenal de la Sierra	5379	2588	2791	48.1130321621119	51.8869678378881
06	Badajoz	051	06051	Fuenlabrada de los Montes	2078	1026	1052	49.3743984600578	50.6256015399423
06	Badajoz	052	06052	Fuente de Cantos	5039	2535	2504	50.3076007144275	49.6923992855725
06	Badajoz	053	06053	Fuente del Arco	825	418	407	50.6666666666667	49.3333333333333
06	Badajoz	054	06054	Fuente del Maestre	6818	3375	3443	49.5013200352009	50.4986799647991
06	Badajoz	055	06055	Fuentes de León	2742	1348	1394	49.1611962071481	50.8388037928519
06	Badajoz	056	06056	Garbayuela	583	310	273	53.1732418524871	46.8267581475129
06	Badajoz	057	06057	Garlitos	799	406	393	50.8135168961202	49.1864831038799
06	Badajoz	058	06058	Garrovilla (La)	2637	1350	1287	51.1945392491467	48.8054607508532
06	Badajoz	059	06059	Granja de Torrehermosa	2578	1271	1307	49.3017843289372	50.6982156710628
06	Badajoz	060	06060	Guareña	7474	3765	3709	50.3746320578004	49.6253679421996
06	Badajoz	061	06061	Haba (La)	1467	744	723	50.7157464212679	49.2842535787321
06	Badajoz	062	06062	Helechosa de los Montes	766	423	343	55.2219321148825	44.7780678851175
06	Badajoz	063	06063	Herrera del Duque	3913	1987	1926	50.7794531050345	49.2205468949655
06	Badajoz	064	06064	Higuera de la Serena	1224	622	602	50.8169934640523	49.1830065359477
06	Badajoz	065	06065	Higuera de Llerena	449	221	228	49.2204899777283	50.7795100222717
06	Badajoz	066	06066	Higuera de Vargas	2221	1108	1113	49.88743809095	50.11256190905
06	Badajoz	067	06067	Higuera la Real	2584	1294	1290	50.077399380805	49.922600619195
06	Badajoz	068	06068	Hinojosa del Valle	610	311	299	50.9836065573771	49.0163934426229
06	Badajoz	069	06069	Hornachos	3861	1988	1873	51.4892514892515	48.5107485107485
06	Badajoz	070	06070	Jerez de los Caballeros	9594	4792	4802	49.9478840942256	50.0521159057744
06	Badajoz	071	06071	Lapa (La)	328	168	160	51.219512195122	48.7804878048781
06	Badajoz	072	06072	Lobón	2725	1393	1332	51.1192660550459	48.8807339449541
06	Badajoz	073	06073	Llera	969	498	471	51.3931888544892	48.6068111455108
06	Badajoz	074	06074	Llerena	5621	2721	2900	48.4077566269347	51.5922433730653
06	Badajoz	075	06075	Magacela	709	371	338	52.327221438646	47.672778561354
06	Badajoz	076	06076	Maguilla	1151	569	582	49.4352736750652	50.5647263249348
06	Badajoz	077	06077	Malcocinado	546	292	254	53.4798534798535	46.5201465201465
06	Badajoz	078	06078	Malpartida de la Serena	782	401	381	51.2787723785166	48.7212276214834
06	Badajoz	079	06079	Manchita	770	383	387	49.7402597402597	50.2597402597403
06	Badajoz	080	06080	Medellín	2400	1210	1190	50.4166666666667	49.5833333333333
06	Badajoz	081	06081	Medina de las Torres	1512	743	769	49.1402116402116	50.8597883597884
06	Badajoz	082	06082	Mengabril	462	236	226	51.0822510822511	48.9177489177489
06	Badajoz	083	06083	Mérida	50478	24600	25878	48.7341019850232	51.2658980149768
06	Badajoz	084	06084	Mirandilla	1364	688	676	50.4398826979472	49.5601173020528
06	Badajoz	085	06085	Monesterio	4679	2340	2339	50.0106860440265	49.9893139559735
06	Badajoz	086	06086	Montemolín	1696	874	822	51.5330188679245	48.4669811320755
06	Badajoz	087	06087	Monterrubio de la Serena	3093	1509	1584	48.7875848690592	51.2124151309408
06	Badajoz	088	06088	Montijo	15314	7567	7747	49.4123024683296	50.5876975316704
06	Badajoz	089	06089	Morera (La)	783	385	398	49.1698595146871	50.8301404853129
06	Badajoz	090	06090	Nava de Santiago (La)	1179	588	591	49.8727735368957	50.1272264631043
06	Badajoz	091	06091	Navalvillar de Pela	4923	2481	2442	50.3960999390615	49.6039000609385
06	Badajoz	092	06092	Nogales	788	394	394	50	50
06	Badajoz	093	06093	Oliva de la Frontera	5925	2948	2977	49.7552742616034	50.2447257383966
06	Badajoz	094	06094	Oliva de Mérida	1999	988	1011	49.4247123561781	50.5752876438219
06	Badajoz	095	06095	Olivenza	10709	5277	5432	49.2763096460921	50.7236903539079
06	Badajoz	096	06096	Orellana de la Sierra	377	195	182	51.7241379310345	48.2758620689655
06	Badajoz	097	06097	Orellana la Vieja	3397	1703	1694	50.1324698263173	49.8675301736827
06	Badajoz	098	06098	Palomas	698	370	328	53.0085959885387	46.9914040114613
06	Badajoz	099	06099	Parra (La)	1403	725	678	51.6749821810406	48.3250178189594
06	Badajoz	100	06100	Peñalsordo	1517	725	792	47.7916941331575	52.2083058668425
06	Badajoz	101	06101	Peraleda del Zaucejo	664	340	324	51.2048192771084	48.7951807228916
06	Badajoz	102	06102	Puebla de Alcocer	1476	715	761	48.4417344173442	51.5582655826558
06	Badajoz	103	06103	Puebla de la Calzada	5525	2739	2786	49.5746606334842	50.4253393665158
06	Badajoz	104	06104	Puebla de la Reina	885	449	436	50.7344632768362	49.2655367231638
06	Badajoz	105	06105	Puebla del Maestre	938	462	476	49.2537313432836	50.7462686567164
06	Badajoz	106	06106	Puebla del Prior	574	288	286	50.1742160278746	49.8257839721254
06	Badajoz	107	06107	Puebla de Obando	2043	1041	1002	50.9544787077827	49.0455212922173
06	Badajoz	108	06108	Puebla de Sancho Pérez	2875	1448	1427	50.3652173913043	49.6347826086957
06	Badajoz	109	06109	Quintana de la Serena	5134	2581	2553	50.2726918582002	49.7273081417998
06	Badajoz	110	06110	Reina	226	120	106	53.0973451327434	46.9026548672566
06	Badajoz	111	06111	Rena	669	330	339	49.3273542600897	50.6726457399103
06	Badajoz	112	06112	Retamal de Llerena	556	289	267	51.9784172661871	48.021582733813
06	Badajoz	113	06113	Ribera del Fresno	3423	1670	1753	48.7876132047911	51.2123867952089
06	Badajoz	114	06114	Risco	216	106	110	49.0740740740741	50.9259259259259
06	Badajoz	115	06115	Roca de la Sierra (La)	1633	811	822	49.6631965707287	50.3368034292713
06	Badajoz	116	06116	Salvaleón	2214	1117	1097	50.4516711833785	49.5483288166215
06	Badajoz	117	06117	Salvatierra de los Barros	1973	961	1012	48.7075519513431	51.2924480486569
06	Badajoz	118	06118	Sancti-Spíritus	309	146	163	47.2491909385113	52.7508090614887
06	Badajoz	119	06119	San Pedro de Mérida	816	414	402	50.7352941176471	49.2647058823529
06	Badajoz	120	06120	Santa Amalia	4332	2172	2160	50.1385041551247	49.8614958448754
06	Badajoz	121	06121	Santa Marta	4102	2014	2088	49.0980009751341	50.9019990248659
06	Badajoz	122	06122	Santos de Maimona (Los)	7924	3955	3969	49.9116607773852	50.0883392226148
06	Badajoz	123	06123	San Vicente de Alcántara	5908	2917	2991	49.373730534868	50.626269465132
06	Badajoz	124	06124	Segura de León	2296	1144	1152	49.8257839721254	50.1742160278746
06	Badajoz	125	06125	Siruela	2463	1221	1242	49.5736906211937	50.4263093788063
06	Badajoz	126	06126	Solana de los Barros	2768	1389	1379	50.1806358381503	49.8193641618497
06	Badajoz	127	06127	Talarrubias	3658	1806	1852	49.3712411153636	50.6287588846364
06	Badajoz	128	06128	Talavera la Real	5317	2683	2634	50.4607861576077	49.5392138423923
06	Badajoz	129	06129	Táliga	766	392	374	51.1749347258486	48.8250652741514
06	Badajoz	130	06130	Tamurejo	272	134	138	49.2647058823529	50.7352941176471
06	Badajoz	131	06131	Torre de Miguel Sesmero	1273	638	635	50.1178318931658	49.8821681068343
06	Badajoz	132	06132	Torremayor	1067	517	550	48.4536082474227	51.5463917525773
06	Badajoz	133	06133	Torremejía	2045	1038	1007	50.757946210269	49.2420537897311
06	Badajoz	134	06134	Trasierra	712	379	333	53.2303370786517	46.7696629213483
06	Badajoz	135	06135	Trujillanos	1358	718	640	52.8718703976436	47.1281296023564
06	Badajoz	136	06136	Usagre	2089	1054	1035	50.4547630445189	49.5452369554811
06	Badajoz	137	06137	Valdecaballeros	1423	716	707	50.3162333099086	49.6837666900914
06	Badajoz	138	06138	Valdetorres	1382	703	679	50.8683068017366	49.1316931982634
06	Badajoz	139	06139	Valencia de las Torres	855	436	419	50.9941520467836	49.0058479532164
06	Badajoz	140	06140	Valencia del Mombuey	817	398	419	48.7148102815177	51.2851897184823
06	Badajoz	141	06141	Valencia del Ventoso	2355	1162	1193	49.3418259023355	50.6581740976645
06	Badajoz	142	06142	Valverde de Burguillos	375	189	186	50.4	49.6
06	Badajoz	143	06143	Valverde de Leganés	3767	1903	1864	50.5176533050173	49.4823466949828
06	Badajoz	144	06144	Valverde de Llerena	829	394	435	47.5271411338963	52.4728588661037
06	Badajoz	145	06145	Valverde de Mérida	1150	574	576	49.9130434782609	50.0869565217391
06	Badajoz	146	06146	Valle de la Serena	1588	779	809	49.0554156171285	50.9445843828715
06	Badajoz	147	06147	Valle de Matamoros	505	248	257	49.1089108910891	50.8910891089109
06	Badajoz	148	06148	Valle de Santa Ana	1221	619	602	50.6961506961507	49.3038493038493
06	Badajoz	149	06149	Villafranca de los Barros	12537	6226	6311	49.6610034298477	50.3389965701524
06	Badajoz	150	06150	Villagarcía de la Torre	1012	505	507	49.901185770751	50.098814229249
06	Badajoz	151	06151	Villagonzalo	1446	707	739	48.8934993084371	51.1065006915629
06	Badajoz	152	06152	Villalba de los Barros	1745	890	855	51.0028653295129	48.9971346704871
06	Badajoz	153	06153	Villanueva de la Serena	23875	11783	12092	49.3528795811518	50.6471204188482
06	Badajoz	154	06154	Villanueva del Fresno	3489	1744	1745	49.9856692462024	50.0143307537977
06	Badajoz	155	06155	Villar del Rey	2313	1186	1127	51.2753999135322	48.7246000864678
06	Badajoz	156	06156	Villar de Rena	1696	890	806	52.4764150943396	47.5235849056604
06	Badajoz	157	06157	Villarta de los Montes	680	339	341	49.8529411764706	50.1470588235294
06	Badajoz	158	06158	Zafra	15158	7290	7868	48.0934160179443	51.9065839820557
06	Badajoz	159	06159	Zahínos	3043	1537	1506	50.5093657574762	49.4906342425238
06	Badajoz	160	06160	Zalamea de la Serena	4647	2285	2362	49.1715085001076	50.8284914998924
06	Badajoz	161	06161	Zarza-Capilla	516	269	247	52.1317829457364	47.8682170542636
06	Badajoz	162	06162	Zarza (La)	3586	1801	1785	50.2230897936419	49.7769102063581
06	Badajoz	901	06901	Valdelacalzada	2582	1335	1247	51.704105344694	48.295894655306
07	Balears (Illes)	001	07001	Alaró	4032	1950	2082	48.3630952380952	51.6369047619048
07	Balears (Illes)	002	07002	Alaior	7390	3679	3711	49.7834912043302	50.2165087956698
07	Balears (Illes)	003	07003	Alcúdia	12152	6136	6016	50.493745885451	49.506254114549
07	Balears (Illes)	004	07004	Algaida	3753	1896	1857	50.519584332534	49.480415667466
07	Balears (Illes)	005	07005	Andratx	8655	4346	4309	50.2137492778741	49.7862507221259
07	Balears (Illes)	006	07006	Artà	6140	3071	3069	50.0162866449511	49.9837133550489
07	Balears (Illes)	007	07007	Banyalbufar	520	282	238	54.2307692307692	45.7692307692308
07	Balears (Illes)	008	07008	Binissalem	5193	2503	2690	48.1994993260158	51.8005006739842
07	Balears (Illes)	009	07009	Búger	932	472	460	50.6437768240343	49.3562231759657
07	Balears (Illes)	010	07010	Bunyola	4745	2340	2405	49.3150684931507	50.6849315068493
07	Balears (Illes)	011	07011	Calvià	37419	18777	18642	50.1803896416259	49.8196103583741
07	Balears (Illes)	012	07012	Campanet	2346	1161	1185	49.4884910485934	50.5115089514066
07	Balears (Illes)	013	07013	Campos	7074	3568	3506	50.438224484026	49.561775515974
07	Balears (Illes)	014	07014	Capdepera	8008	4029	3979	50.3121878121878	49.6878121878122
07	Balears (Illes)	015	07015	Ciutadella de Menorca	22925	11433	11492	49.8713195201745	50.1286804798255
07	Balears (Illes)	016	07016	Consell	2327	1157	1170	49.7206703910615	50.2793296089386
07	Balears (Illes)	017	07017	Costitx	903	442	461	48.9479512735327	51.0520487264673
07	Balears (Illes)	018	07018	Deyá	652	328	324	50.3067484662577	49.6932515337423
07	Balears (Illes)	019	07019	Escorca	318	168	150	52.8301886792453	47.1698113207547
07	Balears (Illes)	020	07020	Esporles	3993	1982	2011	49.6368645128976	50.3631354871024
07	Balears (Illes)	021	07021	Estellencs	357	181	176	50.7002801120448	49.2997198879552
07	Balears (Illes)	022	07022	Felanitx	15238	7625	7613	50.0393752460953	49.9606247539047
07	Balears (Illes)	023	07023	Ferreries	4061	2124	1937	52.3023885742428	47.6976114257572
07	Balears (Illes)	024	07024	Formentera	6289	3196	3093	50.8188901256162	49.1811098743838
07	Balears (Illes)	025	07025	Fornalutx	627	312	315	49.7607655502392	50.2392344497608
07	Balears (Illes)	026	07026	Eivissa	33223	16590	16633	49.9352857959847	50.0647142040153
07	Balears (Illes)	027	07027	Inca	22402	11107	11295	49.5803946076243	50.4196053923757
07	Balears (Illes)	028	07028	Lloret de Vista Alegre	933	457	476	48.9817792068596	51.0182207931404
07	Balears (Illes)	029	07029	Lloseta	4630	2308	2322	49.8488120950324	50.1511879049676
07	Balears (Illes)	030	07030	Llubí	1909	949	960	49.7118910424306	50.2881089575694
07	Balears (Illes)	031	07031	Llucmajor	23723	11866	11857	50.0189689331029	49.9810310668971
07	Balears (Illes)	032	07032	Mahón	23189	11314	11875	48.7903747466471	51.2096252533529
07	Balears (Illes)	033	07033	Manacor	30923	15386	15537	49.7558451637939	50.2441548362061
07	Balears (Illes)	034	07034	Mancor de la Vall	914	448	466	49.0153172866521	50.9846827133479
07	Balears (Illes)	035	07035	Maria de la Salut	1819	897	922	49.3128092358439	50.6871907641561
07	Balears (Illes)	036	07036	Marratxí	20924	10531	10393	50.3297648633149	49.6702351366852
07	Balears (Illes)	037	07037	Mercadal (Es)	3104	1571	1533	50.6121134020619	49.3878865979382
07	Balears (Illes)	038	07038	Montuïri	2317	1149	1168	49.5899870522227	50.4100129477773
07	Balears (Illes)	039	07039	Muro	6340	3175	3165	50.0788643533123	49.9211356466877
07	Balears (Illes)	040	07040	Palma de Mallorca	333925	162727	171198	48.7316014075017	51.2683985924983
07	Balears (Illes)	041	07041	Petra	2600	1278	1322	49.1538461538462	50.8461538461538
07	Balears (Illes)	042	07042	Pollença	14358	7158	7200	49.8537400752194	50.1462599247806
07	Balears (Illes)	043	07043	Porreres	4283	2168	2115	50.618725192622	49.381274807378
07	Balears (Illes)	044	07044	Pobla (Sa)	10347	5335	5012	51.5608388904997	48.4391611095003
07	Balears (Illes)	045	07045	Puigpunyent	1249	626	623	50.1200960768615	49.8799039231385
07	Balears (Illes)	046	07046	Sant Antoni de Portmany	15775	8028	7747	50.8906497622821	49.1093502377179
07	Balears (Illes)	047	07047	Sencelles	2125	1097	1028	51.6235294117647	48.3764705882353
07	Balears (Illes)	048	07048	San José	14428	7372	7056	51.0950928749653	48.9049071250347
07	Balears (Illes)	049	07049	Sant Joan	1686	833	853	49.4068801897983	50.5931198102017
07	Balears (Illes)	050	07050	Sant Joan de Labritja	4194	2119	2075	50.5245588936576	49.4754411063424
07	Balears (Illes)	051	07051	Sant Llorenç des Cardassar	6211	3121	3090	50.2495572371599	49.7504427628401
07	Balears (Illes)	052	07052	Sant Lluís	4395	2220	2175	50.5119453924915	49.4880546075085
07	Balears (Illes)	053	07053	Santa Eugènia	1228	610	618	49.6742671009772	50.3257328990228
07	Balears (Illes)	054	07054	Santa Eulalia del Río	21991	11274	10717	51.2664271747533	48.7335728252467
07	Balears (Illes)	055	07055	Santa Margalida	7943	3953	3990	49.7670905199547	50.2329094800453
07	Balears (Illes)	056	07056	Santa María del Camí	4740	2342	2398	49.4092827004219	50.5907172995781
07	Balears (Illes)	057	07057	Santanyí	8957	4527	4430	50.5414759406051	49.4585240593949
07	Balears (Illes)	058	07058	Selva	2983	1457	1526	48.8434461951056	51.1565538048944
07	Balears (Illes)	059	07059	Salines (Ses)	3528	1804	1724	51.1337868480726	48.8662131519274
07	Balears (Illes)	060	07060	Sineu	2724	1336	1388	49.0455212922173	50.9544787077827
07	Balears (Illes)	061	07061	Sóller	11521	5727	5794	49.7092266296328	50.2907733703672
07	Balears (Illes)	062	07062	Son Servera	9562	4832	4730	50.5333612215018	49.4666387784982
07	Balears (Illes)	063	07063	Valldemosa	1670	810	860	48.502994011976	51.497005988024
07	Balears (Illes)	064	07064	Castell (Es)	6504	3286	3218	50.5227552275523	49.4772447724477
07	Balears (Illes)	065	07065	Vilafranca de Bonany	2366	1162	1204	49.112426035503	50.887573964497
07	Balears (Illes)	901	07901	Ariany	790	397	393	50.253164556962	49.746835443038
07	Balears (Illes)	902	07902	Migjorn Gran (Es)	1148	590	558	51.3937282229965	48.6062717770035
08	Barcelona	001	08001	Abrera	8177	4203	3974	51.4002690473279	48.5997309526721
08	Barcelona	002	08002	Aguilar de Segarra	213	106	107	49.7652582159624	50.2347417840376
08	Barcelona	003	08003	Alella	8413	4180	4233	49.685011292048	50.314988707952
08	Barcelona	004	08004	Alpens	264	140	124	53.030303030303	46.969696969697
08	Barcelona	005	08005	Ametlla del Vallès (L')	5697	2823	2874	49.5523959978936	50.4476040021064
08	Barcelona	006	08006	Arenys de Mar	12610	6046	6564	47.9460745440127	52.0539254559873
08	Barcelona	007	08007	Arenys de Munt	6242	3097	3145	49.6155078500481	50.384492149952
08	Barcelona	008	08008	Argençola	196	105	91	53.5714285714286	46.4285714285714
08	Barcelona	009	08009	Argentona	9482	4706	4776	49.630879561274	50.369120438726
08	Barcelona	010	08010	Artés	4368	2173	2195	49.7481684981685	50.2518315018315
08	Barcelona	011	08011	Avià	1845	930	915	50.4065040650407	49.5934959349593
08	Barcelona	012	08012	Avinyó	1999	977	1022	48.8744372186093	51.1255627813907
08	Barcelona	013	08013	Avinyonet del Penedès	1167	619	548	53.0419880034276	46.9580119965724
08	Barcelona	014	08014	Aiguafreda	2147	1054	1093	49.0917559385189	50.9082440614811
08	Barcelona	015	08015	Badalona	208944	103124	105820	49.3548510605713	50.6451489394287
08	Barcelona	016	08016	Bagà	2078	1004	1074	48.3156881616939	51.6843118383061
08	Barcelona	017	08017	Balenyà	3125	1560	1565	49.92	50.08
08	Barcelona	018	08018	Balsareny	3230	1590	1640	49.2260061919505	50.7739938080495
08	Barcelona	019	08019	Barcelona	1496266	699645	796621	46.7593997324005	53.2406002675995
08	Barcelona	020	08020	Begues	4189	2108	2081	50.3222726187634	49.6777273812366
08	Barcelona	021	08021	Bellprat	95	55	40	57.8947368421053	42.1052631578947
08	Barcelona	022	08022	Berga	14305	6929	7376	48.4376092275428	51.5623907724572
08	Barcelona	023	08023	Bigues i Riells	5436	2848	2588	52.3914643119941	47.6085356880059
08	Barcelona	024	08024	Borredà	485	243	242	50.1030927835052	49.8969072164948
08	Barcelona	025	08025	Bruc (El)	1029	544	485	52.8668610301263	47.1331389698737
08	Barcelona	026	08026	Brull (El)	197	109	88	55.3299492385787	44.6700507614213
08	Barcelona	027	08027	Cabanyes (Les)	544	290	254	53.3088235294118	46.6911764705882
08	Barcelona	028	08028	Cabrera d'Igualada	528	291	237	55.1136363636364	44.8863636363636
08	Barcelona	029	08029	Cabrera de Mar	3716	1899	1817	51.1033369214209	48.8966630785791
08	Barcelona	030	08030	Cabrils	4693	2293	2400	48.8600042616663	51.1399957383337
08	Barcelona	031	08031	Calaf	3016	1500	1516	49.7347480106101	50.2652519893899
08	Barcelona	032	08032	Caldes d'Estrac	1973	951	1022	48.2007095793208	51.7992904206792
08	Barcelona	033	08033	Caldes de Montbui	12464	6149	6315	49.334082156611	50.665917843389
08	Barcelona	034	08034	Calders	763	395	368	51.7693315858453	48.2306684141547
08	Barcelona	035	08035	Calella	13055	6319	6736	48.4029107621601	51.5970892378399
08	Barcelona	036	08036	Calonge de Segarra	196	101	95	51.530612244898	48.469387755102
08	Barcelona	037	08037	Calldetenes	2006	1036	970	51.6450648055833	48.3549351944168
08	Barcelona	038	08038	Callús	1329	661	668	49.7366440933032	50.2633559066968
08	Barcelona	039	08039	Campins	292	150	142	51.3698630136986	48.6301369863014
08	Barcelona	040	08040	Canet de Mar	10138	4946	5192	48.7867429473269	51.2132570526731
08	Barcelona	041	08041	Canovelles	13016	6566	6450	50.4456054087277	49.5543945912723
08	Barcelona	042	08042	Cànoves i Samalús	1870	968	902	51.764705882353	48.2352941176471
08	Barcelona	043	08043	Canyelles	1838	983	855	53.4820457018498	46.5179542981502
08	Barcelona	044	08044	Capellades	4881	2390	2491	48.9653759475517	51.0346240524483
08	Barcelona	045	08045	Capolat	63	38	25	60.3174603174603	39.6825396825397
08	Barcelona	046	08046	Cardedeu	12078	6005	6073	49.7184964398079	50.2815035601921
08	Barcelona	047	08047	Cardona	5567	2707	2860	48.6258307885755	51.3741692114245
08	Barcelona	048	08048	Carme	686	350	336	51.0204081632653	48.9795918367347
08	Barcelona	049	08049	Casserres	1634	778	856	47.6132190942472	52.3867809057528
08	Barcelona	050	08050	Castellar del Riu	114	66	48	57.8947368421053	42.1052631578947
08	Barcelona	051	08051	Castellar del Vallès	17444	8714	8730	49.9541389589544	50.0458610410456
08	Barcelona	052	08052	Castellar de n'Hug	188	97	91	51.5957446808511	48.4042553191489
08	Barcelona	053	08053	Castellbell i el Vilar	2753	1379	1374	50.0908100254268	49.9091899745732
08	Barcelona	054	08054	Castellbisbal	7887	4073	3814	51.6419424369215	48.3580575630785
08	Barcelona	055	08055	Castellcir	366	204	162	55.7377049180328	44.2622950819672
08	Barcelona	056	08056	Castelldefels	45091	22538	22553	49.9833669690182	50.0166330309818
08	Barcelona	057	08057	Castell de l'Areny	48	30	18	62.5	37.5
08	Barcelona	058	08058	Castellet i la Gornal	1404	705	699	50.2136752136752	49.7863247863248
08	Barcelona	059	08059	Castellfollit del Boix	384	186	198	48.4375	51.5625
08	Barcelona	060	08060	Castellfollit de Riubregós	233	117	116	50.2145922746781	49.7854077253219
08	Barcelona	061	08061	Castellgalí	928	477	451	51.4008620689655	48.5991379310345
08	Barcelona	062	08062	Castellnou de Bages	526	276	250	52.4714828897338	47.5285171102662
08	Barcelona	063	08063	Castellolí	427	219	208	51.288056206089	48.711943793911
08	Barcelona	064	08064	Castellterçol	2000	983	1017	49.15	50.85
08	Barcelona	065	08065	Castellví de la Marca	1445	730	715	50.5190311418685	49.4809688581315
08	Barcelona	066	08066	Castellví de Rosanes	1096	563	533	51.3686131386861	48.6313868613139
08	Barcelona	067	08067	Centelles	5793	2851	2942	49.2145693077853	50.7854306922147
08	Barcelona	068	08068	Cervelló	6064	3033	3031	50.0164907651715	49.9835092348285
08	Barcelona	069	08069	Collbató	2099	1124	975	53.5493091948547	46.4506908051453
08	Barcelona	070	08070	Collsuspina	254	137	117	53.9370078740158	46.0629921259843
08	Barcelona	071	08071	Copons	271	128	143	47.2324723247233	52.7675276752767
08	Barcelona	072	08072	Corbera de Llobregat	9090	4636	4454	51.001100110011	48.998899889989
08	Barcelona	073	08073	Cornellà de Llobregat	80998	39716	41282	49.0333094644312	50.9666905355688
08	Barcelona	074	08074	Cubelles	6497	3321	3176	51.1158996459905	48.8841003540095
08	Barcelona	075	08075	Dosrius	2846	1453	1393	51.0541110330288	48.9458889669712
08	Barcelona	076	08076	Esparreguera	17060	8643	8417	50.662368112544	49.337631887456
08	Barcelona	077	08077	Esplugues de Llobregat	45668	22474	23194	49.2117018481212	50.7882981518788
08	Barcelona	078	08078	Espunyola (L')	276	138	138	50	50
08	Barcelona	079	08079	Estany (L')	398	189	209	47.4874371859297	52.5125628140704
08	Barcelona	080	08080	Fígols	50	29	21	58	42
08	Barcelona	081	08081	Fogars de Montclús	350	182	168	52	48
08	Barcelona	082	08082	Fogars de la Selva	692	359	333	51.878612716763	48.121387283237
08	Barcelona	083	08083	Folgueroles	1598	797	801	49.8748435544431	50.125156445557
08	Barcelona	084	08084	Fonollosa	941	476	465	50.5844845908608	49.4155154091392
08	Barcelona	085	08085	Font-rubí	1200	622	578	51.8333333333333	48.1666666666667
08	Barcelona	086	08086	Franqueses del Vallès (Les)	12300	6139	6161	49.9105691056911	50.0894308943089
08	Barcelona	087	08087	Gallifa	156	82	74	52.5641025641026	47.4358974358974
08	Barcelona	088	08088	Garriga (La)	11547	5593	5954	48.4368234173378	51.5631765826622
08	Barcelona	089	08089	Gavà	39220	19524	19696	49.7807241203468	50.2192758796532
08	Barcelona	090	08090	Gaià	168	88	80	52.3809523809524	47.6190476190476
08	Barcelona	091	08091	Gelida	4354	2174	2180	49.9310978410657	50.0689021589343
08	Barcelona	092	08092	Gironella	4867	2349	2518	48.2638175467434	51.7361824532566
08	Barcelona	093	08093	Gisclareny	26	14	12	53.8461538461539	46.1538461538462
08	Barcelona	094	08094	Granada (La)	1329	645	684	48.5327313769752	51.4672686230248
08	Barcelona	095	08095	Granera	59	40	19	67.7966101694915	32.2033898305085
08	Barcelona	096	08096	Granollers	52423	25564	26859	48.7648551208439	51.2351448791561
08	Barcelona	097	08097	Gualba	783	409	374	52.234993614304	47.765006385696
08	Barcelona	098	08098	Sant Salvador de Guardiola	1994	1015	979	50.9027081243731	49.0972918756269
08	Barcelona	099	08099	Guardiola de Berguedà	1013	508	505	50.1480750246792	49.8519249753208
08	Barcelona	100	08100	Gurb	1898	967	931	50.9483667017914	49.0516332982086
08	Barcelona	101	08101	Hospitalet de Llobregat (L')	241782	118140	123642	48.8621981785245	51.1378018214756
08	Barcelona	102	08102	Igualada	32516	15815	16701	48.6375937999754	51.3624062000246
08	Barcelona	103	08103	Jorba	572	273	299	47.7272727272727	52.2727272727273
08	Barcelona	104	08104	Llacuna (La)	849	441	408	51.9434628975265	48.0565371024735
08	Barcelona	105	08105	Llagosta (La)	11933	5968	5965	50.0125701835247	49.9874298164753
08	Barcelona	106	08106	Llinars del Vallès	6877	3469	3408	50.4435073433183	49.5564926566817
08	Barcelona	107	08107	Lliçà d'Amunt	9595	4954	4641	51.6310578426264	48.3689421573736
08	Barcelona	108	08108	Lliçà de Vall	5070	2610	2460	51.4792899408284	48.5207100591716
08	Barcelona	109	08109	Lluçà	288	158	130	54.8611111111111	45.1388888888889
08	Barcelona	110	08110	Malgrat de Mar	13686	6827	6859	49.8830922110186	50.1169077889814
08	Barcelona	111	08111	Malla	255	115	140	45.0980392156863	54.9019607843137
08	Barcelona	112	08112	Manlleu	17520	8722	8798	49.783105022831	50.2168949771689
08	Barcelona	113	08113	Manresa	63742	30608	33134	48.0185748799849	51.9814251200151
08	Barcelona	114	08114	Martorell	21314	10727	10587	50.3284226330112	49.6715773669888
08	Barcelona	115	08115	Martorelles	4895	2450	2445	50.0510725229826	49.9489274770174
08	Barcelona	116	08116	Masies de Roda (Les)	655	327	328	49.9236641221374	50.0763358778626
08	Barcelona	117	08117	Masies de Voltregà (Les)	2703	1309	1394	48.4276729559748	51.5723270440252
08	Barcelona	118	08118	Masnou (El)	21076	10207	10869	48.4294932624787	51.5705067375214
08	Barcelona	119	08119	Masquefa	4582	2331	2251	50.8729812309035	49.1270187690965
08	Barcelona	120	08120	Matadepera	6924	3474	3450	50.1733102253033	49.8266897746967
08	Barcelona	121	08121	Mataró	104659	51324	53335	49.0392608375773	50.9607391624227
08	Barcelona	122	08122	Mediona	1446	745	701	51.521438450899	48.478561549101
08	Barcelona	123	08123	Molins de Rei	19723	9664	10059	48.9986310399027	51.0013689600974
08	Barcelona	124	08124	Mollet del Vallès	46204	23079	23125	49.9502207601074	50.0497792398927
08	Barcelona	125	08125	Montcada i Reixac	27952	13793	14159	49.3453062392673	50.6546937607327
08	Barcelona	126	08126	Montgat	8305	4092	4213	49.271523178808	50.7284768211921
08	Barcelona	127	08127	Monistrol de Montserrat	2490	1261	1229	50.6425702811245	49.3574297188755
08	Barcelona	128	08128	Monistrol de Calders	597	296	301	49.5812395309883	50.4187604690117
08	Barcelona	129	08129	Muntanyola	311	168	143	54.0192926045016	45.9807073954984
08	Barcelona	130	08130	Montclar	117	61	56	52.1367521367522	47.8632478632479
08	Barcelona	131	08131	Montesquiu	844	412	432	48.8151658767773	51.1848341232227
08	Barcelona	132	08132	Montmajor	473	244	229	51.5856236786469	48.4143763213531
08	Barcelona	133	08133	Montmaneu	194	102	92	52.5773195876289	47.4226804123711
08	Barcelona	134	08134	Figaró-Montmany	825	436	389	52.8484848484848	47.1515151515152
08	Barcelona	135	08135	Montmeló	8437	4207	4230	49.8636956264075	50.1363043735925
08	Barcelona	136	08136	Montornès del Vallès	12426	6254	6172	50.3299533236762	49.6700466763238
08	Barcelona	137	08137	Montseny	301	155	146	51.4950166112957	48.5049833887043
08	Barcelona	138	08138	Moià	3988	1961	2027	49.172517552658	50.827482447342
08	Barcelona	139	08139	Mura	217	118	99	54.3778801843318	45.6221198156682
08	Barcelona	140	08140	Navarcles	5318	2641	2677	49.6615268898082	50.3384731101918
08	Barcelona	141	08141	Navàs	5722	2830	2892	49.4582313876267	50.5417686123733
08	Barcelona	142	08142	Nou de Berguedà (La)	153	83	70	54.2483660130719	45.7516339869281
08	Barcelona	143	08143	Òdena	2681	1337	1344	49.8694516971279	50.1305483028721
08	Barcelona	144	08144	Olvan	899	433	466	48.1646273637375	51.8353726362625
08	Barcelona	145	08145	Olèrdola	2232	1141	1091	51.1200716845878	48.8799283154122
08	Barcelona	146	08146	Olesa de Bonesvalls	942	512	430	54.3524416135881	45.6475583864119
08	Barcelona	147	08147	Olesa de Montserrat	17151	8640	8511	50.3760713661011	49.6239286338989
08	Barcelona	148	08148	Olivella	1319	702	617	53.2221379833207	46.7778620166793
08	Barcelona	149	08149	Olost	1160	568	592	48.9655172413793	51.0344827586207
08	Barcelona	150	08150	Orís	226	114	112	50.4424778761062	49.5575221238938
08	Barcelona	151	08151	Oristà	645	314	331	48.6821705426357	51.3178294573643
08	Barcelona	152	08152	Orpí	147	78	69	53.0612244897959	46.9387755102041
08	Barcelona	153	08153	Òrrius	420	220	200	52.3809523809524	47.6190476190476
08	Barcelona	154	08154	Pacs del Penedès	653	325	328	49.7702909647779	50.2297090352221
08	Barcelona	155	08155	Palafolls	5235	2627	2608	50.18147086915	49.8185291308501
08	Barcelona	156	08156	Palau de Plegamans	11089	5653	5436	50.9784471097484	49.0215528902516
08	Barcelona	157	08157	Pallejà	7258	3661	3597	50.4408928079361	49.5591071920639
08	Barcelona	158	08158	Papiol (El)	3464	1721	1743	49.6824480369515	50.3175519630485
08	Barcelona	159	08159	Parets del Vallès	14478	7335	7143	50.6630750103606	49.3369249896394
08	Barcelona	160	08160	Perafita	368	181	187	49.1847826086957	50.8152173913043
08	Barcelona	161	08161	Piera	8540	4361	4179	51.0655737704918	48.9344262295082
08	Barcelona	162	08162	Hostalets de Pierola (Els)	1239	642	597	51.81598062954	48.1840193704601
08	Barcelona	163	08163	Pineda de Mar	20057	10014	10043	49.9277060377923	50.0722939622077
08	Barcelona	164	08164	Pla del Penedès (El)	923	461	462	49.9458288190683	50.0541711809317
08	Barcelona	165	08165	Pobla de Claramunt (La)	1656	846	810	51.0869565217391	48.9130434782609
08	Barcelona	166	08166	Pobla de Lillet (La)	1455	715	740	49.1408934707904	50.8591065292096
08	Barcelona	167	08167	Polinyà	4657	2396	2261	51.44943096414	48.55056903586
08	Barcelona	168	08168	Pontons	363	193	170	53.168044077135	46.831955922865
08	Barcelona	169	08169	Prat de Llobregat (El)	62956	31518	31438	50.0635364381473	49.9364635618527
08	Barcelona	170	08170	Prats de Rei (Els)	537	267	270	49.7206703910615	50.2793296089386
08	Barcelona	171	08171	Prats de Lluçanès	2750	1342	1408	48.8	51.2
08	Barcelona	172	08172	Premià de Mar	26130	13005	13125	49.7703788748565	50.2296211251435
08	Barcelona	174	08174	Puigdàlber	333	150	183	45.0450450450451	54.954954954955
08	Barcelona	175	08175	Puig-reig	4319	2087	2232	48.3213706876592	51.6786293123408
08	Barcelona	176	08176	Pujalt	178	92	86	51.685393258427	48.314606741573
08	Barcelona	177	08177	Quar (La)	79	41	38	51.8987341772152	48.1012658227848
08	Barcelona	178	08178	Rajadell	456	234	222	51.3157894736842	48.6842105263158
08	Barcelona	179	08179	Rellinars	378	194	184	51.3227513227513	48.6772486772487
08	Barcelona	180	08180	Ripollet	29877	14935	14942	49.988285303076	50.0117146969241
08	Barcelona	181	08181	Roca del Vallès (La)	7380	3714	3666	50.3252032520325	49.6747967479675
08	Barcelona	182	08182	Pont de Vilomara i Rocafort (El)	2614	1345	1269	51.4537107880643	48.5462892119357
08	Barcelona	183	08183	Roda de Ter	5148	2483	2665	48.2323232323232	51.7676767676768
08	Barcelona	184	08184	Rubí	58646	29391	29255	50.1159499369096	49.8840500630904
08	Barcelona	185	08185	Rubió	120	68	52	56.6666666666667	43.3333333333333
08	Barcelona	187	08187	Sabadell	183727	89079	94648	48.4844361471096	51.5155638528904
08	Barcelona	188	08188	Sagàs	155	80	75	51.6129032258065	48.3870967741936
08	Barcelona	189	08189	Sant Pere Sallavinera	155	78	77	50.3225806451613	49.6774193548387
08	Barcelona	190	08190	Saldes	328	183	145	55.7926829268293	44.2073170731707
08	Barcelona	191	08191	Sallent	7159	3449	3710	48.1771197094566	51.8228802905434
08	Barcelona	192	08192	Santpedor	5352	2611	2741	48.7855007473842	51.2144992526159
08	Barcelona	193	08193	Sant Iscle de Vallalta	839	435	404	51.8474374255066	48.1525625744934
08	Barcelona	194	08194	Sant Adrià de Besòs	32452	15946	16506	49.137187230371	50.862812769629
08	Barcelona	195	08195	Sant Agustí de Lluçanès	121	65	56	53.7190082644628	46.2809917355372
08	Barcelona	196	08196	Sant Andreu de la Barca	20140	10277	9863	51.0278053624628	48.9721946375372
08	Barcelona	197	08197	Sant Andreu de Llavaneres	7161	3579	3582	49.9790532048597	50.0209467951403
08	Barcelona	198	08198	Sant Antoni de Vilamajor	3293	1655	1638	50.2581232918312	49.7418767081688
08	Barcelona	199	08199	Sant Bartomeu del Grau	1150	603	547	52.4347826086957	47.5652173913044
08	Barcelona	200	08200	Sant Boi de Llobregat	79337	39419	39918	49.685518736529	50.314481263471
08	Barcelona	201	08201	Sant Boi de Lluçanès	540	273	267	50.5555555555556	49.4444444444444
08	Barcelona	202	08202	Sant Celoni	12734	6302	6432	49.4895555206534	50.5104444793466
08	Barcelona	203	08203	Sant Cebrià de Vallalta	1757	945	812	53.7848605577689	46.2151394422311
08	Barcelona	204	08204	Sant Climent de Llobregat	2950	1473	1477	49.9322033898305	50.0677966101695
08	Barcelona	205	08205	Sant Cugat del Vallès	52654	25939	26715	49.2631139134729	50.7368860865271
08	Barcelona	206	08206	Sant Cugat Sesgarrigues	731	375	356	51.2995896032832	48.7004103967168
08	Barcelona	207	08207	Sant Esteve de Palautordera	1461	737	724	50.444900752909	49.555099247091
08	Barcelona	208	08208	Sant Esteve Sesrovires	5161	2702	2459	52.3541949234645	47.6458050765356
08	Barcelona	209	08209	Sant Fost de Campsentelles	6312	3206	3106	50.7921419518378	49.2078580481622
08	Barcelona	210	08210	Sant Feliu de Codines	4290	2135	2155	49.7668997668998	50.2331002331002
08	Barcelona	211	08211	Sant Feliu de Llobregat	38435	18972	19463	49.3612592688955	50.6387407311045
08	Barcelona	212	08212	Sant Feliu Sasserra	657	321	336	48.8584474885845	51.1415525114155
08	Barcelona	213	08213	Sant Fruitós de Bages	5542	2772	2770	50.0180440274269	49.9819559725731
08	Barcelona	214	08214	Vilassar de Dalt	7484	3717	3767	49.6659540352753	50.3340459647248
08	Barcelona	215	08215	Sant Hipòlit de Voltregà	3005	1485	1520	49.4176372712146	50.5823627287854
08	Barcelona	216	08216	Sant Jaume de Frontanyà	28	15	13	53.5714285714286	46.4285714285714
08	Barcelona	217	08217	Sant Joan Despí	27627	13638	13989	49.3647518731676	50.6352481268324
08	Barcelona	218	08218	Sant Joan de Vilatorrada	9145	4570	4575	49.9726626571897	50.0273373428103
08	Barcelona	219	08219	Vilassar de Mar	17000	8327	8673	48.9823529411765	51.0176470588235
08	Barcelona	220	08220	Sant Julià de Vilatorta	2269	1106	1163	48.7439400617012	51.2560599382988
08	Barcelona	221	08221	Sant Just Desvern	14030	6763	7267	48.2038488952245	51.7961511047755
08	Barcelona	222	08222	Sant Llorenç d'Hortons	1547	775	772	50.0969618616677	49.9030381383323
08	Barcelona	223	08223	Sant Llorenç Savall	1983	988	995	49.8234997478568	50.1765002521432
08	Barcelona	224	08224	Sant Martí de Centelles	729	378	351	51.8518518518519	48.1481481481482
08	Barcelona	225	08225	Sant Martí d'Albars	132	64	68	48.4848484848485	51.5151515151515
08	Barcelona	226	08226	Sant Martí de Tous	982	494	488	50.3054989816701	49.6945010183299
08	Barcelona	227	08227	Sant Martí Sarroca	2478	1229	1249	49.5964487489911	50.4035512510089
08	Barcelona	228	08228	Sant Martí Sesgueioles	342	170	172	49.7076023391813	50.2923976608187
08	Barcelona	229	08229	Sant Mateu de Bages	491	252	239	51.3238289205703	48.6761710794297
08	Barcelona	230	08230	Premià de Dalt	8869	4443	4426	50.0958394407487	49.9041605592513
08	Barcelona	231	08231	Sant Pere de Ribes	21976	11111	10865	50.5597014925373	49.4402985074627
08	Barcelona	232	08232	Sant Pere de Riudebitlles	2076	1023	1053	49.2774566473988	50.7225433526012
08	Barcelona	233	08233	Sant Pere de Torelló	2160	1054	1106	48.7962962962963	51.2037037037037
08	Barcelona	234	08234	Sant Pere de Vilamajor	2547	1329	1218	52.1790341578327	47.8209658421673
08	Barcelona	235	08235	Sant Pol de Mar	3594	1863	1731	51.8363939899833	48.1636060100167
08	Barcelona	236	08236	Sant Quintí de Mediona	1679	826	853	49.1959499702204	50.8040500297796
08	Barcelona	237	08237	Sant Quirze de Besora	1978	970	1008	49.0394337714864	50.9605662285137
08	Barcelona	238	08238	Sant Quirze del Vallès	12706	6358	6348	50.0393514874862	49.9606485125138
08	Barcelona	239	08239	Sant Quirze Safaja	369	197	172	53.3875338753388	46.6124661246612
08	Barcelona	240	08240	Sant Sadurní d'Anoia	9539	4734	4805	49.6278435894748	50.3721564105252
08	Barcelona	241	08241	Sant Sadurní d'Osormort	76	41	35	53.9473684210526	46.0526315789474
08	Barcelona	242	08242	Marganell	243	108	135	44.4444444444444	55.5555555555556
08	Barcelona	243	08243	Santa Cecília de Voltregà	202	112	90	55.4455445544555	44.5544554455446
08	Barcelona	244	08244	Santa Coloma de Cervelló	4691	2351	2340	50.1172457898103	49.8827542101897
08	Barcelona	245	08245	Santa Coloma de Gramenet	117127	58139	58988	49.6375728909645	50.3624271090355
08	Barcelona	246	08246	Santa Eugènia de Berga	1946	987	959	50.7194244604317	49.2805755395684
08	Barcelona	247	08247	Santa Eulàlia de Riuprimer	864	449	415	51.9675925925926	48.0324074074074
08	Barcelona	248	08248	Santa Eulàlia de Ronçana	4536	2291	2245	50.5070546737213	49.4929453262787
08	Barcelona	249	08249	Santa Fe del Penedès	293	145	148	49.4880546075085	50.5119453924915
08	Barcelona	250	08250	Santa Margarida de Montbui	9123	4541	4582	49.7752932149512	50.2247067850488
08	Barcelona	251	08251	Santa Margarida i els Monjos	4661	2370	2291	50.8474576271186	49.1525423728814
08	Barcelona	252	08252	Barberà del Vallès	26681	13393	13288	50.1967692365354	49.8032307634646
08	Barcelona	253	08253	Santa Maria de Besora	183	93	90	50.8196721311475	49.1803278688525
08	Barcelona	254	08254	Santa Maria de Corcó	2088	1042	1046	49.904214559387	50.095785440613
08	Barcelona	255	08255	Santa Maria de Merlès	168	88	80	52.3809523809524	47.6190476190476
08	Barcelona	256	08256	Santa Maria de Martorelles	700	340	360	48.5714285714286	51.4285714285714
08	Barcelona	257	08257	Santa Maria de Miralles	88	44	44	50	50
08	Barcelona	258	08258	Santa Maria d'Oló	1006	519	487	51.5904572564612	48.4095427435388
08	Barcelona	259	08259	Santa Maria de Palautordera	6306	3193	3113	50.6343165239454	49.3656834760546
08	Barcelona	260	08260	Santa Perpètua de Mogoda	19084	9630	9454	50.4611192622092	49.5388807377908
08	Barcelona	261	08261	Santa Susanna	1908	987	921	51.7295597484277	48.2704402515723
08	Barcelona	262	08262	Sant Vicenç de Castellet	7212	3457	3755	47.9339988907377	52.0660011092623
08	Barcelona	263	08263	Sant Vicenç dels Horts	24438	12273	12165	50.2209673459367	49.7790326540633
08	Barcelona	264	08264	Sant Vicenç de Montalt	3334	1701	1633	51.0197960407919	48.9802039592082
08	Barcelona	265	08265	Sant Vicenç de Torelló	1786	863	923	48.3202687569989	51.6797312430011
08	Barcelona	266	08266	Cerdanyola del Vallès	52778	26403	26375	50.0265262041002	49.9734737958998
08	Barcelona	267	08267	Sentmenat	5675	2823	2852	49.7444933920705	50.2555066079295
08	Barcelona	268	08268	Cercs	1454	727	727	50	50
08	Barcelona	269	08269	Seva	2510	1284	1226	51.1553784860558	48.8446215139442
08	Barcelona	270	08270	Sitges	19448	5458	13990	28.0645824763472	71.9354175236528
08	Barcelona	271	08271	Sobremunt	87	41	46	47.1264367816092	52.8735632183908
08	Barcelona	272	08272	Sora	189	103	86	54.4973544973545	45.5026455026455
08	Barcelona	273	08273	Subirats	2529	1273	1256	50.3361012257809	49.6638987742191
08	Barcelona	274	08274	Súria	6157	3026	3131	49.1473120025987	50.8526879974013
08	Barcelona	275	08275	Tavèrnoles	272	132	140	48.5294117647059	51.4705882352941
08	Barcelona	276	08276	Tagamanent	195	107	88	54.8717948717949	45.1282051282051
08	Barcelona	277	08277	Talamanca	107	61	46	57.0093457943925	42.9906542056075
08	Barcelona	278	08278	Taradell	5000	2484	2516	49.68	50.32
08	Barcelona	279	08279	Terrassa	171794	83957	87837	48.8707405380863	51.1292594619137
08	Barcelona	280	08280	Tavertet	140	75	65	53.5714285714286	46.4285714285714
08	Barcelona	281	08281	Teià	5280	2657	2623	50.3219696969697	49.6780303030303
08	Barcelona	282	08282	Tiana	5663	2804	2859	49.5143916651951	50.4856083348049
08	Barcelona	283	08283	Tona	5868	2914	2954	49.6591683708248	50.3408316291752
08	Barcelona	284	08284	Tordera	9798	4961	4837	50.6327822004491	49.3672177995509
08	Barcelona	285	08285	Torelló	12150	5913	6237	48.6666666666667	51.3333333333333
08	Barcelona	286	08286	Torre de Claramunt (La)	2371	1228	1143	51.792492619148	48.207507380852
08	Barcelona	287	08287	Torrelavit	1172	597	575	50.938566552901	49.061433447099
08	Barcelona	288	08288	Torrelles de Foix	1684	896	788	53.2066508313539	46.7933491686461
08	Barcelona	289	08289	Torrelles de Llobregat	3574	1820	1754	50.923335198657	49.076664801343
08	Barcelona	290	08290	Ullastrell	1114	571	543	51.2567324955117	48.7432675044883
08	Barcelona	291	08291	Vacarisses	2687	1419	1268	52.8098250837365	47.1901749162635
08	Barcelona	292	08292	Vallbona d'Anoia	1089	558	531	51.2396694214876	48.7603305785124
08	Barcelona	293	08293	Vallcebre	269	142	127	52.7881040892193	47.2118959107807
08	Barcelona	294	08294	Vallgorguina	1325	698	627	52.6792452830189	47.3207547169811
08	Barcelona	295	08295	Vallirana	9004	4564	4440	50.6885828520657	49.3114171479342
08	Barcelona	296	08296	Vallromanes	1374	711	663	51.7467248908297	48.2532751091703
08	Barcelona	297	08297	Veciana	154	83	71	53.8961038961039	46.1038961038961
08	Barcelona	298	08298	Vic	31533	15191	16342	48.17492785336	51.82507214664
08	Barcelona	299	08299	Vilada	522	266	256	50.9578544061303	49.0421455938697
08	Barcelona	300	08300	Viladecavalls	5755	2904	2851	50.4604691572546	49.5395308427454
08	Barcelona	301	08301	Viladecans	56112	28262	27850	50.367122897063	49.632877102937
08	Barcelona	302	08302	Vilanova del Camí	10203	5127	5076	50.2499264922082	49.7500735077918
08	Barcelona	303	08303	Vilanova de Sau	320	150	170	46.875	53.125
08	Barcelona	304	08304	Vilobí del Penedès	874	450	424	51.487414187643	48.512585812357
08	Barcelona	305	08305	Vilafranca del Penedès	30024	14744	15280	49.107380762057	50.892619237943
08	Barcelona	306	08306	Vilalba Sasserra	454	245	209	53.9647577092511	46.0352422907489
08	Barcelona	307	08307	Vilanova i la Geltrú	52389	25734	26655	49.1209986829296	50.8790013170704
08	Barcelona	308	08308	Viver i Serrateix	188	96	92	51.063829787234	48.936170212766
08	Barcelona	901	08901	Rupit i Pruit	354	178	176	50.2824858757062	49.7175141242938
08	Barcelona	902	08902	Vilanova del Vallès	2314	1174	1140	50.7346585998271	49.2653414001729
08	Barcelona	903	08903	Sant Julià de Cerdanyola	227	122	105	53.7444933920705	46.2555066079295
08	Barcelona	904	08904	Badia del Vallès	15533	7825	7708	50.3766175239812	49.6233824760188
08	Barcelona	905	08905	Palma de Cervelló (La)	2607	1319	1288	50.5945531261987	49.4054468738013
09	Burgos	001	09001	Abajas	48	26	22	54.1666666666667	45.8333333333333
09	Burgos	003	09003	Adrada de Haza	286	157	129	54.8951048951049	45.1048951048951
09	Burgos	006	09006	Aguas Cándidas	93	55	38	59.1397849462366	40.8602150537634
09	Burgos	007	09007	Aguilar de Bureba	86	44	42	51.1627906976744	48.8372093023256
09	Burgos	009	09009	Albillos	158	88	70	55.6962025316456	44.3037974683544
09	Burgos	010	09010	Alcocero de Mola	54	33	21	61.1111111111111	38.8888888888889
09	Burgos	011	09011	Alfoz de Bricia	149	76	73	51.006711409396	48.993288590604
09	Burgos	012	09012	Alfoz de Santa Gadea	179	85	94	47.4860335195531	52.5139664804469
09	Burgos	013	09013	Altable	58	36	22	62.0689655172414	37.9310344827586
09	Burgos	014	09014	Altos (Los)	230	136	94	59.1304347826087	40.8695652173913
09	Burgos	016	09016	Ameyugo	77	40	37	51.9480519480519	48.0519480519481
09	Burgos	017	09017	Anguix	150	74	76	49.3333333333333	50.6666666666667
09	Burgos	018	09018	Aranda de Duero	29762	14842	14920	49.8689604193267	50.1310395806734
09	Burgos	019	09019	Arandilla	206	123	83	59.7087378640777	40.2912621359223
09	Burgos	020	09020	Arauzo de Miel	395	216	179	54.6835443037975	45.3164556962025
09	Burgos	021	09021	Arauzo de Salce	75	41	34	54.6666666666667	45.3333333333333
09	Burgos	022	09022	Arauzo de Torre	109	62	47	56.8807339449541	43.1192660550459
09	Burgos	023	09023	Arcos	276	149	127	53.9855072463768	46.0144927536232
09	Burgos	024	09024	Arenillas de Riopisuerga	238	127	111	53.3613445378151	46.6386554621849
09	Burgos	025	09025	Arija	221	110	111	49.7737556561086	50.2262443438914
09	Burgos	026	09026	Arlanzón	404	219	185	54.2079207920792	45.7920792079208
09	Burgos	027	09027	Arraya de Oca	54	27	27	50	50
09	Burgos	029	09029	Atapuerca	202	104	98	51.4851485148515	48.5148514851485
09	Burgos	030	09030	Ausines (Los)	144	79	65	54.8611111111111	45.1388888888889
09	Burgos	032	09032	Avellanosa de Muñó	162	85	77	52.4691358024691	47.5308641975309
09	Burgos	033	09033	Bahabón de Esgueva	139	81	58	58.273381294964	41.726618705036
09	Burgos	034	09034	Balbases (Los)	368	191	177	51.9021739130435	48.0978260869565
09	Burgos	035	09035	Baños de Valdearados	464	254	210	54.7413793103448	45.2586206896552
09	Burgos	036	09036	Bañuelos de Bureba	45	28	17	62.2222222222222	37.7777777777778
09	Burgos	037	09037	Barbadillo de Herreros	151	85	66	56.2913907284768	43.7086092715232
09	Burgos	038	09038	Barbadillo del Mercado	167	94	73	56.2874251497006	43.7125748502994
09	Burgos	039	09039	Barbadillo del Pez	107	58	49	54.2056074766355	45.7943925233645
09	Burgos	041	09041	Barrio de Muñó	36	21	15	58.3333333333333	41.6666666666667
09	Burgos	043	09043	Barrios de Bureba (Los)	266	144	122	54.1353383458647	45.8646616541353
09	Burgos	044	09044	Barrios de Colina	76	42	34	55.2631578947369	44.7368421052632
09	Burgos	045	09045	Basconcillos del Tozo	373	204	169	54.6916890080429	45.3083109919571
09	Burgos	046	09046	Bascuñana	66	36	30	54.5454545454545	45.4545454545455
09	Burgos	047	09047	Belbimbre	75	41	34	54.6666666666667	45.3333333333333
09	Burgos	048	09048	Belorado	2093	1057	1036	50.5016722408027	49.4983277591973
09	Burgos	050	09050	Berberana	89	43	46	48.314606741573	51.685393258427
09	Burgos	051	09051	Berlangas de Roa	264	137	127	51.8939393939394	48.1060606060606
09	Burgos	052	09052	Berzosa de Bureba	53	32	21	60.377358490566	39.622641509434
09	Burgos	054	09054	Bozoó	115	61	54	53.0434782608696	46.9565217391304
09	Burgos	055	09055	Brazacorta	100	56	44	56	44
09	Burgos	056	09056	Briviesca	6235	3102	3133	49.7514033680834	50.2485966319166
09	Burgos	057	09057	Bugedo	100	73	27	73	27
09	Burgos	058	09058	Buniel	188	107	81	56.9148936170213	43.0851063829787
09	Burgos	059	09059	Burgos	163358	78740	84618	48.2008839481385	51.7991160518616
09	Burgos	060	09060	Busto de Bureba	229	122	107	53.2751091703057	46.7248908296943
09	Burgos	061	09061	Cabañes de Esgueva	268	143	125	53.3582089552239	46.6417910447761
09	Burgos	062	09062	Cabezón de la Sierra	73	32	41	43.8356164383562	56.1643835616438
09	Burgos	063	09063	Cabia	244	136	108	55.7377049180328	44.2622950819672
09	Burgos	064	09064	Caleruega	401	213	188	53.1172069825436	46.8827930174564
09	Burgos	065	09065	Campillo de Aranda	188	102	86	54.2553191489362	45.7446808510638
09	Burgos	066	09066	Campolara	97	53	44	54.639175257732	45.360824742268
09	Burgos	067	09067	Canicosa de la Sierra	645	338	307	52.4031007751938	47.5968992248062
09	Burgos	068	09068	Cantabrana	52	28	24	53.8461538461539	46.1538461538462
09	Burgos	070	09070	Carazo	48	28	20	58.3333333333333	41.6666666666667
09	Burgos	071	09071	Carcedo de Bureba	49	27	22	55.1020408163265	44.8979591836735
09	Burgos	072	09072	Carcedo de Burgos	152	90	62	59.2105263157895	40.7894736842105
09	Burgos	073	09073	Cardeñadijo	531	277	254	52.165725047081	47.834274952919
09	Burgos	074	09074	Cardeñajimeno	444	239	205	53.8288288288288	46.1711711711712
09	Burgos	075	09075	Cardeñuela Riopico	89	47	42	52.8089887640449	47.1910112359551
09	Burgos	076	09076	Carrias	50	34	16	68	32
09	Burgos	077	09077	Cascajares de Bureba	62	35	27	56.4516129032258	43.5483870967742
09	Burgos	078	09078	Cascajares de la Sierra	28	11	17	39.2857142857143	60.7142857142857
09	Burgos	079	09079	Castellanos de Castro	68	38	30	55.8823529411765	44.1176470588235
09	Burgos	082	09082	Castildelgado	82	40	42	48.7804878048781	51.219512195122
09	Burgos	083	09083	Castil de Peones	33	16	17	48.4848484848485	51.5151515151515
09	Burgos	084	09084	Castrillo de la Reina	285	173	112	60.7017543859649	39.2982456140351
09	Burgos	085	09085	Castrillo de la Vega	592	313	279	52.8716216216216	47.1283783783784
09	Burgos	086	09086	Castrillo del Val	411	235	176	57.1776155717762	42.8223844282238
09	Burgos	088	09088	Castrillo de Riopisuerga	88	46	42	52.2727272727273	47.7272727272727
09	Burgos	090	09090	Castrillo Matajudíos	78	37	41	47.4358974358974	52.5641025641026
09	Burgos	091	09091	Castrojeriz	996	507	489	50.9036144578313	49.0963855421687
09	Burgos	093	09093	Cayuela	118	69	49	58.4745762711864	41.5254237288136
09	Burgos	094	09094	Cebrecos	80	46	34	57.5	42.5
09	Burgos	095	09095	Celada del Camino	99	45	54	45.4545454545455	54.5454545454545
09	Burgos	098	09098	Cerezo de Río Tirón	771	411	360	53.307392996109	46.692607003891
09	Burgos	100	09100	Cerratón de Juarros	81	45	36	55.5555555555556	44.4444444444444
09	Burgos	101	09101	Ciadoncha	124	71	53	57.258064516129	42.741935483871
09	Burgos	102	09102	Cillaperlata	64	34	30	53.125	46.875
09	Burgos	103	09103	Cilleruelo de Abajo	325	181	144	55.6923076923077	44.3076923076923
09	Burgos	104	09104	Cilleruelo de Arriba	82	45	37	54.8780487804878	45.1219512195122
09	Burgos	105	09105	Ciruelos de Cervera	166	90	76	54.2168674698795	45.7831325301205
09	Burgos	108	09108	Cogollos	242	131	111	54.1322314049587	45.8677685950413
09	Burgos	109	09109	Condado de Treviño	929	520	409	55.9741657696448	44.0258342303552
09	Burgos	110	09110	Contreras	119	75	44	63.0252100840336	36.9747899159664
09	Burgos	112	09112	Coruña del Conde	173	98	75	56.6473988439306	43.3526011560694
09	Burgos	113	09113	Covarrubias	629	333	296	52.9411764705882	47.0588235294118
09	Burgos	114	09114	Cubillo del Campo	72	38	34	52.7777777777778	47.2222222222222
09	Burgos	115	09115	Cubo de Bureba	113	56	57	49.5575221238938	50.4424778761062
09	Burgos	117	09117	Cueva de Roa (La)	120	64	56	53.3333333333333	46.6666666666667
09	Burgos	119	09119	Cuevas de San Clemente	58	27	31	46.551724137931	53.448275862069
09	Burgos	120	09120	Encío	67	35	32	52.2388059701493	47.7611940298507
09	Burgos	122	09122	Espinosa de Cervera	110	66	44	60	40
09	Burgos	123	09123	Espinosa del Camino	45	24	21	53.3333333333333	46.6666666666667
09	Burgos	124	09124	Espinosa de los Monteros	2173	1110	1063	51.0814542107685	48.9185457892315
09	Burgos	125	09125	Estépar	857	467	390	54.4924154025671	45.5075845974329
09	Burgos	127	09127	Fontioso	82	45	37	54.8780487804878	45.1219512195122
09	Burgos	128	09128	Frandovínez	91	48	43	52.7472527472528	47.2527472527472
09	Burgos	129	09129	Fresneda de la Sierra Tirón	100	55	45	55	45
09	Burgos	130	09130	Fresneña	117	61	56	52.1367521367522	47.8632478632479
09	Burgos	131	09131	Fresnillo de las Dueñas	313	161	152	51.4376996805112	48.5623003194888
09	Burgos	132	09132	Fresno de Río Tirón	266	151	115	56.7669172932331	43.2330827067669
09	Burgos	133	09133	Fresno de Rodilla	52	29	23	55.7692307692308	44.2307692307692
09	Burgos	134	09134	Frías	276	144	132	52.1739130434783	47.8260869565217
09	Burgos	135	09135	Fuentebureba	82	41	41	50	50
09	Burgos	136	09136	Fuentecén	276	155	121	56.1594202898551	43.8405797101449
09	Burgos	137	09137	Fuentelcésped	191	92	99	48.1675392670157	51.8324607329843
09	Burgos	138	09138	Fuentelisendo	125	65	60	52	48
09	Burgos	139	09139	Fuentemolinos	123	71	52	57.7235772357724	42.2764227642277
09	Burgos	140	09140	Fuentenebro	199	106	93	53.2663316582915	46.7336683417086
09	Burgos	141	09141	Fuentespina	577	311	266	53.8994800693241	46.1005199306759
09	Burgos	143	09143	Galbarros	34	23	11	67.6470588235294	32.3529411764706
09	Burgos	144	09144	Gallega (La)	90	49	41	54.4444444444444	45.5555555555556
09	Burgos	148	09148	Grijalba	133	65	68	48.8721804511278	51.1278195488722
09	Burgos	149	09149	Grisaleña	47	30	17	63.8297872340426	36.1702127659575
09	Burgos	151	09151	Gumiel de Izán	610	326	284	53.4426229508197	46.5573770491803
09	Burgos	152	09152	Gumiel de Mercado	370	203	167	54.8648648648649	45.1351351351351
09	Burgos	154	09154	Hacinas	209	115	94	55.0239234449761	44.9760765550239
09	Burgos	155	09155	Haza	41	21	20	51.219512195122	48.7804878048781
09	Burgos	159	09159	Hontanas	69	39	30	56.5217391304348	43.4782608695652
09	Burgos	160	09160	Hontangas	152	88	64	57.8947368421053	42.1052631578947
09	Burgos	162	09162	Hontoria de la Cantera	127	62	65	48.8188976377953	51.1811023622047
09	Burgos	163	09163	Hontoria del Pinar	890	479	411	53.8202247191011	46.1797752808989
09	Burgos	164	09164	Hontoria de Valdearados	221	139	82	62.89592760181	37.10407239819
09	Burgos	166	09166	Hormazas (Las)	147	81	66	55.1020408163265	44.8979591836735
09	Burgos	167	09167	Hornillos del Camino	74	40	34	54.0540540540541	45.945945945946
09	Burgos	168	09168	Horra (La)	452	237	215	52.4336283185841	47.5663716814159
09	Burgos	169	09169	Hortigüela	132	84	48	63.6363636363636	36.3636363636364
09	Burgos	170	09170	Hoyales de Roa	299	145	154	48.494983277592	51.505016722408
09	Burgos	172	09172	Huérmeces	157	86	71	54.7770700636943	45.2229299363057
09	Burgos	173	09173	Huerta de Arriba	194	101	93	52.0618556701031	47.9381443298969
09	Burgos	174	09174	Huerta de Rey	1173	607	566	51.7476555839727	48.2523444160273
09	Burgos	175	09175	Humada	233	138	95	59.2274678111588	40.7725321888412
09	Burgos	176	09176	Hurones	58	37	21	63.7931034482759	36.2068965517241
09	Burgos	177	09177	Ibeas de Juarros	998	549	449	55.0100200400802	44.9899799599198
09	Burgos	178	09178	Ibrillos	99	58	41	58.5858585858586	41.4141414141414
09	Burgos	179	09179	Iglesiarrubia	63	34	29	53.968253968254	46.031746031746
09	Burgos	180	09180	Iglesias	187	105	82	56.1497326203209	43.8502673796791
09	Burgos	181	09181	Isar	423	196	227	46.3356973995272	53.6643026004728
09	Burgos	182	09182	Itero del Castillo	124	66	58	53.2258064516129	46.7741935483871
09	Burgos	183	09183	Jaramillo de la Fuente	36	21	15	58.3333333333333	41.6666666666667
09	Burgos	184	09184	Jaramillo Quemado	15	10	5	66.6666666666667	33.3333333333333
09	Burgos	189	09189	Junta de Traslaloma	190	102	88	53.6842105263158	46.3157894736842
09	Burgos	190	09190	Junta de Villalba de Losa	97	47	50	48.4536082474227	51.5463917525773
09	Burgos	191	09191	Jurisdicción de Lara	66	37	29	56.0606060606061	43.9393939393939
09	Burgos	192	09192	Jurisdicción de San Zadornil	91	40	51	43.956043956044	56.043956043956
09	Burgos	194	09194	Lerma	2518	1254	1264	49.801429706116	50.198570293884
09	Burgos	195	09195	Llano de Bureba	57	35	22	61.4035087719298	38.5964912280702
09	Burgos	196	09196	Madrigal del Monte	211	114	97	54.0284360189574	45.9715639810427
09	Burgos	197	09197	Madrigalejo del Monte	160	90	70	56.25	43.75
09	Burgos	198	09198	Mahamud	168	83	85	49.4047619047619	50.5952380952381
09	Burgos	199	09199	Mambrilla de Castrejón	152	79	73	51.9736842105263	48.0263157894737
09	Burgos	200	09200	Mambrillas de Lara	78	39	39	50	50
09	Burgos	201	09201	Mamolar	72	37	35	51.3888888888889	48.6111111111111
09	Burgos	202	09202	Manciles	47	25	22	53.1914893617021	46.8085106382979
09	Burgos	206	09206	Mazuela	88	46	42	52.2727272727273	47.7272727272727
09	Burgos	208	09208	Mecerreyes	325	168	157	51.6923076923077	48.3076923076923
09	Burgos	209	09209	Medina de Pomar	5166	2618	2548	50.6775067750677	49.3224932249323
09	Burgos	211	09211	Melgar de Fernamental	2021	1036	985	51.2617516081148	48.7382483918852
09	Burgos	213	09213	Merindad de Cuesta-Urria	516	289	227	56.0077519379845	43.9922480620155
09	Burgos	214	09214	Merindad de Montija	949	507	442	53.4246575342466	46.5753424657534
09	Burgos	215	09215	Merindad de Sotoscueva	593	326	267	54.9747048903879	45.0252951096121
09	Burgos	216	09216	Merindad de Valdeporres	565	291	274	51.5044247787611	48.4955752212389
09	Burgos	217	09217	Merindad de Valdivielso	546	286	260	52.3809523809524	47.6190476190476
09	Burgos	218	09218	Milagros	456	245	211	53.7280701754386	46.2719298245614
09	Burgos	219	09219	Miranda de Ebro	35631	17587	18044	49.3587044988914	50.6412955011086
09	Burgos	220	09220	Miraveche	119	70	49	58.8235294117647	41.1764705882353
09	Burgos	221	09221	Modúbar de la Emparedada	256	139	117	54.296875	45.703125
09	Burgos	223	09223	Monasterio de la Sierra	40	23	17	57.5	42.5
09	Burgos	224	09224	Monasterio de Rodilla	219	118	101	53.8812785388128	46.1187214611872
09	Burgos	225	09225	Moncalvillo	126	74	52	58.7301587301587	41.2698412698413
09	Burgos	226	09226	Monterrubio de la Demanda	87	50	37	57.4712643678161	42.5287356321839
09	Burgos	227	09227	Montorio	166	86	80	51.8072289156626	48.1927710843374
09	Burgos	228	09228	Moradillo de Roa	231	124	107	53.6796536796537	46.3203463203463
09	Burgos	229	09229	Nava de Roa	270	142	128	52.5925925925926	47.4074074074074
09	Burgos	230	09230	Navas de Bureba	51	26	25	50.9803921568627	49.0196078431373
09	Burgos	231	09231	Nebreda	107	68	39	63.5514018691589	36.4485981308411
09	Burgos	232	09232	Neila	233	117	116	50.2145922746781	49.7854077253219
09	Burgos	235	09235	Olmedillo de Roa	206	109	97	52.9126213592233	47.0873786407767
09	Burgos	236	09236	Olmillos de Muñó	46	24	22	52.1739130434783	47.8260869565217
09	Burgos	238	09238	Oña	1620	822	798	50.7407407407407	49.2592592592593
09	Burgos	239	09239	Oquillas	77	43	34	55.8441558441558	44.1558441558442
09	Burgos	241	09241	Orbaneja Riopico	160	93	67	58.125	41.875
09	Burgos	242	09242	Padilla de Abajo	107	64	43	59.8130841121495	40.1869158878505
09	Burgos	243	09243	Padilla de Arriba	132	70	62	53.030303030303	46.969696969697
09	Burgos	244	09244	Padrones de Bureba	73	40	33	54.7945205479452	45.2054794520548
09	Burgos	246	09246	Palacios de la Sierra	880	452	428	51.3636363636364	48.6363636363636
09	Burgos	247	09247	Palacios de Riopisuerga	33	17	16	51.5151515151515	48.4848484848485
09	Burgos	248	09248	Palazuelos de la Sierra	70	39	31	55.7142857142857	44.2857142857143
09	Burgos	249	09249	Palazuelos de Muñó	66	39	27	59.0909090909091	40.9090909090909
09	Burgos	250	09250	Pampliega	412	209	203	50.7281553398058	49.2718446601942
09	Burgos	251	09251	Pancorbo	491	258	233	52.5458248472505	47.4541751527495
09	Burgos	253	09253	Pardilla	121	64	57	52.8925619834711	47.1074380165289
09	Burgos	255	09255	Partido de la Sierra en Tobalina	77	48	29	62.3376623376623	37.6623376623377
09	Burgos	256	09256	Pedrosa de Duero	558	289	269	51.7921146953405	48.2078853046595
09	Burgos	257	09257	Pedrosa del Páramo	119	67	52	56.3025210084034	43.6974789915966
09	Burgos	258	09258	Pedrosa del Príncipe	245	128	117	52.2448979591837	47.7551020408163
09	Burgos	259	09259	Pedrosa de Río Úrbel	282	158	124	56.0283687943262	43.9716312056738
09	Burgos	261	09261	Peñaranda de Duero	601	323	278	53.7437603993344	46.2562396006656
09	Burgos	262	09262	Peral de Arlanza	243	128	115	52.6748971193416	47.3251028806584
09	Burgos	265	09265	Piérnigas	41	30	11	73.1707317073171	26.8292682926829
09	Burgos	266	09266	Pineda de la Sierra	126	70	56	55.5555555555556	44.4444444444444
09	Burgos	267	09267	Pineda Trasmonte	190	101	89	53.1578947368421	46.8421052631579
09	Burgos	268	09268	Pinilla de los Barruecos	141	75	66	53.1914893617021	46.8085106382979
09	Burgos	269	09269	Pinilla de los Moros	51	33	18	64.7058823529412	35.2941176470588
09	Burgos	270	09270	Pinilla Trasmonte	224	124	100	55.3571428571429	44.6428571428571
09	Burgos	272	09272	Poza de la Sal	384	193	191	50.2604166666667	49.7395833333333
09	Burgos	273	09273	Prádanos de Bureba	57	33	24	57.8947368421053	42.1052631578947
09	Burgos	274	09274	Pradoluengo	1713	839	874	48.9784004670169	51.0215995329831
09	Burgos	275	09275	Presencio	273	147	126	53.8461538461539	46.1538461538462
09	Burgos	276	09276	Puebla de Arganzón (La)	383	213	170	55.6135770234987	44.3864229765013
09	Burgos	277	09277	Puentedura	137	78	59	56.9343065693431	43.0656934306569
09	Burgos	279	09279	Quemada	245	139	106	56.734693877551	43.265306122449
09	Burgos	280	09280	Quintanabureba	46	24	22	52.1739130434783	47.8260869565217
09	Burgos	281	09281	Quintana del Pidio	200	106	94	53	47
09	Burgos	283	09283	Quintanaélez	98	46	52	46.9387755102041	53.0612244897959
09	Burgos	287	09287	Quintanaortuño	144	75	69	52.0833333333333	47.9166666666667
09	Burgos	288	09288	Quintanapalla	115	62	53	53.9130434782609	46.0869565217391
09	Burgos	289	09289	Quintanar de la Sierra	2078	1066	1012	51.2993262752647	48.7006737247353
09	Burgos	292	09292	Quintanavides	85	41	44	48.2352941176471	51.764705882353
09	Burgos	294	09294	Quintanilla de la Mata	169	90	79	53.2544378698225	46.7455621301775
09	Burgos	295	09295	Quintanilla del Coco	120	61	59	50.8333333333333	49.1666666666667
09	Burgos	297	09297	Quintanillas (Las)	345	184	161	53.3333333333333	46.6666666666667
09	Burgos	298	09298	Quintanilla San García	104	50	54	48.0769230769231	51.9230769230769
09	Burgos	301	09301	Quintanilla Vivar	470	230	240	48.936170212766	51.063829787234
09	Burgos	302	09302	Rabanera del Pinar	141	75	66	53.1914893617021	46.8085106382979
09	Burgos	303	09303	Rábanos	89	55	34	61.7977528089888	38.2022471910112
09	Burgos	304	09304	Rabé de las Calzadas	172	92	80	53.4883720930233	46.5116279069767
09	Burgos	306	09306	Rebolledo de la Torre	180	100	80	55.5555555555556	44.4444444444444
09	Burgos	307	09307	Redecilla del Camino	150	87	63	58	42
09	Burgos	308	09308	Redecilla del Campo	88	46	42	52.2727272727273	47.7272727272727
09	Burgos	309	09309	Regumiel de la Sierra	480	240	240	50	50
09	Burgos	310	09310	Reinoso	24	16	8	66.6666666666667	33.3333333333333
09	Burgos	311	09311	Retuerta	72	41	31	56.9444444444444	43.0555555555556
09	Burgos	312	09312	Revilla y Ahedo (La)	121	66	55	54.5454545454545	45.4545454545455
09	Burgos	314	09314	Revilla del Campo	129	68	61	52.7131782945737	47.2868217054264
09	Burgos	315	09315	Revillarruz	152	79	73	51.9736842105263	48.0263157894737
09	Burgos	316	09316	Revilla Vallejera	130	73	57	56.1538461538462	43.8461538461539
09	Burgos	317	09317	Rezmondo	24	12	12	50	50
09	Burgos	318	09318	Riocavado de la Sierra	71	40	31	56.3380281690141	43.6619718309859
09	Burgos	321	09321	Roa	2249	1145	1104	50.9115162294353	49.0884837705647
09	Burgos	323	09323	Rojas	93	56	37	60.2150537634409	39.7849462365591
09	Burgos	325	09325	Royuela de Río Franco	338	189	149	55.9171597633136	44.0828402366864
09	Burgos	326	09326	Rubena	168	88	80	52.3809523809524	47.6190476190476
09	Burgos	327	09327	Rublacedo de Abajo	38	20	18	52.6315789473684	47.3684210526316
09	Burgos	328	09328	Rucandio	120	59	61	49.1666666666667	50.8333333333333
09	Burgos	329	09329	Salas de Bureba	151	81	70	53.6423841059603	46.3576158940397
09	Burgos	330	09330	Salas de los Infantes	2030	1026	1004	50.5418719211823	49.4581280788177
09	Burgos	332	09332	Saldaña de Burgos	127	69	58	54.3307086614173	45.6692913385827
09	Burgos	334	09334	Salinillas de Bureba	63	36	27	57.1428571428571	42.8571428571429
09	Burgos	335	09335	San Adrián de Juarros	54	31	23	57.4074074074074	42.5925925925926
09	Burgos	337	09337	San Juan del Monte	168	88	80	52.3809523809524	47.6190476190476
09	Burgos	338	09338	San Mamés de Burgos	207	119	88	57.487922705314	42.512077294686
09	Burgos	339	09339	San Martín de Rubiales	262	134	128	51.1450381679389	48.8549618320611
09	Burgos	340	09340	San Millán de Lara	77	50	27	64.9350649350649	35.0649350649351
09	Burgos	343	09343	Santa Cecilia	135	74	61	54.8148148148148	45.1851851851852
09	Burgos	345	09345	Santa Cruz de la Salceda	192	110	82	57.2916666666667	42.7083333333333
09	Burgos	346	09346	Santa Cruz del Valle Urbión	127	74	53	58.2677165354331	41.7322834645669
09	Burgos	347	09347	Santa Gadea del Cid	185	99	86	53.5135135135135	46.4864864864865
09	Burgos	348	09348	Santa Inés	203	111	92	54.679802955665	45.320197044335
09	Burgos	350	09350	Santa María del Campo	727	375	352	51.5818431911967	48.4181568088033
09	Burgos	351	09351	Santa María del Invierno	61	39	22	63.9344262295082	36.0655737704918
09	Burgos	352	09352	Santa María del Mercadillo	189	108	81	57.1428571428571	42.8571428571429
09	Burgos	353	09353	Santa María Rivarredonda	131	71	60	54.1984732824428	45.8015267175573
09	Burgos	354	09354	Santa Olalla de Bureba	37	15	22	40.5405405405405	59.4594594594595
09	Burgos	355	09355	Santibáñez de Esgueva	159	76	83	47.7987421383648	52.2012578616352
09	Burgos	356	09356	Santibáñez del Val	63	40	23	63.4920634920635	36.5079365079365
09	Burgos	358	09358	Santo Domingo de Silos	316	199	117	62.9746835443038	37.0253164556962
09	Burgos	360	09360	San Vicente del Valle	37	24	13	64.8648648648649	35.1351351351351
09	Burgos	361	09361	Sargentes de la Lora	171	92	79	53.8011695906433	46.1988304093567
09	Burgos	362	09362	Sarracín	213	116	97	54.4600938967136	45.5399061032864
09	Burgos	363	09363	Sasamón	1511	813	698	53.8054268696228	46.1945731303772
09	Burgos	365	09365	Sequera de Haza (La)	63	36	27	57.1428571428571	42.8571428571429
09	Burgos	366	09366	Solarana	111	64	47	57.6576576576577	42.3423423423423
09	Burgos	368	09368	Sordillos	39	23	16	58.974358974359	41.025641025641
09	Burgos	369	09369	Sotillo de la Ribera	611	340	271	55.6464811783961	44.3535188216039
09	Burgos	372	09372	Sotragero	173	90	83	52.0231213872832	47.9768786127168
09	Burgos	373	09373	Sotresgudo	730	396	334	54.2465753424658	45.7534246575342
09	Burgos	374	09374	Susinos del Páramo	110	52	58	47.2727272727273	52.7272727272727
09	Burgos	375	09375	Tamarón	53	32	21	60.377358490566	39.622641509434
09	Burgos	377	09377	Tardajos	642	344	298	53.582554517134	46.417445482866
09	Burgos	378	09378	Tejada	55	32	23	58.1818181818182	41.8181818181818
09	Burgos	380	09380	Terradillos de Esgueva	129	65	64	50.3875968992248	49.6124031007752
09	Burgos	381	09381	Tinieblas de la Sierra	53	24	29	45.2830188679245	54.7169811320755
09	Burgos	382	09382	Tobar	52	30	22	57.6923076923077	42.3076923076923
09	Burgos	384	09384	Tordómar	402	227	175	56.4676616915423	43.5323383084577
09	Burgos	386	09386	Torrecilla del Monte	76	41	35	53.9473684210526	46.0526315789474
09	Burgos	387	09387	Torregalindo	143	81	62	56.6433566433567	43.3566433566434
09	Burgos	388	09388	Torrelara	26	13	13	50	50
09	Burgos	389	09389	Torrepadre	123	67	56	54.4715447154472	45.5284552845528
09	Burgos	390	09390	Torresandino	838	451	387	53.81861575179	46.18138424821
09	Burgos	391	09391	Tórtoles de Esgueva	524	297	227	56.6793893129771	43.3206106870229
09	Burgos	392	09392	Tosantos	62	32	30	51.6129032258065	48.3870967741936
09	Burgos	394	09394	Trespaderne	1057	550	507	52.0340586565752	47.9659413434248
09	Burgos	395	09395	Tubilla del Agua	209	129	80	61.7224880382775	38.2775119617225
09	Burgos	396	09396	Tubilla del Lago	194	105	89	54.1237113402062	45.8762886597938
09	Burgos	398	09398	Úrbel del Castillo	93	54	39	58.0645161290323	41.9354838709677
09	Burgos	400	09400	Vadocondes	437	228	209	52.1739130434783	47.8260869565217
09	Burgos	403	09403	Valdeande	146	86	60	58.9041095890411	41.0958904109589
09	Burgos	405	09405	Valdezate	194	102	92	52.5773195876289	47.4226804123711
09	Burgos	406	09406	Valdorros	119	64	55	53.781512605042	46.218487394958
09	Burgos	407	09407	Valmala	32	15	17	46.875	53.125
09	Burgos	408	09408	Vallarta de Bureba	70	40	30	57.1428571428571	42.8571428571429
09	Burgos	409	09409	Valle de Manzanedo	133	71	62	53.3834586466165	46.6165413533835
09	Burgos	410	09410	Valle de Mena	3376	1720	1656	50.9478672985782	49.0521327014218
09	Burgos	411	09411	Valle de Oca	216	107	109	49.537037037037	50.462962962963
09	Burgos	412	09412	Valle de Tobalina	1096	567	529	51.7335766423358	48.2664233576642
09	Burgos	413	09413	Valle de Valdebezana	760	409	351	53.8157894736842	46.1842105263158
09	Burgos	414	09414	Valle de Valdelaguna	238	132	106	55.4621848739496	44.5378151260504
09	Burgos	415	09415	Valle de Valdelucio	375	206	169	54.9333333333333	45.0666666666667
09	Burgos	416	09416	Valle de Zamanzas	79	49	30	62.0253164556962	37.9746835443038
09	Burgos	417	09417	Vallejera	64	37	27	57.8125	42.1875
09	Burgos	418	09418	Valles de Palenzuela	107	55	52	51.4018691588785	48.5981308411215
09	Burgos	419	09419	Valluércanes	120	65	55	54.1666666666667	45.8333333333333
09	Burgos	421	09421	Vid y Barrios (La)	334	188	146	56.2874251497006	43.7125748502994
09	Burgos	422	09422	Vid de Bureba (La)	44	22	22	50	50
09	Burgos	423	09423	Vileña	37	24	13	64.8648648648649	35.1351351351351
09	Burgos	424	09424	Viloria de Rioja	71	40	31	56.3380281690141	43.6619718309859
09	Burgos	425	09425	Vilviestre del Pinar	772	398	374	51.5544041450777	48.4455958549223
09	Burgos	427	09427	Villadiego	1988	1081	907	54.3762575452716	45.6237424547284
09	Burgos	428	09428	Villaescusa de Roa	176	102	74	57.9545454545455	42.0454545454546
09	Burgos	429	09429	Villaescusa la Sombría	57	34	23	59.6491228070175	40.3508771929825
09	Burgos	430	09430	Villaespasa	30	17	13	56.6666666666667	43.3333333333333
09	Burgos	431	09431	Villafranca Montes de Oca	206	106	100	51.4563106796116	48.5436893203884
09	Burgos	432	09432	Villafruela	291	163	128	56.0137457044674	43.9862542955327
09	Burgos	433	09433	Villagalijo	70	45	25	64.2857142857143	35.7142857142857
09	Burgos	434	09434	Villagonzalo Pedernales	777	387	390	49.8069498069498	50.1930501930502
09	Burgos	437	09437	Villahoz	401	203	198	50.6234413965087	49.3765586034913
09	Burgos	438	09438	Villalba de Duero	595	314	281	52.7731092436975	47.2268907563025
09	Burgos	439	09439	Villalbilla de Burgos	692	372	320	53.757225433526	46.242774566474
09	Burgos	440	09440	Villalbilla de Gumiel	132	76	56	57.5757575757576	42.4242424242424
09	Burgos	441	09441	Villaldemiro	84	45	39	53.5714285714286	46.4285714285714
09	Burgos	442	09442	Villalmanzo	494	269	225	54.4534412955466	45.5465587044534
09	Burgos	443	09443	Villamayor de los Montes	251	119	132	47.4103585657371	52.5896414342629
09	Burgos	444	09444	Villamayor de Treviño	112	64	48	57.1428571428571	42.8571428571429
09	Burgos	445	09445	Villambistia	70	42	28	60	40
09	Burgos	446	09446	Villamedianilla	29	13	16	44.8275862068966	55.1724137931034
09	Burgos	447	09447	Villamiel de la Sierra	43	24	19	55.8139534883721	44.1860465116279
09	Burgos	448	09448	Villangómez	335	182	153	54.3283582089552	45.6716417910448
09	Burgos	449	09449	Villanueva de Argaño	124	64	60	51.6129032258065	48.3870967741936
09	Burgos	450	09450	Villanueva de Carazo	26	14	12	53.8461538461539	46.1538461538462
09	Burgos	451	09451	Villanueva de Gumiel	304	158	146	51.9736842105263	48.0263157894737
09	Burgos	454	09454	Villanueva de Teba	69	37	32	53.6231884057971	46.3768115942029
09	Burgos	455	09455	Villaquirán de la Puebla	64	36	28	56.25	43.75
09	Burgos	456	09456	Villaquirán de los Infantes	197	96	101	48.7309644670051	51.2690355329949
09	Burgos	458	09458	Villariezo	214	116	98	54.2056074766355	45.7943925233645
09	Burgos	460	09460	Villasandino	261	134	127	51.3409961685824	48.6590038314176
09	Burgos	463	09463	Villasur de Herreros	303	168	135	55.4455445544555	44.5544554455446
09	Burgos	464	09464	Villatuelda	70	37	33	52.8571428571429	47.1428571428571
09	Burgos	466	09466	Villaverde del Monte	199	108	91	54.2713567839196	45.7286432160804
09	Burgos	467	09467	Villaverde-Mogina	115	70	45	60.8695652173913	39.1304347826087
09	Burgos	471	09471	Villayerno Morquillas	132	64	68	48.4848484848485	51.5151515151515
09	Burgos	472	09472	Villazopeque	88	50	38	56.8181818181818	43.1818181818182
09	Burgos	473	09473	Villegas	128	73	55	57.03125	42.96875
09	Burgos	476	09476	Villoruebo	56	35	21	62.5	37.5
09	Burgos	478	09478	Vizcaínos	67	35	32	52.2388059701493	47.7611940298507
09	Burgos	480	09480	Zael	141	73	68	51.7730496453901	48.2269503546099
09	Burgos	482	09482	Zarzosa de Río Pisuerga	56	34	22	60.7142857142857	39.2857142857143
09	Burgos	483	09483	Zazuar	262	136	126	51.9083969465649	48.0916030534351
09	Burgos	485	09485	Zuñeda	84	44	40	52.3809523809524	47.6190476190476
09	Burgos	901	09901	Quintanilla del Agua y Tordueles	583	302	281	51.8010291595197	48.1989708404803
09	Burgos	902	09902	Valle de Santibáñez	626	323	303	51.5974440894569	48.4025559105431
09	Burgos	903	09903	Villarcayo de Merindad de Castilla la Vieja	3807	1911	1896	50.1970055161545	49.8029944838456
09	Burgos	904	09904	Valle de las Navas	636	354	282	55.6603773584906	44.3396226415094
09	Burgos	905	09905	Valle de Sedano	539	293	246	54.3599257884972	45.6400742115028
09	Burgos	906	09906	Merindad de Río Ubierna	1305	676	629	51.8007662835249	48.1992337164751
09	Burgos	907	09907	Alfoz de Quintanadueñas	671	358	313	53.3532041728763	46.6467958271237
09	Burgos	908	09908	Valle de Losa	670	378	292	56.4179104477612	43.5820895522388
10	Cáceres	001	10001	Abadía	276	158	118	57.2463768115942	42.7536231884058
10	Cáceres	002	10002	Abertura	511	272	239	53.2289628180039	46.7710371819961
10	Cáceres	003	10003	Acebo	806	432	374	53.5980148883375	46.4019851116625
10	Cáceres	004	10004	Acehuche	944	474	470	50.2118644067797	49.7881355932203
10	Cáceres	005	10005	Aceituna	709	363	346	51.1988716502116	48.8011283497884
10	Cáceres	006	10006	Ahigal	1564	807	757	51.5984654731458	48.4015345268542
10	Cáceres	007	10007	Albalá del Caudillo	850	414	436	48.7058823529412	51.2941176470588
10	Cáceres	008	10008	Alcántara	1650	828	822	50.1818181818182	49.8181818181818
10	Cáceres	009	10009	Alcollarín	348	164	184	47.1264367816092	52.8735632183908
10	Cáceres	010	10010	Alcuéscar	3131	1629	1502	52.0281060364101	47.9718939635899
10	Cáceres	011	10011	Aldeacentenera	927	469	458	50.5933117583603	49.4066882416397
10	Cáceres	012	10012	Aldea del Cano	801	388	413	48.4394506866417	51.5605493133583
10	Cáceres	013	10013	Aldea del Obispo (La)	395	208	187	52.6582278481013	47.3417721518987
10	Cáceres	014	10014	Aldeanueva de la Vera	2462	1220	1242	49.553208773355	50.446791226645
10	Cáceres	015	10015	Aldeanueva del Camino	785	404	381	51.4649681528662	48.5350318471338
10	Cáceres	016	10016	Aldehuela de Jerte	380	217	163	57.1052631578947	42.8947368421053
10	Cáceres	017	10017	Alía	1373	687	686	50.0364166059723	49.9635833940277
10	Cáceres	018	10018	Aliseda	2265	1125	1140	49.6688741721854	50.3311258278146
10	Cáceres	019	10019	Almaraz	1557	803	754	51.5735388567759	48.4264611432242
10	Cáceres	020	10020	Almoharín	2141	1072	1069	50.0700607192901	49.92993928071
10	Cáceres	021	10021	Arroyo de la Luz	6515	3257	3258	49.9923254029163	50.0076745970837
10	Cáceres	022	10022	Arroyomolinos de la Vera	583	290	293	49.7427101200686	50.2572898799314
10	Cáceres	023	10023	Arroyomolinos	1184	595	589	50.2533783783784	49.7466216216216
10	Cáceres	024	10024	Baños de Montemayor	695	328	367	47.1942446043166	52.8057553956834
10	Cáceres	025	10025	Barrado	527	269	258	51.0436432637571	48.9563567362429
10	Cáceres	026	10026	Belvís de Monroy	604	309	295	51.158940397351	48.841059602649
10	Cáceres	027	10027	Benquerencia	106	63	43	59.4339622641509	40.5660377358491
10	Cáceres	028	10028	Berrocalejo	120	53	67	44.1666666666667	55.8333333333333
10	Cáceres	029	10029	Berzocana	607	307	300	50.5766062602965	49.4233937397035
10	Cáceres	030	10030	Bohonal de Ibor	580	294	286	50.6896551724138	49.3103448275862
10	Cáceres	031	10031	Botija	178	79	99	44.3820224719101	55.6179775280899
10	Cáceres	032	10032	Brozas	2328	1157	1171	49.6993127147766	50.3006872852234
10	Cáceres	033	10033	Cabañas del Castillo	550	279	271	50.7272727272727	49.2727272727273
10	Cáceres	034	10034	Cabezabellosa	523	262	261	50.0956022944551	49.9043977055449
10	Cáceres	035	10035	Cabezuela del Valle	2382	1234	1148	51.8052057094878	48.1947942905122
10	Cáceres	036	10036	Cabrero	445	233	212	52.3595505617978	47.6404494382023
10	Cáceres	037	10037	Cáceres	82235	39590	42645	48.142518392412	51.857481607588
10	Cáceres	038	10038	Cachorrilla	105	48	57	45.7142857142857	54.2857142857143
10	Cáceres	039	10039	Cadalso	585	300	285	51.2820512820513	48.7179487179487
10	Cáceres	040	10040	Calzadilla	593	304	289	51.2647554806071	48.7352445193929
10	Cáceres	041	10041	Caminomorisco	1228	646	582	52.6058631921824	47.3941368078176
10	Cáceres	042	10042	Campillo de Deleitosa	132	64	68	48.4848484848485	51.5151515151515
10	Cáceres	043	10043	Campo Lugar	1232	615	617	49.9188311688312	50.0811688311688
10	Cáceres	044	10044	Cañamero	1981	1012	969	51.085310449268	48.914689550732
10	Cáceres	045	10045	Cañaveral	1449	715	734	49.344375431332	50.6556245686681
10	Cáceres	046	10046	Carbajo	280	145	135	51.7857142857143	48.2142857142857
10	Cáceres	047	10047	Carcaboso	1098	625	473	56.9216757741348	43.0783242258652
10	Cáceres	048	10048	Carrascalejo	423	214	209	50.5910165484634	49.4089834515366
10	Cáceres	049	10049	Casar de Cáceres	4716	2371	2345	50.275657336726	49.724342663274
10	Cáceres	050	10050	Casar de Palomero	1338	671	667	50.1494768310912	49.8505231689088
10	Cáceres	051	10051	Casares de las Hurdes	728	361	367	49.5879120879121	50.4120879120879
10	Cáceres	052	10052	Casas de Don Antonio	238	116	122	48.7394957983193	51.2605042016807
10	Cáceres	053	10053	Casas de Don Gómez	343	179	164	52.1865889212828	47.8134110787172
10	Cáceres	054	10054	Casas del Castañar	693	344	349	49.6392496392496	50.3607503607504
10	Cáceres	055	10055	Casas del Monte	891	468	423	52.5252525252525	47.4747474747475
10	Cáceres	056	10056	Casas de Millán	809	416	393	51.4215080346106	48.5784919653894
10	Cáceres	057	10057	Casas de Miravete	182	97	85	53.2967032967033	46.7032967032967
10	Cáceres	058	10058	Casatejada	1319	670	649	50.7960576194086	49.2039423805914
10	Cáceres	059	10059	Casillas de Coria	540	256	284	47.4074074074074	52.5925925925926
10	Cáceres	060	10060	Castañar de Ibor	1354	692	662	51.1078286558346	48.8921713441654
10	Cáceres	061	10061	Ceclavín	2228	1133	1095	50.8527827648115	49.1472172351885
10	Cáceres	062	10062	Cedillo	543	282	261	51.9337016574586	48.0662983425414
10	Cáceres	063	10063	Cerezo	228	108	120	47.3684210526316	52.6315789473684
10	Cáceres	064	10064	Cilleros	2156	1090	1066	50.556586270872	49.443413729128
10	Cáceres	065	10065	Collado	231	122	109	52.8138528138528	47.1861471861472
10	Cáceres	066	10066	Conquista de la Sierra	193	92	101	47.6683937823834	52.3316062176166
10	Cáceres	067	10067	Coria	12540	6291	6249	50.1674641148325	49.8325358851675
10	Cáceres	068	10068	Cuacos de Yuste	957	502	455	52.4555903866249	47.5444096133751
10	Cáceres	069	10069	Cumbre (La)	1161	587	574	50.5598621877692	49.4401378122308
10	Cáceres	070	10070	Deleitosa	898	447	451	49.7772828507795	50.2227171492205
10	Cáceres	071	10071	Descargamaría	288	151	137	52.4305555555556	47.5694444444444
10	Cáceres	072	10072	Eljas	1230	625	605	50.8130081300813	49.1869918699187
10	Cáceres	073	10073	Escurial	914	460	454	50.328227571116	49.671772428884
10	Cáceres	075	10075	Fresnedoso de Ibor	366	179	187	48.9071038251366	51.0928961748634
10	Cáceres	076	10076	Galisteo	1985	1007	978	50.7304785894207	49.2695214105794
10	Cáceres	077	10077	Garciaz	1038	533	505	51.3487475915222	48.6512524084778
10	Cáceres	078	10078	Garganta (La)	601	316	285	52.5790349417637	47.4209650582363
10	Cáceres	079	10079	Garganta la Olla	1040	545	495	52.4038461538462	47.5961538461539
10	Cáceres	080	10080	Gargantilla	495	262	233	52.9292929292929	47.0707070707071
10	Cáceres	081	10081	Gargüera	193	100	93	51.8134715025907	48.1865284974093
10	Cáceres	082	10082	Garrovillas	2509	1234	1275	49.1829414109207	50.8170585890793
10	Cáceres	083	10083	Garvín	127	70	57	55.1181102362205	44.8818897637795
10	Cáceres	084	10084	Gata	1893	955	938	50.4490227152668	49.5509772847332
10	Cáceres	085	10085	Gordo (El)	312	153	159	49.0384615384615	50.9615384615385
10	Cáceres	086	10086	Granja (La)	415	229	186	55.1807228915663	44.8192771084337
10	Cáceres	087	10087	Guadalupe	2365	1170	1195	49.4714587737844	50.5285412262156
10	Cáceres	088	10088	Guijo de Coria	291	154	137	52.9209621993127	47.0790378006873
10	Cáceres	089	10089	Guijo de Galisteo	1830	932	898	50.9289617486339	49.0710382513661
10	Cáceres	090	10090	Guijo de Granadilla	731	365	366	49.9316005471956	50.0683994528044
10	Cáceres	091	10091	Guijo de Santa Bárbara	489	243	246	49.6932515337423	50.3067484662577
10	Cáceres	092	10092	Herguijuela	436	214	222	49.0825688073395	50.9174311926605
10	Cáceres	093	10093	Hernán-Pérez	497	258	239	51.9114688128773	48.0885311871227
10	Cáceres	094	10094	Herrera de Alcántara	309	154	155	49.8381877022654	50.1618122977346
10	Cáceres	095	10095	Herreruela	470	247	223	52.5531914893617	47.4468085106383
10	Cáceres	096	10096	Hervás	3839	1863	1976	48.5282625683772	51.4717374316228
10	Cáceres	097	10097	Higuera	111	59	52	53.1531531531532	46.8468468468469
10	Cáceres	098	10098	Hinojal	425	201	224	47.2941176470588	52.7058823529412
10	Cáceres	099	10099	Holguera	813	412	401	50.6765067650677	49.3234932349324
10	Cáceres	100	10100	Hoyos	978	504	474	51.5337423312884	48.4662576687117
10	Cáceres	101	10101	Huélaga	208	107	101	51.4423076923077	48.5576923076923
10	Cáceres	102	10102	Ibahernando	727	353	374	48.5557083906465	51.4442916093535
10	Cáceres	103	10103	Jaraicejo	724	353	371	48.7569060773481	51.2430939226519
10	Cáceres	104	10104	Jaraíz de la Vera	6479	3290	3189	50.7794412718012	49.2205587281988
10	Cáceres	105	10105	Jarandilla de la Vera	3103	1546	1557	49.8227521753142	50.1772478246858
10	Cáceres	106	10106	Jarilla	190	95	95	50	50
10	Cáceres	107	10107	Jerte	1302	682	620	52.3809523809524	47.6190476190476
10	Cáceres	108	10108	Ladrillar	314	168	146	53.5031847133758	46.4968152866242
10	Cáceres	109	10109	Logrosán	2492	1270	1222	50.9630818619583	49.0369181380417
10	Cáceres	110	10110	Losar de la Vera	3094	1618	1476	52.29476405947	47.7052359405301
10	Cáceres	111	10111	Madrigal de la Vera	1677	878	799	52.3553965414431	47.6446034585569
10	Cáceres	112	10112	Madrigalejo	2237	1101	1136	49.2177022798391	50.7822977201609
10	Cáceres	113	10113	Madroñera	3127	1565	1562	50.0479692996482	49.9520307003518
10	Cáceres	114	10114	Majadas	1255	692	563	55.1394422310757	44.8605577689243
10	Cáceres	115	10115	Malpartida de Cáceres	4338	2177	2161	50.1844167819272	49.8155832180728
10	Cáceres	116	10116	Malpartida de Plasencia	4119	2006	2113	48.7011410536538	51.2988589463462
10	Cáceres	117	10117	Marchagaz	322	161	161	50	50
10	Cáceres	118	10118	Mata de Alcántara	387	200	187	51.6795865633075	48.3204134366925
10	Cáceres	119	10119	Membrío	873	414	459	47.4226804123711	52.5773195876289
10	Cáceres	120	10120	Mesas de Ibor	211	110	101	52.132701421801	47.8672985781991
10	Cáceres	121	10121	Miajadas	9315	4653	4662	49.951690821256	50.048309178744
10	Cáceres	122	10122	Millanes	196	109	87	55.6122448979592	44.3877551020408
10	Cáceres	123	10123	Mirabel	812	404	408	49.7536945812808	50.2463054187192
10	Cáceres	124	10124	Mohedas de Granadilla	1122	562	560	50.0891265597148	49.9108734402852
10	Cáceres	125	10125	Monroy	1059	555	504	52.4079320113315	47.5920679886686
10	Cáceres	126	10126	Montánchez	2157	1064	1093	49.3277700509968	50.6722299490033
10	Cáceres	127	10127	Montehermoso	5356	2647	2709	49.4212098581031	50.5787901418969
10	Cáceres	128	10128	Moraleja	7958	3942	4016	49.5350590600653	50.4649409399347
10	Cáceres	129	10129	Morcillo	484	238	246	49.1735537190083	50.8264462809917
10	Cáceres	130	10130	Navaconcejo	2035	1031	1004	50.6633906633907	49.3366093366093
10	Cáceres	131	10131	Navalmoral de la Mata	14838	7422	7416	50.0202183582693	49.9797816417307
10	Cáceres	132	10132	Navalvillar de Ibor	515	269	246	52.2330097087379	47.7669902912621
10	Cáceres	133	10133	Navas del Madroño	1536	770	766	50.1302083333333	49.8697916666667
10	Cáceres	134	10134	Navezuelas	731	383	348	52.3939808481532	47.6060191518468
10	Cáceres	135	10135	Nuñomoral	1760	929	831	52.7840909090909	47.2159090909091
10	Cáceres	136	10136	Oliva de Plasencia	302	157	145	51.9867549668874	48.0132450331126
10	Cáceres	137	10137	Palomero	540	269	271	49.8148148148148	50.1851851851852
10	Cáceres	138	10138	Pasarón de la Vera	701	345	356	49.2154065620542	50.7845934379458
10	Cáceres	139	10139	Pedroso de Acim	140	74	66	52.8571428571429	47.1428571428571
10	Cáceres	140	10140	Peraleda de la Mata	1372	686	686	50	50
10	Cáceres	141	10141	Peraleda de San Román	412	197	215	47.8155339805825	52.1844660194175
10	Cáceres	142	10142	Perales del Puerto	993	490	503	49.3454179254784	50.6545820745217
10	Cáceres	143	10143	Pescueza	205	95	110	46.3414634146342	53.6585365853659
10	Cáceres	144	10144	Pesga (La)	1217	662	555	54.3960558751027	45.6039441248973
10	Cáceres	145	10145	Piedras Albas	210	100	110	47.6190476190476	52.3809523809524
10	Cáceres	146	10146	Pinofranqueado	1693	926	767	54.695806261075	45.304193738925
10	Cáceres	147	10147	Piornal	1566	769	797	49.1060025542784	50.8939974457216
10	Cáceres	148	10148	Plasencia	37018	18098	18920	48.8897293208709	51.1102706791291
10	Cáceres	149	10149	Plasenzuela	551	258	293	46.8239564428312	53.1760435571688
10	Cáceres	150	10150	Portaje	407	197	210	48.4029484029484	51.5970515970516
10	Cáceres	151	10151	Portezuelo	312	151	161	48.3974358974359	51.6025641025641
10	Cáceres	152	10152	Pozuelo de Zarzón	624	301	323	48.2371794871795	51.7628205128205
10	Cáceres	153	10153	Puerto de Santa Cruz	427	209	218	48.9461358313817	51.0538641686183
10	Cáceres	154	10154	Rebollar	246	126	120	51.219512195122	48.7804878048781
10	Cáceres	155	10155	Riolobos	1506	797	709	52.9216467463479	47.0783532536521
10	Cáceres	156	10156	Robledillo de Gata	175	93	82	53.1428571428572	46.8571428571429
10	Cáceres	157	10157	Robledillo de la Vera	327	162	165	49.5412844036697	50.4587155963303
10	Cáceres	158	10158	Robledillo de Trujillo	498	259	239	52.0080321285141	47.9919678714859
10	Cáceres	159	10159	Robledollano	430	232	198	53.953488372093	46.046511627907
10	Cáceres	160	10160	Romangordo	185	86	99	46.4864864864865	53.5135135135135
10	Cáceres	161	10161	Ruanes	108	58	50	53.7037037037037	46.2962962962963
10	Cáceres	162	10162	Salorino	796	398	398	50	50
10	Cáceres	163	10163	Salvatierra de Santiago	423	218	205	51.5366430260047	48.4633569739953
10	Cáceres	164	10164	San Martín de Trevejo	998	494	504	49.498997995992	50.501002004008
10	Cáceres	165	10165	Santa Ana	336	171	165	50.8928571428571	49.1071428571429
10	Cáceres	166	10166	Santa Cruz de la Sierra	366	188	178	51.3661202185792	48.6338797814208
10	Cáceres	167	10167	Santa Cruz de Paniagua	450	242	208	53.7777777777778	46.2222222222222
10	Cáceres	168	10168	Santa Marta de Magasca	373	187	186	50.1340482573727	49.8659517426273
10	Cáceres	169	10169	Santiago de Alcántara	751	372	379	49.5339547270306	50.4660452729694
10	Cáceres	170	10170	Santiago del Campo	314	157	157	50	50
10	Cáceres	171	10171	Santibáñez el Alto	563	293	270	52.0426287744227	47.9573712255773
10	Cáceres	172	10172	Santibáñez el Bajo	1027	528	499	51.4118792599805	48.5881207400195
10	Cáceres	173	10173	Saucedilla	614	316	298	51.4657980456026	48.5342019543974
10	Cáceres	174	10174	Segura de Toro	205	110	95	53.6585365853659	46.3414634146342
10	Cáceres	175	10175	Serradilla	1919	983	936	51.2245961438249	48.7754038561751
10	Cáceres	176	10176	Serrejón	496	254	242	51.2096774193548	48.7903225806452
10	Cáceres	177	10177	Sierra de Fuentes	1656	849	807	51.268115942029	48.731884057971
10	Cáceres	178	10178	Talaván	1012	503	509	49.703557312253	50.296442687747
10	Cáceres	179	10179	Talaveruela de la Vera	458	216	242	47.1615720524017	52.8384279475983
10	Cáceres	180	10180	Talayuela	9444	5715	3729	60.5146124523507	39.4853875476493
10	Cáceres	181	10181	Tejeda de Tiétar	1026	544	482	53.0214424951267	46.9785575048733
10	Cáceres	182	10182	Toril	198	126	72	63.6363636363636	36.3636363636364
10	Cáceres	183	10183	Tornavacas	1328	712	616	53.6144578313253	46.3855421686747
10	Cáceres	184	10184	Torno (El)	941	478	463	50.7970244420829	49.2029755579171
10	Cáceres	185	10185	Torrecilla de los Ángeles	733	375	358	51.1596180081855	48.8403819918145
10	Cáceres	186	10186	Torrecillas de la Tiesa	1185	598	587	50.464135021097	49.535864978903
10	Cáceres	187	10187	Torre de Don Miguel	671	335	336	49.9254843517139	50.0745156482861
10	Cáceres	188	10188	Torre de Santa María	739	370	369	50.0676589986468	49.9323410013532
10	Cáceres	189	10189	Torrejoncillo	3557	1728	1829	48.5802642676413	51.4197357323587
10	Cáceres	190	10190	Torrejón el Rubio	704	364	340	51.7045454545455	48.2954545454546
10	Cáceres	191	10191	Torremenga	543	277	266	51.0128913443831	48.9871086556169
10	Cáceres	192	10192	Torremocha	1277	616	661	48.2380579483164	51.7619420516836
10	Cáceres	193	10193	Torreorgaz	1665	833	832	50.03003003003	49.96996996997
10	Cáceres	194	10194	Torrequemada	586	278	308	47.4402730375427	52.5597269624573
10	Cáceres	195	10195	Trujillo	8713	4199	4514	48.1923562492827	51.8076437507173
10	Cáceres	196	10196	Valdastillas	401	200	201	49.8753117206983	50.1246882793017
10	Cáceres	197	10197	Valdecañas de Tajo	284	151	133	53.169014084507	46.830985915493
10	Cáceres	198	10198	Valdefuentes	1555	781	774	50.2250803858521	49.7749196141479
10	Cáceres	199	10199	Valdehúncar	214	106	108	49.5327102803738	50.4672897196262
10	Cáceres	200	10200	Valdelacasa de Tajo	539	252	287	46.7532467532468	53.2467532467532
10	Cáceres	201	10201	Valdemorales	273	134	139	49.0842490842491	50.9157509157509
10	Cáceres	202	10202	Valdeobispo	800	393	407	49.125	50.875
10	Cáceres	203	10203	Valencia de Alcántara	6240	3056	3184	48.974358974359	51.025641025641
10	Cáceres	204	10204	Valverde de la Vera	560	289	271	51.6071428571429	48.3928571428571
10	Cáceres	205	10205	Valverde del Fresno	2651	1340	1311	50.546963410034	49.4530365899661
10	Cáceres	206	10206	Viandar de la Vera	323	154	169	47.6780185758514	52.3219814241486
10	Cáceres	207	10207	Villa del Campo	679	333	346	49.0427098674521	50.9572901325479
10	Cáceres	208	10208	Villa del Rey	181	95	86	52.4861878453039	47.5138121546961
10	Cáceres	209	10209	Villamesías	370	183	187	49.4594594594595	50.5405405405405
10	Cáceres	210	10210	Villamiel	691	396	295	57.3082489146165	42.6917510853835
10	Cáceres	211	10211	Villanueva de la Sierra	616	297	319	48.2142857142857	51.7857142857143
10	Cáceres	212	10212	Villanueva de la Vera	2006	1008	998	50.2492522432702	49.7507477567298
10	Cáceres	213	10213	Villar del Pedroso	813	407	406	50.0615006150061	49.9384993849939
10	Cáceres	214	10214	Villar de Plasencia	275	139	136	50.5454545454546	49.4545454545455
10	Cáceres	215	10215	Villasbuenas de Gata	504	262	242	51.984126984127	48.015873015873
10	Cáceres	216	10216	Zarza de Granadilla	1784	914	870	51.2331838565022	48.7668161434978
10	Cáceres	217	10217	Zarza de Montánchez	618	306	312	49.5145631067961	50.4854368932039
10	Cáceres	218	10218	Zarza la Mayor	1712	866	846	50.5841121495327	49.4158878504673
10	Cáceres	219	10219	Zorita	1987	994	993	50.0251635631606	49.9748364368395
10	Cáceres	901	10901	Rosalejo	1766	991	775	56.1155152887882	43.8844847112118
11	Cádiz	001	11001	Alcalá de los Gazules	5563	2880	2683	51.7706273593385	48.2293726406615
11	Cádiz	002	11002	Alcalá del Valle	5271	2983	2288	56.592676911402	43.407323088598
11	Cádiz	003	11003	Algar	1778	950	828	53.4308211473566	46.5691788526434
11	Cádiz	004	11004	Algeciras	104087	51166	52921	49.1569552393671	50.8430447606329
11	Cádiz	005	11005	Algodonales	5617	2883	2734	51.326330781556	48.673669218444
11	Cádiz	006	11006	Arcos de la Frontera	27979	14027	13952	50.1340290932485	49.8659709067515
11	Cádiz	007	11007	Barbate	22020	11041	10979	50.1407811080836	49.8592188919164
11	Cádiz	008	11008	Barrios (Los)	16825	8447	8378	50.2050520059435	49.7949479940565
11	Cádiz	009	11009	Benaocaz	659	342	317	51.896813353566	48.103186646434
11	Cádiz	010	11010	Bornos	7897	3916	3981	49.5884513106243	50.4115486893757
11	Cádiz	011	11011	Bosque (El)	1875	959	916	51.1466666666667	48.8533333333333
11	Cádiz	012	11012	Cádiz	140061	67180	72881	47.9648153304632	52.0351846695368
11	Cádiz	013	11013	Castellar de la Frontera	2531	1295	1236	51.1655472145397	48.8344527854603
11	Cádiz	014	11014	Conil de la Frontera	17773	9016	8757	50.7286333202048	49.2713666797952
11	Cádiz	015	11015	Chiclana de la Frontera	59857	30411	29446	50.8060878426918	49.1939121573082
11	Cádiz	016	11016	Chipiona	16539	8352	8187	50.4988209686196	49.5011790313804
11	Cádiz	017	11017	Espera	3971	2071	1900	52.1531100478469	47.8468899521531
11	Cádiz	018	11018	Gastor (El)	1953	1023	930	52.3809523809524	47.6190476190476
11	Cádiz	019	11019	Grazalema	2240	1179	1061	52.6339285714286	47.3660714285714
11	Cádiz	020	11020	Jerez de la Frontera	183677	89617	94060	48.7905399151772	51.2094600848228
11	Cádiz	021	11021	Jimena de la Frontera	9109	4645	4464	50.99352288945	49.00647711055
11	Cádiz	022	11022	Línea de la Concepción (La)	59993	29349	30644	48.9207074158652	51.0792925841348
11	Cádiz	023	11023	Medina-Sidonia	10793	5581	5212	51.7094413045492	48.2905586954508
11	Cádiz	024	11024	Olvera	8685	4352	4333	50.1093839953944	49.8906160046056
11	Cádiz	025	11025	Paterna de Rivera	5179	2687	2492	51.882602819077	48.117397180923
11	Cádiz	026	11026	Prado del Rey	5856	2928	2928	50	50
11	Cádiz	027	11027	Puerto de Santa María (El)	75478	37592	37886	49.8052412623546	50.1947587376454
11	Cádiz	028	11028	Puerto Real	35182	17696	17486	50.2984480700358	49.7015519299642
11	Cádiz	029	11029	Puerto Serrano	6758	3446	3312	50.9914175791654	49.0085824208346
11	Cádiz	030	11030	Rota	25560	12917	12643	50.5359937402191	49.4640062597809
11	Cádiz	031	11031	San Fernando	88179	43567	44612	49.4074552898082	50.5925447101918
11	Cádiz	032	11032	Sanlúcar de Barrameda	61966	31010	30956	50.0435722815738	49.9564277184262
11	Cádiz	033	11033	San Roque	22990	11574	11416	50.3436276642018	49.6563723357982
11	Cádiz	034	11034	Setenil de las Bodegas	3067	1573	1494	51.2879034887512	48.7120965112488
11	Cádiz	035	11035	Tarifa	15481	7852	7629	50.7202377107422	49.2797622892578
11	Cádiz	036	11036	Torre Alháquime	931	468	463	50.2685284640172	49.7314715359828
11	Cádiz	037	11037	Trebujena	6937	3591	3346	51.765893037336	48.234106962664
11	Cádiz	038	11038	Ubrique	17586	8717	8869	49.5678380529967	50.4321619470033
11	Cádiz	039	11039	Vejer de la Frontera	12674	6392	6282	50.4339592867287	49.5660407132713
11	Cádiz	040	11040	Villaluenga del Rosario	440	236	204	53.6363636363636	46.3636363636364
11	Cádiz	041	11041	Villamartín	11969	5892	6077	49.2271701896566	50.7728298103434
11	Cádiz	042	11042	Zahara	1560	819	741	52.5	47.5
11	Cádiz	901	11901	Benalup-Casas Viejas	6305	3207	3098	50.8643933386201	49.1356066613799
11	Cádiz	902	11902	San José del Valle	4254	2134	2120	50.1645510108134	49.8354489891866
12	Castellón/Castelló	001	12001	Atzeneta del Maestrat	1438	728	710	50.6258692628651	49.3741307371349
12	Castellón/Castelló	002	12002	Aín	167	82	85	49.1017964071856	50.8982035928144
12	Castellón/Castelló	003	12003	Albocàsser	1344	645	699	47.9910714285714	52.0089285714286
12	Castellón/Castelló	004	12004	Alcalà de Xivert	5456	2757	2699	50.5315249266862	49.4684750733138
12	Castellón/Castelló	005	12005	Alcora (l')	9106	4636	4470	50.9114869316934	49.0885130683066
12	Castellón/Castelló	006	12006	Alcudia de Veo	220	110	110	50	50
12	Castellón/Castelló	007	12007	Alfondeguilla	908	448	460	49.3392070484582	50.6607929515419
12	Castellón/Castelló	008	12008	Algimia de Almonacid	278	161	117	57.9136690647482	42.0863309352518
12	Castellón/Castelló	009	12009	Almazora/Almassora	16897	8400	8497	49.71296679884	50.28703320116
12	Castellón/Castelló	010	12010	Almedíjar	275	133	142	48.3636363636364	51.6363636363636
12	Castellón/Castelló	011	12011	Almenara	4912	2419	2493	49.2467426710098	50.7532573289902
12	Castellón/Castelló	012	12012	Altura	3137	1573	1564	50.1434491552439	49.8565508447561
12	Castellón/Castelló	013	12013	Arañuel	181	91	90	50.2762430939227	49.7237569060774
12	Castellón/Castelló	014	12014	Ares del Maestre	254	126	128	49.6062992125984	50.3937007874016
12	Castellón/Castelló	015	12015	Argelita	136	70	66	51.4705882352941	48.5294117647059
12	Castellón/Castelló	016	12016	Artana	1840	909	931	49.4021739130435	50.5978260869565
12	Castellón/Castelló	017	12017	Ayódar	236	133	103	56.3559322033898	43.6440677966102
12	Castellón/Castelló	018	12018	Azuébar	347	171	176	49.2795389048991	50.7204610951009
12	Castellón/Castelló	020	12020	Barracas	159	85	74	53.4591194968554	46.5408805031447
12	Castellón/Castelló	021	12021	Betxí	5356	2718	2638	50.7468259895444	49.2531740104556
12	Castellón/Castelló	022	12022	Bejís	383	218	165	56.9190600522193	43.0809399477807
12	Castellón/Castelló	024	12024	Benafer	151	83	68	54.9668874172185	45.0331125827815
12	Castellón/Castelló	025	12025	Benafigos	206	109	97	52.9126213592233	47.0873786407767
12	Castellón/Castelló	026	12026	Benasal	1388	672	716	48.4149855907781	51.5850144092219
12	Castellón/Castelló	027	12027	Benicarló	19908	9889	10019	49.6734980912196	50.3265019087804
12	Castellón/Castelló	028	12028	Benicasim/Benicàssim	11874	6017	5857	50.673740946606	49.326259053394
12	Castellón/Castelló	029	12029	Benlloch	842	427	415	50.7125890736342	49.2874109263658
12	Castellón/Castelló	031	12031	Borriol	3576	1808	1768	50.5592841163311	49.4407158836689
12	Castellón/Castelló	032	12032	Burriana	26499	12952	13547	48.8773161251368	51.1226838748632
12	Castellón/Castelló	033	12033	Cabanes	2359	1183	1176	50.1483679525223	49.8516320474777
12	Castellón/Castelló	034	12034	Càlig	1744	858	886	49.197247706422	50.802752293578
12	Castellón/Castelló	036	12036	Canet lo Roig	879	420	459	47.7815699658703	52.2184300341297
12	Castellón/Castelló	037	12037	Castell de Cabres	22	10	12	45.4545454545455	54.5454545454545
12	Castellón/Castelló	038	12038	Castellfort	236	123	113	52.1186440677966	47.8813559322034
12	Castellón/Castelló	039	12039	Castellnovo	1020	476	544	46.6666666666667	53.3333333333333
12	Castellón/Castelló	040	12040	Castellón de la Plana/Castelló de la Plana	142285	69360	72925	48.7472326668307	51.2527673331694
12	Castellón/Castelló	041	12041	Castillo de Villamalefa	115	58	57	50.4347826086956	49.5652173913044
12	Castellón/Castelló	042	12042	Catí	869	448	421	51.5535097813579	48.4464902186421
12	Castellón/Castelló	043	12043	Caudiel	695	339	356	48.7769784172662	51.2230215827338
12	Castellón/Castelló	044	12044	Cervera del Maestre	711	333	378	46.8354430379747	53.1645569620253
12	Castellón/Castelló	045	12045	Cinctorres	520	246	274	47.3076923076923	52.6923076923077
12	Castellón/Castelló	046	12046	Cirat	282	151	131	53.5460992907801	46.4539007092199
12	Castellón/Castelló	048	12048	Cortes de Arenoso	406	215	191	52.9556650246305	47.0443349753695
12	Castellón/Castelló	049	12049	Costur	463	230	233	49.6760259179266	50.3239740820734
12	Castellón/Castelló	050	12050	Coves de Vinromà (les)	1810	915	895	50.5524861878453	49.4475138121547
12	Castellón/Castelló	051	12051	Culla	771	395	376	51.2321660181582	48.7678339818418
12	Castellón/Castelló	052	12052	Chert/Xert	894	433	461	48.4340044742729	51.5659955257271
12	Castellón/Castelló	053	12053	Chilches	2299	1179	1120	51.2831665941714	48.7168334058286
12	Castellón/Castelló	055	12055	Chodos/Xodos	160	87	73	54.375	45.625
12	Castellón/Castelló	056	12056	Chóvar	378	193	185	51.0582010582011	48.9417989417989
12	Castellón/Castelló	057	12057	Eslida	769	361	408	46.9440832249675	53.0559167750325
12	Castellón/Castelló	058	12058	Espadilla	73	35	38	47.9452054794521	52.0547945205479
12	Castellón/Castelló	059	12059	Fanzara	250	116	134	46.4	53.6
12	Castellón/Castelló	060	12060	Figueroles	581	287	294	49.3975903614458	50.6024096385542
12	Castellón/Castelló	061	12061	Forcall	571	270	301	47.2854640980736	52.7145359019264
12	Castellón/Castelló	063	12063	Fuente la Reina	29	15	14	51.7241379310345	48.2758620689655
12	Castellón/Castelló	064	12064	Fuentes de Ayódar	110	60	50	54.5454545454545	45.4545454545455
12	Castellón/Castelló	065	12065	Gaibiel	203	111	92	54.679802955665	45.320197044335
12	Castellón/Castelló	067	12067	Geldo	689	344	345	49.9274310595065	50.0725689404935
12	Castellón/Castelló	068	12068	Herbés	103	54	49	52.4271844660194	47.5728155339806
12	Castellón/Castelló	069	12069	Higueras	39	22	17	56.4102564102564	43.5897435897436
12	Castellón/Castelló	070	12070	Jana (la)	812	411	401	50.615763546798	49.384236453202
12	Castellón/Castelló	071	12071	Jérica	1554	779	775	50.1287001287001	49.8712998712999
12	Castellón/Castelló	072	12072	Lucena del Cid	1538	774	764	50.3250975292588	49.6749024707412
12	Castellón/Castelló	073	12073	Ludiente	225	117	108	52	48
12	Castellón/Castelló	074	12074	Llosa (la)	918	461	457	50.2178649237473	49.7821350762527
12	Castellón/Castelló	075	12075	Mata de Morella (la)	180	90	90	50	50
12	Castellón/Castelló	076	12076	Matet	140	71	69	50.7142857142857	49.2857142857143
12	Castellón/Castelló	077	12077	Moncofa	3905	1997	1908	51.1395646606914	48.8604353393086
12	Castellón/Castelló	078	12078	Montán	347	179	168	51.5850144092219	48.4149855907781
12	Castellón/Castelló	079	12079	Montanejos	415	209	206	50.3614457831325	49.6385542168675
12	Castellón/Castelló	080	12080	Morella	2711	1309	1402	48.2847657690889	51.7152342309111
12	Castellón/Castelló	081	12081	Navajas	541	275	266	50.8317929759704	49.1682070240296
12	Castellón/Castelló	082	12082	Nules	11453	5698	5755	49.7511569021217	50.2488430978783
12	Castellón/Castelló	083	12083	Olocau del Rey	144	78	66	54.1666666666667	45.8333333333333
12	Castellón/Castelló	084	12084	Onda	19303	9774	9529	50.6346163808735	49.3653836191266
12	Castellón/Castelló	085	12085	Oropesa del Mar/Orpesa	3734	1912	1822	51.2051419389395	48.7948580610605
12	Castellón/Castelló	087	12087	Palanques	21	13	8	61.9047619047619	38.0952380952381
12	Castellón/Castelló	088	12088	Pavías	61	37	24	60.655737704918	39.344262295082
12	Castellón/Castelló	089	12089	Peñíscola	4548	2293	2255	50.4177660510114	49.5822339489886
12	Castellón/Castelló	090	12090	Pina de Montalgrao	167	89	78	53.2934131736527	46.7065868263473
12	Castellón/Castelló	091	12091	Portell de Morella	262	127	135	48.4732824427481	51.5267175572519
12	Castellón/Castelló	092	12092	Puebla de Arenoso	164	82	82	50	50
12	Castellón/Castelló	093	12093	Pobla de Benifassà (la)	269	132	137	49.0706319702602	50.9293680297398
12	Castellón/Castelló	094	12094	Pobla Tornesa (la)	558	273	285	48.9247311827957	51.0752688172043
12	Castellón/Castelló	095	12095	Ribesalbes	1284	647	637	50.3894080996885	49.6105919003115
12	Castellón/Castelló	096	12096	Rossell	1119	572	547	51.1170688114388	48.8829311885612
12	Castellón/Castelló	097	12097	Sacañet	84	52	32	61.9047619047619	38.0952380952381
12	Castellón/Castelló	098	12098	Salzadella (la)	814	405	409	49.7542997542998	50.2457002457002
12	Castellón/Castelló	099	12099	San Jorge	581	288	293	49.5697074010327	50.4302925989673
12	Castellón/Castelló	100	12100	Sant Mateu	1806	891	915	49.3355481727575	50.6644518272425
12	Castellón/Castelló	101	12101	San Rafael del Río	455	242	213	53.1868131868132	46.8131868131868
12	Castellón/Castelló	102	12102	Santa Magdalena de Pulpis	723	374	349	51.7289073305671	48.2710926694329
12	Castellón/Castelló	103	12103	Sarratella	87	47	40	54.0229885057471	45.9770114942529
12	Castellón/Castelló	104	12104	Segorbe	7839	3819	4020	48.7179487179487	51.2820512820513
12	Castellón/Castelló	105	12105	Sierra Engarcerán	1098	577	521	52.5500910746812	47.4499089253188
12	Castellón/Castelló	106	12106	Soneja	1379	696	683	50.4713560551124	49.5286439448876
12	Castellón/Castelló	107	12107	Sot de Ferrer	422	215	207	50.9478672985782	49.0521327014218
12	Castellón/Castelló	108	12108	Sueras/Suera	547	270	277	49.3601462522852	50.6398537477148
12	Castellón/Castelló	109	12109	Tales	763	369	394	48.3617300131062	51.6382699868938
12	Castellón/Castelló	110	12110	Teresa	345	175	170	50.7246376811594	49.2753623188406
12	Castellón/Castelló	111	12111	Tírig	551	276	275	50.0907441016334	49.9092558983666
12	Castellón/Castelló	112	12112	Todolella	144	82	62	56.9444444444444	43.0555555555556
12	Castellón/Castelló	113	12113	Toga	103	54	49	52.4271844660194	47.5728155339806
12	Castellón/Castelló	114	12114	Torás	258	132	126	51.1627906976744	48.8372093023256
12	Castellón/Castelló	115	12115	Toro (El)	336	177	159	52.6785714285714	47.3214285714286
12	Castellón/Castelló	116	12116	Torralba del Pinar	75	35	40	46.6666666666667	53.3333333333333
12	Castellón/Castelló	117	12117	Torreblanca	4614	2294	2320	49.7182488079757	50.2817511920243
12	Castellón/Castelló	118	12118	Torrechiva	76	49	27	64.4736842105263	35.5263157894737
12	Castellón/Castelló	119	12119	Torre d'En Besora (la)	210	107	103	50.952380952381	49.047619047619
12	Castellón/Castelló	120	12120	Torre Endoménech	235	118	117	50.2127659574468	49.7872340425532
12	Castellón/Castelló	121	12121	Traiguera	1588	823	765	51.8261964735516	48.1738035264484
12	Castellón/Castelló	122	12122	Useras/Useres (les)	986	503	483	51.0141987829615	48.9858012170385
12	Castellón/Castelló	123	12123	Vallat	57	27	30	47.3684210526316	52.6315789473684
12	Castellón/Castelló	124	12124	Vall d'Alba	1948	976	972	50.1026694045174	49.8973305954826
12	Castellón/Castelló	125	12125	Vall de Almonacid	293	154	139	52.5597269624573	47.4402730375427
12	Castellón/Castelló	126	12126	Vall d'Uixó (la)	29152	14503	14649	49.7495883644347	50.2504116355653
12	Castellón/Castelló	127	12127	Vallibona	93	53	40	56.989247311828	43.010752688172
12	Castellón/Castelló	128	12128	Vilafamés	1471	780	691	53.025152957172	46.974847042828
12	Castellón/Castelló	129	12129	Villafranca del Cid	2635	1284	1351	48.7286527514232	51.2713472485769
12	Castellón/Castelló	130	12130	Villahermosa del Río	452	247	205	54.6460176991151	45.353982300885
12	Castellón/Castelló	131	12131	Villamalur	141	79	62	56.0283687943262	43.9716312056738
12	Castellón/Castelló	132	12132	Vilanova d'Alcolea	639	328	311	51.3302034428795	48.6697965571205
12	Castellón/Castelló	133	12133	Villanueva de Viver	79	40	39	50.6329113924051	49.3670886075949
12	Castellón/Castelló	134	12134	Vilar de Canes	183	94	89	51.3661202185792	48.6338797814208
12	Castellón/Castelló	135	12135	Villarreal/Vila-real	41531	20683	20848	49.8013532060389	50.1986467939611
12	Castellón/Castelló	136	12136	Villavieja	3366	1684	1682	50.0297088532383	49.9702911467617
12	Castellón/Castelló	137	12137	Villores	63	32	31	50.7936507936508	49.2063492063492
12	Castellón/Castelló	138	12138	Vinaròs	22552	11025	11527	48.8870166725789	51.1129833274211
12	Castellón/Castelló	139	12139	Vistabella del Maestrazgo	453	228	225	50.3311258278146	49.6688741721854
12	Castellón/Castelló	140	12140	Viver	1297	656	641	50.5782575173477	49.4217424826523
12	Castellón/Castelló	141	12141	Zorita del Maestrazgo	138	68	70	49.2753623188406	50.7246376811594
12	Castellón/Castelló	142	12142	Zucaina	215	121	94	56.2790697674419	43.7209302325581
12	Castellón/Castelló	901	12901	Alquerías del Niño Perdido	3543	1722	1821	48.6028789161727	51.3971210838273
12	Castellón/Castelló	902	12902	Sant Joan de Moró	1783	920	863	51.5984296130118	48.4015703869882
13	Ciudad Real	001	13001	Abenójar	1762	878	884	49.8297389330307	50.1702610669694
13	Ciudad Real	002	13002	Agudo	2097	1065	1032	50.7868383404864	49.2131616595136
13	Ciudad Real	003	13003	Alamillo	723	367	356	50.7607192254495	49.2392807745505
13	Ciudad Real	004	13004	Albaladejo	1641	829	812	50.5179768433882	49.4820231566118
13	Ciudad Real	005	13005	Alcázar de San Juan	26150	12738	13412	48.7112810707457	51.2887189292543
13	Ciudad Real	006	13006	Alcoba	769	400	369	52.0156046814044	47.9843953185956
13	Ciudad Real	007	13007	Alcolea de Calatrava	1656	834	822	50.3623188405797	49.6376811594203
13	Ciudad Real	008	13008	Alcubillas	680	327	353	48.0882352941176	51.9117647058824
13	Ciudad Real	009	13009	Aldea del Rey	2186	1067	1119	48.8106129917658	51.1893870082342
13	Ciudad Real	010	13010	Alhambra	1259	637	622	50.5957108816521	49.4042891183479
13	Ciudad Real	011	13011	Almadén	7152	3416	3736	47.7628635346756	52.2371364653244
13	Ciudad Real	012	13012	Almadenejos	579	301	278	51.986183074266	48.013816925734
13	Ciudad Real	013	13013	Almagro	8262	4017	4245	48.6201888162672	51.3798111837327
13	Ciudad Real	014	13014	Almedina	760	387	373	50.921052631579	49.0789473684211
13	Ciudad Real	015	13015	Almodóvar del Campo	7452	3665	3787	49.1814278046162	50.8185721953838
13	Ciudad Real	016	13016	Almuradiel	978	454	524	46.4212678936605	53.5787321063395
13	Ciudad Real	017	13017	Anchuras	450	257	193	57.1111111111111	42.8888888888889
13	Ciudad Real	018	13018	Arenas de San Juan	1083	547	536	50.5078485687904	49.4921514312096
13	Ciudad Real	019	13019	Argamasilla de Alba	6710	3321	3389	49.4932935916543	50.5067064083458
13	Ciudad Real	020	13020	Argamasilla de Calatrava	5369	2713	2656	50.5308251070963	49.4691748929037
13	Ciudad Real	021	13021	Arroba de los Montes	627	321	306	51.1961722488038	48.8038277511962
13	Ciudad Real	022	13022	Ballesteros de Calatrava	575	281	294	48.8695652173913	51.1304347826087
13	Ciudad Real	023	13023	Bolaños de Calatrava	10679	5329	5350	49.9016761869089	50.0983238130911
13	Ciudad Real	024	13024	Brazatortas	1241	620	621	49.9597099113618	50.0402900886382
13	Ciudad Real	025	13025	Cabezarados	387	199	188	51.421188630491	48.5788113695091
13	Ciudad Real	026	13026	Cabezarrubias del Puerto	636	328	308	51.5723270440252	48.4276729559748
13	Ciudad Real	027	13027	Calzada de Calatrava	4687	2299	2388	49.050565393642	50.949434606358
13	Ciudad Real	028	13028	Campo de Criptana	13042	6401	6641	49.0798957215151	50.9201042784849
13	Ciudad Real	029	13029	Cañada de Calatrava	82	46	36	56.0975609756098	43.9024390243903
13	Ciudad Real	030	13030	Caracuel de Calatrava	176	96	80	54.5454545454545	45.4545454545455
13	Ciudad Real	031	13031	Carrión de Calatrava	2633	1288	1345	48.9175845043676	51.0824154956324
13	Ciudad Real	032	13032	Carrizosa	1692	845	847	49.9408983451537	50.0591016548463
13	Ciudad Real	033	13033	Castellar de Santiago	2220	1078	1142	48.5585585585586	51.4414414414414
13	Ciudad Real	034	13034	Ciudad Real	60243	28480	31763	47.2752020981691	52.7247979018309
13	Ciudad Real	035	13035	Corral de Calatrava	1306	668	638	51.1485451761103	48.8514548238897
13	Ciudad Real	036	13036	Cortijos (Los)	1090	538	552	49.3577981651376	50.6422018348624
13	Ciudad Real	037	13037	Cózar	1296	623	673	48.070987654321	51.929012345679
13	Ciudad Real	038	13038	Chillón	2347	1134	1213	48.3170004260759	51.6829995739242
13	Ciudad Real	039	13039	Daimiel	17276	8488	8788	49.1317434591341	50.8682565408659
13	Ciudad Real	040	13040	Fernancaballero	1042	499	543	47.8886756238004	52.1113243761996
13	Ciudad Real	041	13041	Fontanarejo	363	194	169	53.4435261707989	46.5564738292011
13	Ciudad Real	042	13042	Fuencaliente	1304	679	625	52.0705521472393	47.9294478527607
13	Ciudad Real	043	13043	Fuenllana	328	155	173	47.2560975609756	52.7439024390244
13	Ciudad Real	044	13044	Fuente el Fresno	3508	1737	1771	49.515393386545	50.484606613455
13	Ciudad Real	045	13045	Granátula de Calatrava	1002	479	523	47.8043912175649	52.1956087824351
13	Ciudad Real	046	13046	Guadalmez	1075	545	530	50.6976744186047	49.3023255813954
13	Ciudad Real	047	13047	Herencia	7023	3519	3504	50.1067919692439	49.8932080307561
13	Ciudad Real	048	13048	Hinojosas de Calatrava	762	374	388	49.0813648293963	50.9186351706037
13	Ciudad Real	049	13049	Horcajo de los Montes	1097	549	548	50.0455788514129	49.9544211485871
13	Ciudad Real	050	13050	Labores (Las)	704	343	361	48.7215909090909	51.2784090909091
13	Ciudad Real	051	13051	Luciana	444	224	220	50.4504504504505	49.5495495495496
13	Ciudad Real	052	13052	Malagón	7955	3928	4027	49.3777498428661	50.6222501571339
13	Ciudad Real	053	13053	Manzanares	17216	8422	8794	48.9196096654275	51.0803903345725
13	Ciudad Real	054	13054	Membrilla	6609	3308	3301	50.0529580874565	49.9470419125435
13	Ciudad Real	055	13055	Mestanza	917	444	473	48.4187568157034	51.5812431842966
13	Ciudad Real	056	13056	Miguelturra	9863	4928	4935	49.9645138396026	50.0354861603975
13	Ciudad Real	057	13057	Montiel	1673	845	828	50.5080693365212	49.4919306634788
13	Ciudad Real	058	13058	Moral de Calatrava	5218	2553	2665	48.9267918742813	51.0732081257187
13	Ciudad Real	059	13059	Navalpino	311	149	162	47.9099678456592	52.0900321543408
13	Ciudad Real	060	13060	Navas de Estena	410	221	189	53.9024390243903	46.0975609756098
13	Ciudad Real	061	13061	Pedro Muñoz	7186	3586	3600	49.9025883662677	50.0974116337323
13	Ciudad Real	062	13062	Picón	661	352	309	53.2526475037822	46.7473524962178
13	Ciudad Real	063	13063	Piedrabuena	4888	2485	2403	50.8387888707038	49.1612111292962
13	Ciudad Real	064	13064	Poblete	806	407	399	50.4962779156328	49.5037220843672
13	Ciudad Real	065	13065	Porzuna	3919	1990	1929	50.7782597601429	49.2217402398571
13	Ciudad Real	066	13066	Pozuelo de Calatrava	2545	1257	1288	49.3909626719057	50.6090373280943
13	Ciudad Real	067	13067	Pozuelos de Calatrava (Los)	572	292	280	51.0489510489511	48.951048951049
13	Ciudad Real	068	13068	Puebla de Don Rodrigo	1318	693	625	52.5796661608498	47.4203338391502
13	Ciudad Real	069	13069	Puebla del Príncipe	1080	535	545	49.537037037037	50.462962962963
13	Ciudad Real	070	13070	Puerto Lápice	1037	524	513	50.5303760848602	49.4696239151398
13	Ciudad Real	071	13071	Puertollano	50212	24364	25848	48.5222655938819	51.4777344061181
13	Ciudad Real	072	13072	Retuerta del Bullaque	1019	535	484	52.5024533856722	47.4975466143278
13	Ciudad Real	073	13073	Saceruela	774	411	363	53.1007751937985	46.8992248062016
13	Ciudad Real	074	13074	San Carlos del Valle	1241	618	623	49.798549556809	50.201450443191
13	Ciudad Real	075	13075	San Lorenzo de Calatrava	321	168	153	52.3364485981308	47.6635514018692
13	Ciudad Real	076	13076	Santa Cruz de los Cáñamos	654	328	326	50.1529051987768	49.8470948012232
13	Ciudad Real	077	13077	Santa Cruz de Mudela	4830	2374	2456	49.1511387163561	50.8488612836439
13	Ciudad Real	078	13078	Socuéllamos	11228	5522	5706	49.1806198788743	50.8193801211258
13	Ciudad Real	079	13079	Solana (La)	15066	7538	7528	50.033187309173	49.966812690827
13	Ciudad Real	080	13080	Solana del Pino	554	276	278	49.8194945848375	50.1805054151625
13	Ciudad Real	081	13081	Terrinches	970	480	490	49.4845360824742	50.5154639175258
13	Ciudad Real	082	13082	Tomelloso	29284	14314	14970	48.8799344351865	51.1200655648136
13	Ciudad Real	083	13083	Torralba de Calatrava	2899	1432	1467	49.3963435667472	50.6036564332528
13	Ciudad Real	084	13084	Torre de Juan Abad	1406	680	726	48.3641536273115	51.6358463726885
13	Ciudad Real	085	13085	Torrenueva	3271	1653	1618	50.5350045857536	49.4649954142464
13	Ciudad Real	086	13086	Valdemanco del Esteras	310	155	155	50	50
13	Ciudad Real	087	13087	Valdepeñas	26395	12685	13710	48.058344383406	51.9416556165941
13	Ciudad Real	088	13088	Valenzuela de Calatrava	798	385	413	48.2456140350877	51.7543859649123
13	Ciudad Real	089	13089	Villahermosa	2628	1230	1398	46.8036529680365	53.1963470319635
13	Ciudad Real	090	13090	Villamanrique	1672	817	855	48.8636363636364	51.1363636363636
13	Ciudad Real	091	13091	Villamayor de Calatrava	639	320	319	50.0782472613459	49.9217527386542
13	Ciudad Real	092	13092	Villanueva de la Fuente	2648	1304	1344	49.2447129909366	50.7552870090635
13	Ciudad Real	093	13093	Villanueva de los Infantes	5805	2798	3007	48.1998277347115	51.8001722652885
13	Ciudad Real	094	13094	Villanueva de San Carlos	460	227	233	49.3478260869565	50.6521739130435
13	Ciudad Real	095	13095	Villar del Pozo	106	57	49	53.7735849056604	46.2264150943396
13	Ciudad Real	096	13096	Villarrubia de los Ojos	9583	4761	4822	49.6817280601064	50.3182719398936
13	Ciudad Real	097	13097	Villarta de San Juan	2970	1496	1474	50.3703703703704	49.6296296296296
13	Ciudad Real	098	13098	Viso del Marqués	3041	1516	1525	49.8520223610654	50.1479776389346
13	Ciudad Real	901	13901	Robledo (El)	1119	586	533	52.3681858802502	47.6318141197498
13	Ciudad Real	902	13902	Ruidera	594	312	282	52.5252525252525	47.4747474747475
13	Ciudad Real	903	13903	Arenales de San Gregorio	629	325	304	51.6693163751987	48.3306836248013
13	Ciudad Real	904	13904	Llanos del Caudillo	718	373	345	51.949860724234	48.050139275766
14	Córdoba	001	14001	Adamuz	4465	2271	2194	50.8622620380739	49.1377379619261
14	Córdoba	002	14002	Aguilar de la Frontera	13393	6616	6777	49.3989397446427	50.6010602553573
14	Córdoba	003	14003	Alcaracejos	1469	726	743	49.4213750850919	50.5786249149081
14	Córdoba	004	14004	Almedinilla	2527	1240	1287	49.0700435298773	50.9299564701227
14	Córdoba	005	14005	Almodóvar del Río	7013	3467	3546	49.4367603022957	50.5632396977043
14	Córdoba	006	14006	Añora	1618	797	821	49.2583436341162	50.7416563658838
14	Córdoba	007	14007	Baena	19725	9758	9967	49.4702154626109	50.5297845373891
14	Córdoba	008	14008	Belalcázar	3768	1835	1933	48.6995753715499	51.3004246284501
14	Córdoba	009	14009	Belmez	3924	1873	2051	47.7319062181448	52.2680937818553
14	Córdoba	010	14010	Benamejí	4788	2422	2366	50.5847953216374	49.4152046783626
14	Córdoba	011	14011	Blázquez (Los)	714	364	350	50.9803921568627	49.0196078431373
14	Córdoba	012	14012	Bujalance	8051	3943	4108	48.9752825735933	51.0247174264067
14	Córdoba	013	14013	Cabra	20711	10083	10628	48.6842740572643	51.3157259427357
14	Córdoba	014	14014	Cañete de las Torres	3328	1663	1665	49.9699519230769	50.0300480769231
14	Córdoba	015	14015	Carcabuey	2868	1442	1426	50.278940027894	49.721059972106
14	Córdoba	016	14016	Cardeña	1907	971	936	50.9176717357105	49.0823282642895
14	Córdoba	017	14017	Carlota (La)	10471	5245	5226	50.090726769172	49.909273230828
14	Córdoba	018	14018	Carpio (El)	4465	2178	2287	48.7793952967525	51.2206047032475
14	Córdoba	019	14019	Castro del Río	8040	3939	4101	48.9925373134328	51.0074626865672
14	Córdoba	020	14020	Conquista	501	253	248	50.499001996008	49.500998003992
14	Córdoba	021	14021	Córdoba	313463	151060	162403	48.1906955525852	51.8093044474149
14	Córdoba	022	14022	Doña Mencía	4946	2470	2476	49.9393449251921	50.0606550748079
14	Córdoba	023	14023	Dos Torres	2586	1270	1316	49.1105955143078	50.8894044856922
14	Córdoba	024	14024	Encinas Reales	2401	1175	1226	48.9379425239484	51.0620574760516
14	Córdoba	025	14025	Espejo	3963	1977	1986	49.886449659349	50.113550340651
14	Córdoba	026	14026	Espiel	2441	1212	1229	49.6517820565342	50.3482179434658
14	Córdoba	027	14027	Fernán-Núñez	9497	4742	4755	49.9315573338949	50.0684426661051
14	Córdoba	028	14028	Fuente la Lancha	411	201	210	48.9051094890511	51.0948905109489
14	Córdoba	029	14029	Fuente Obejuna	5890	2994	2896	50.8319185059423	49.1680814940577
14	Córdoba	030	14030	Fuente Palmera	9897	4998	4899	50.5001515610791	49.4998484389209
14	Córdoba	031	14031	Fuente-Tójar	817	389	428	47.6132190942472	52.3867809057528
14	Córdoba	032	14032	Granjuela (La)	496	265	231	53.4274193548387	46.5725806451613
14	Córdoba	033	14033	Guadalcázar	1168	589	579	50.4280821917808	49.5719178082192
14	Córdoba	034	14034	Guijo (El)	394	195	199	49.492385786802	50.507614213198
14	Córdoba	035	14035	Hinojosa del Duque	7928	3815	4113	48.1205852674067	51.8794147325933
14	Córdoba	036	14036	Hornachuelos	4860	2433	2427	50.0617283950617	49.9382716049383
14	Córdoba	037	14037	Iznájar	5077	2555	2522	50.3249950758322	49.6750049241678
14	Córdoba	038	14038	Lucena	36445	18081	18364	49.6117437234189	50.3882562765812
14	Córdoba	039	14039	Luque	3363	1673	1690	49.7472494796313	50.2527505203687
14	Córdoba	040	14040	Montalbán de Córdoba	4558	2288	2270	50.1974550241334	49.8025449758666
14	Córdoba	041	14041	Montemayor	3813	1912	1901	50.1442433779177	49.8557566220824
14	Córdoba	042	14042	Montilla	22973	11331	11642	49.3231184433901	50.6768815566099
14	Córdoba	043	14043	Montoro	9457	4630	4827	48.9584434810194	51.0415565189807
14	Córdoba	044	14044	Monturque	1962	982	980	50.0509683995923	49.9490316004077
14	Córdoba	045	14045	Moriles	3797	1888	1909	49.7234658941269	50.2765341058731
14	Córdoba	046	14046	Nueva Carteya	5583	2808	2775	50.2955400322407	49.7044599677593
14	Córdoba	047	14047	Obejo	1509	759	750	50.2982107355865	49.7017892644135
14	Córdoba	048	14048	Palenciana	1571	784	787	49.9045194143857	50.0954805856143
14	Córdoba	049	14049	Palma del Río	19266	9580	9686	49.7249039759161	50.2750960240839
14	Córdoba	050	14050	Pedro Abad	2893	1439	1454	49.7407535430349	50.2592464569651
14	Córdoba	051	14051	Pedroche	1843	903	940	48.9962018448182	51.0037981551818
14	Córdoba	052	14052	Peñarroya-Pueblonuevo	13024	6210	6814	47.6812039312039	52.3187960687961
14	Córdoba	053	14053	Posadas	7101	3522	3579	49.5986480777355	50.4013519222645
14	Córdoba	054	14054	Pozoblanco	16282	7855	8427	48.2434590345167	51.7565409654834
14	Córdoba	055	14055	Priego de Córdoba	22053	10759	11294	48.787013104793	51.212986895207
14	Córdoba	056	14056	Puente Genil	27909	13739	14170	49.2278476477122	50.7721523522878
14	Córdoba	057	14057	Rambla (La)	7299	3639	3660	49.8561446773531	50.1438553226469
14	Córdoba	058	14058	Rute	9923	4911	5012	49.4910813262118	50.5089186737882
14	Córdoba	059	14059	San Sebastián de los Ballesteros	852	435	417	51.056338028169	48.943661971831
14	Córdoba	060	14060	Santaella	5878	2957	2921	50.3062266076897	49.6937733923103
14	Córdoba	061	14061	Santa Eufemia	1148	580	568	50.5226480836237	49.4773519163763
14	Córdoba	062	14062	Torrecampo	1416	687	729	48.5169491525424	51.4830508474576
14	Córdoba	063	14063	Valenzuela	1440	706	734	49.0277777777778	50.9722222222222
14	Córdoba	064	14064	Valsequillo	450	216	234	48	52
14	Córdoba	065	14065	Victoria (La)	1786	892	894	49.9440089585666	50.0559910414334
14	Córdoba	066	14066	Villa del Río	7171	3621	3550	50.4950495049505	49.5049504950495
14	Córdoba	067	14067	Villafranca de Córdoba	3625	1874	1751	51.6965517241379	48.3034482758621
14	Córdoba	068	14068	Villaharta	642	322	320	50.1557632398754	49.8442367601246
14	Córdoba	069	14069	Villanueva de Córdoba	9807	4768	5039	48.6183338431732	51.3816661568268
14	Córdoba	070	14070	Villanueva del Duque	1808	843	965	46.6261061946903	53.3738938053097
14	Córdoba	071	14071	Villanueva del Rey	1258	640	618	50.8744038155803	49.1255961844197
14	Córdoba	072	14072	Villaralto	1526	732	794	47.9685452162516	52.0314547837484
14	Córdoba	073	14073	Villaviciosa de Córdoba	3854	1973	1881	51.1935651271406	48.8064348728594
14	Córdoba	074	14074	Viso (El)	3071	1492	1579	48.5835232823185	51.4164767176815
14	Córdoba	075	14075	Zuheros	900	451	449	50.1111111111111	49.8888888888889
15	Coruña (A)	001	15001	Abegondo	5594	2806	2788	50.1608866642832	49.8391133357168
15	Coruña (A)	002	15002	Ames	16549	8048	8501	48.6313372409209	51.3686627590791
15	Coruña (A)	003	15003	Aranga	2423	1212	1211	50.0206355757326	49.9793644242674
15	Coruña (A)	004	15004	Ares	4744	2349	2395	49.5151770657673	50.4848229342327
15	Coruña (A)	005	15005	Arteixo	22153	11120	11033	50.1963616665914	49.8036383334086
15	Coruña (A)	006	15006	Arzúa	6886	3367	3519	48.8963113563753	51.1036886436247
15	Coruña (A)	007	15007	Baña (A)	5324	2559	2765	48.0653643876784	51.9346356123216
15	Coruña (A)	008	15008	Bergondo	6119	2984	3135	48.7661382578853	51.2338617421147
15	Coruña (A)	009	15009	Betanzos	12361	5851	6510	47.3343580616455	52.6656419383545
15	Coruña (A)	010	15010	Boimorto	2598	1303	1295	50.1539645881447	49.8460354118553
15	Coruña (A)	011	15011	Boiro	18038	8751	9287	48.5142476993015	51.4857523006985
15	Coruña (A)	012	15012	Boqueixón	4291	2104	2187	49.0328594733162	50.9671405266838
15	Coruña (A)	013	15013	Brión	6239	3009	3230	48.2288828337875	51.7711171662125
15	Coruña (A)	014	15014	Cabana de Bergantiños	5733	2843	2890	49.5900924472353	50.4099075527647
15	Coruña (A)	015	15015	Cabanas	3262	1577	1685	48.3445738810546	51.6554261189454
15	Coruña (A)	016	15016	Camariñas	6813	3357	3456	49.2734478203435	50.7265521796565
15	Coruña (A)	017	15017	Cambre	17805	8738	9067	49.076102218478	50.9238977815221
15	Coruña (A)	018	15018	Capela (A)	1595	784	811	49.153605015674	50.846394984326
15	Coruña (A)	019	15019	Carballo	28271	13749	14522	48.6328746772311	51.3671253227689
15	Coruña (A)	020	15020	Carnota	5645	2716	2929	48.1133746678477	51.8866253321523
15	Coruña (A)	021	15021	Carral	5275	2554	2721	48.4170616113744	51.5829383886256
15	Coruña (A)	022	15022	Cedeira	7528	3686	3842	48.9638682252922	51.0361317747078
15	Coruña (A)	023	15023	Cee	7364	3554	3810	48.261814231396	51.738185768604
15	Coruña (A)	024	15024	Cerceda	5573	2725	2848	48.8964650995873	51.1035349004127
15	Coruña (A)	025	15025	Cerdido	1668	806	862	48.3213429256595	51.6786570743405
15	Coruña (A)	026	15026	Cesuras	2646	1316	1330	49.7354497354497	50.2645502645503
15	Coruña (A)	027	15027	Coirós	1552	763	789	49.1623711340206	50.8376288659794
15	Coruña (A)	028	15028	Corcubión	1945	934	1011	48.0205655526992	51.9794344473008
15	Coruña (A)	029	15029	Coristanco	8146	4016	4130	49.3002700712006	50.6997299287994
15	Coruña (A)	030	15030	Coruña (A)	241769	112264	129505	46.4344063961881	53.5655936038119
15	Coruña (A)	031	15031	Culleredo	20890	10247	10643	49.0521780756343	50.9478219243657
15	Coruña (A)	032	15032	Curtis	4468	2191	2277	49.0376007162041	50.9623992837959
15	Coruña (A)	033	15033	Dodro	3280	1591	1689	48.5060975609756	51.4939024390244
15	Coruña (A)	034	15034	Dumbría	4529	2186	2343	48.2667255464783	51.7332744535218
15	Coruña (A)	035	15035	Fene	14848	7291	7557	49.1042564655172	50.8957435344828
15	Coruña (A)	036	15036	Ferrol	81255	37887	43368	46.6272844748016	53.3727155251984
15	Coruña (A)	037	15037	Fisterra	5224	2618	2606	50.114854517611	49.885145482389
15	Coruña (A)	038	15038	Frades	3083	1538	1545	49.8864742134285	50.1135257865715
15	Coruña (A)	039	15039	Irixoa	1719	848	871	49.3310063990692	50.6689936009308
15	Coruña (A)	040	15040	Laxe	3551	1764	1787	49.6761475640665	50.3238524359335
15	Coruña (A)	041	15041	Laracha	10701	5215	5486	48.733763199701	51.266236800299
15	Coruña (A)	042	15042	Lousame	4199	2009	2190	47.8447249345082	52.1552750654918
15	Coruña (A)	043	15043	Malpica de Bergantiños	7262	3561	3701	49.0360782153677	50.9639217846323
15	Coruña (A)	044	15044	Mañón	1932	938	994	48.5507246376812	51.4492753623188
15	Coruña (A)	045	15045	Mazaricos	6185	2978	3207	48.1487469684721	51.8512530315279
15	Coruña (A)	046	15046	Melide	8441	4169	4272	49.3898827153181	50.6101172846819
15	Coruña (A)	047	15047	Mesía	3409	1692	1717	49.6333235552948	50.3666764447052
15	Coruña (A)	048	15048	Miño	4870	2302	2568	47.2689938398357	52.7310061601643
15	Coruña (A)	049	15049	Moeche	1561	743	818	47.5976937860346	52.4023062139654
15	Coruña (A)	050	15050	Monfero	2695	1383	1312	51.317254174397	48.682745825603
15	Coruña (A)	051	15051	Mugardos	5984	2894	3090	48.3622994652407	51.6377005347594
15	Coruña (A)	052	15052	Muxía	6213	3033	3180	48.8169966199903	51.1830033800097
15	Coruña (A)	053	15053	Muros	10519	5042	5477	47.9323129575055	52.0676870424945
15	Coruña (A)	054	15054	Narón	30328	14679	15649	48.4008177261936	51.5991822738064
15	Coruña (A)	055	15055	Neda	6166	2994	3172	48.5566007135907	51.4433992864093
15	Coruña (A)	056	15056	Negreira	6588	3160	3428	47.9659987856709	52.0340012143291
15	Coruña (A)	057	15057	Noia	14404	6883	7521	47.785337406276	52.214662593724
15	Coruña (A)	058	15058	Oleiros	26016	12642	13374	48.5931734317343	51.4068265682657
15	Coruña (A)	059	15059	Ordes	11942	5789	6153	48.4759671746776	51.5240328253224
15	Coruña (A)	060	15060	Oroso	5236	2595	2641	49.5607333842628	50.4392666157372
15	Coruña (A)	061	15061	Ortigueira	8533	4057	4476	47.5448259697644	52.4551740302356
15	Coruña (A)	062	15062	Outes	8634	4127	4507	47.799397729905	52.200602270095
15	Coruña (A)	063	15063	Oza dos Ríos	3208	1553	1655	48.4102244389027	51.5897755610973
15	Coruña (A)	064	15064	Paderne	2753	1318	1435	47.8750454050127	52.1249545949873
15	Coruña (A)	065	15065	Padrón	9260	4453	4807	48.0885529157667	51.9114470842333
15	Coruña (A)	066	15066	Pino (O)	4934	2452	2482	49.6959870287799	50.3040129712201
15	Coruña (A)	067	15067	Pobra do Caramiñal (A)	9955	4764	5191	47.8553490708187	52.1446509291813
15	Coruña (A)	068	15068	Ponteceso	7155	3579	3576	50.020964360587	49.979035639413
15	Coruña (A)	069	15069	Pontedeume	8936	4291	4645	48.0192479856759	51.9807520143241
15	Coruña (A)	070	15070	Pontes de García Rodríguez (As)	12488	6297	6191	50.4244074311339	49.5755925688661
15	Coruña (A)	071	15071	Porto do Son	10298	5023	5275	48.776461448825	51.223538551175
15	Coruña (A)	072	15072	Rianxo	11882	5797	6085	48.788082814341	51.211917185659
15	Coruña (A)	073	15073	Ribeira	26478	13036	13442	49.2333257798927	50.7666742201073
15	Coruña (A)	074	15074	Rois	5216	2485	2731	47.6418711656442	52.3581288343558
15	Coruña (A)	075	15075	Sada	11015	5412	5603	49.1330004539265	50.8669995460735
15	Coruña (A)	076	15076	San Sadurniño	3431	1670	1761	48.6738560186535	51.3261439813465
15	Coruña (A)	077	15077	Santa Comba	10930	5390	5540	49.3138151875572	50.6861848124428
15	Coruña (A)	078	15078	Santiago de Compostela	93903	44038	49865	46.8973302237415	53.1026697762585
15	Coruña (A)	079	15079	Santiso	2282	1181	1101	51.7528483786152	48.2471516213847
15	Coruña (A)	080	15080	Sobrado	2518	1289	1229	51.1914217633042	48.8085782366958
15	Coruña (A)	081	15081	Somozas (As)	1473	734	739	49.8302783435166	50.1697216564834
15	Coruña (A)	082	15082	Teo	14447	7072	7375	48.9513393784177	51.0486606215823
15	Coruña (A)	083	15083	Toques	1626	841	785	51.7220172201722	48.2779827798278
15	Coruña (A)	084	15084	Tordoia	5100	2424	2676	47.5294117647059	52.4705882352941
15	Coruña (A)	085	15085	Touro	4865	2386	2479	49.0441932168551	50.9558067831449
15	Coruña (A)	086	15086	Trazo	3818	1874	1944	49.083289680461	50.916710319539
15	Coruña (A)	087	15087	Valdoviño	6790	3354	3436	49.3961708394698	50.6038291605302
15	Coruña (A)	088	15088	Val do Dubra	4892	2390	2502	48.8552739165985	51.1447260834015
15	Coruña (A)	089	15089	Vedra	5083	2429	2654	47.7867401141058	52.2132598858942
15	Coruña (A)	090	15090	Vilasantar	1678	858	820	51.1323003575685	48.8676996424315
15	Coruña (A)	091	15091	Vilarmaior	1417	724	693	51.0938602681722	48.9061397318278
15	Coruña (A)	092	15092	Vimianzo	8766	4263	4503	48.631074606434	51.3689253935661
15	Coruña (A)	093	15093	Zas	6212	3019	3193	48.5994848679974	51.4005151320026
15	Coruña (A)	901	15901	Cariño	5036	2457	2579	48.7887212073074	51.2112787926926
16	Cuenca	001	16001	Abia de la Obispalía	85	46	39	54.1176470588235	45.8823529411765
16	Cuenca	002	16002	Acebrón (El)	284	142	142	50	50
16	Cuenca	003	16003	Alarcón	208	97	111	46.6346153846154	53.3653846153846
16	Cuenca	004	16004	Albaladejo del Cuende	411	214	197	52.0681265206813	47.9318734793187
16	Cuenca	005	16005	Albalate de las Nogueras	378	201	177	53.1746031746032	46.8253968253968
16	Cuenca	006	16006	Albendea	178	90	88	50.561797752809	49.438202247191
16	Cuenca	007	16007	Alberca de Záncara (La)	1741	857	884	49.2245835726594	50.7754164273406
16	Cuenca	008	16008	Alcalá de la Vega	176	94	82	53.4090909090909	46.5909090909091
16	Cuenca	009	16009	Alcantud	120	65	55	54.1666666666667	45.8333333333333
16	Cuenca	010	16010	Alcázar del Rey	252	124	128	49.2063492063492	50.7936507936508
16	Cuenca	011	16011	Alcohujate	68	38	30	55.8823529411765	44.1176470588235
16	Cuenca	012	16012	Alconchel de la Estrella	223	115	108	51.5695067264574	48.4304932735426
16	Cuenca	013	16013	Algarra	34	17	17	50	50
16	Cuenca	014	16014	Aliaguilla	852	449	403	52.6995305164319	47.3004694835681
16	Cuenca	015	16015	Almarcha (La)	618	315	303	50.9708737864078	49.0291262135922
16	Cuenca	016	16016	Almendros	340	172	168	50.5882352941176	49.4117647058824
16	Cuenca	017	16017	Almodóvar del Pinar	520	264	256	50.7692307692308	49.2307692307692
16	Cuenca	018	16018	Almonacid del Marquesado	556	287	269	51.6187050359712	48.3812949640288
16	Cuenca	019	16019	Altarejos	318	163	155	51.2578616352201	48.7421383647799
16	Cuenca	020	16020	Arandilla del Arroyo	45	22	23	48.8888888888889	51.1111111111111
16	Cuenca	022	16022	Arcos de la Sierra	126	67	59	53.1746031746032	46.8253968253968
16	Cuenca	023	16023	Chillarón de Cuenca	356	192	164	53.9325842696629	46.0674157303371
16	Cuenca	024	16024	Arguisuelas	196	102	94	52.0408163265306	47.9591836734694
16	Cuenca	025	16025	Arrancacepas	38	20	18	52.6315789473684	47.3684210526316
16	Cuenca	026	16026	Atalaya del Cañavate	138	70	68	50.7246376811594	49.2753623188406
16	Cuenca	027	16027	Barajas de Melo	732	358	374	48.9071038251366	51.0928961748634
16	Cuenca	029	16029	Barchín del Hoyo	131	74	57	56.4885496183206	43.5114503816794
16	Cuenca	030	16030	Bascuñana de San Pedro	47	27	20	57.4468085106383	42.5531914893617
16	Cuenca	031	16031	Beamud	108	60	48	55.5555555555556	44.4444444444444
16	Cuenca	032	16032	Belinchón	362	177	185	48.8950276243094	51.1049723756906
16	Cuenca	033	16033	Belmonte	2445	1151	1294	47.0756646216769	52.9243353783231
16	Cuenca	034	16034	Belmontejo	268	133	135	49.6268656716418	50.3731343283582
16	Cuenca	035	16035	Beteta	427	215	212	50.3512880562061	49.6487119437939
16	Cuenca	036	16036	Boniches	200	106	94	53	47
16	Cuenca	038	16038	Buciegas	86	41	45	47.6744186046512	52.3255813953488
16	Cuenca	039	16039	Buenache de Alarcón	631	326	305	51.6640253565769	48.3359746434231
16	Cuenca	040	16040	Buenache de la Sierra	119	71	48	59.6638655462185	40.3361344537815
16	Cuenca	041	16041	Buendía	491	238	253	48.4725050916497	51.5274949083503
16	Cuenca	042	16042	Campillo de Altobuey	1663	813	850	48.8875526157547	51.1124473842453
16	Cuenca	043	16043	Campillos-Paravientos	146	81	65	55.4794520547945	44.5205479452055
16	Cuenca	044	16044	Campillos-Sierra	104	57	47	54.8076923076923	45.1923076923077
16	Cuenca	045	16045	Canalejas del Arroyo	346	175	171	50.5780346820809	49.4219653179191
16	Cuenca	046	16046	Cañada del Hoyo	361	185	176	51.2465373961219	48.7534626038781
16	Cuenca	047	16047	Cañada Juncosa	350	187	163	53.4285714285714	46.5714285714286
16	Cuenca	048	16048	Cañamares	583	310	273	53.1732418524871	46.8267581475129
16	Cuenca	049	16049	Cañavate (El)	251	121	130	48.207171314741	51.792828685259
16	Cuenca	050	16050	Cañaveras	381	189	192	49.6062992125984	50.3937007874016
16	Cuenca	051	16051	Cañaveruelas	240	120	120	50	50
16	Cuenca	052	16052	Cañete	892	436	456	48.8789237668162	51.1210762331839
16	Cuenca	053	16053	Cañizares	626	331	295	52.8753993610224	47.1246006389776
16	Cuenca	055	16055	Carboneras de Guadazaón	1026	540	486	52.6315789473684	47.3684210526316
16	Cuenca	056	16056	Cardenete	722	369	353	51.1080332409972	48.8919667590028
16	Cuenca	057	16057	Carrascosa	101	63	38	62.3762376237624	37.6237623762376
16	Cuenca	058	16058	Carrascosa de Haro	153	77	76	50.3267973856209	49.6732026143791
16	Cuenca	060	16060	Casas de Benítez	1116	532	584	47.6702508960574	52.3297491039427
16	Cuenca	061	16061	Casas de Fernando Alonso	1431	703	728	49.1264849755416	50.8735150244584
16	Cuenca	062	16062	Casas de Garcimolina	36	18	18	50	50
16	Cuenca	063	16063	Casas de Guijarro	145	71	74	48.9655172413793	51.0344827586207
16	Cuenca	064	16064	Casas de Haro	894	457	437	51.1185682326622	48.8814317673378
16	Cuenca	065	16065	Casas de los Pinos	512	254	258	49.609375	50.390625
16	Cuenca	066	16066	Casasimarro	3047	1554	1493	51.0009845749918	48.9990154250082
16	Cuenca	067	16067	Castejón	226	112	114	49.5575221238938	50.4424778761062
16	Cuenca	068	16068	Castillejo de Iniesta	190	103	87	54.2105263157895	45.7894736842105
16	Cuenca	070	16070	Castillejo-Sierra	48	24	24	50	50
16	Cuenca	071	16071	Castillo-Albaráñez	31	16	15	51.6129032258065	48.3870967741936
16	Cuenca	072	16072	Castillo de Garcimuñoz	212	111	101	52.3584905660377	47.6415094339623
16	Cuenca	073	16073	Cervera del Llano	341	170	171	49.8533724340176	50.1466275659824
16	Cuenca	074	16074	Cierva (La)	60	30	30	50	50
16	Cuenca	078	16078	Cuenca	45707	21934	23773	47.9882731310303	52.0117268689697
16	Cuenca	079	16079	Cueva del Hierro	52	31	21	59.6153846153846	40.3846153846154
16	Cuenca	081	16081	Chumillas	40	26	14	65	35
16	Cuenca	082	16082	Enguídanos	573	288	285	50.261780104712	49.738219895288
16	Cuenca	083	16083	Fresneda de Altarejos	94	53	41	56.3829787234043	43.6170212765957
16	Cuenca	084	16084	Fresneda de la Sierra	75	36	39	48	52
16	Cuenca	085	16085	Frontera (La)	214	108	106	50.4672897196262	49.5327102803738
16	Cuenca	086	16086	Fuente de Pedro Naharro	1218	612	606	50.2463054187192	49.7536945812808
16	Cuenca	087	16087	Fuentelespino de Haro	316	168	148	53.1645569620253	46.8354430379747
16	Cuenca	088	16088	Fuentelespino de Moya	140	71	69	50.7142857142857	49.2857142857143
16	Cuenca	089	16089	Fuentes	506	263	243	51.9762845849802	48.0237154150198
16	Cuenca	091	16091	Fuertescusa	112	61	51	54.4642857142857	45.5357142857143
16	Cuenca	092	16092	Gabaldón	196	116	80	59.1836734693878	40.8163265306122
16	Cuenca	093	16093	Garaballa	146	77	69	52.7397260273973	47.2602739726027
16	Cuenca	094	16094	Gascueña	157	73	84	46.4968152866242	53.5031847133758
16	Cuenca	095	16095	Graja de Campalbo	134	73	61	54.4776119402985	45.5223880597015
16	Cuenca	096	16096	Graja de Iniesta	329	176	153	53.4954407294833	46.5045592705167
16	Cuenca	097	16097	Henarejos	265	125	140	47.1698113207547	52.8301886792453
16	Cuenca	098	16098	Herrumblar (El)	787	410	377	52.0965692503177	47.9034307496823
16	Cuenca	099	16099	Hinojosa (La)	340	166	174	48.8235294117647	51.1764705882353
16	Cuenca	100	16100	Hinojosos (Los)	1079	530	549	49.1195551436515	50.8804448563485
16	Cuenca	101	16101	Hito (El)	236	118	118	50	50
16	Cuenca	102	16102	Honrubia	1632	809	823	49.5710784313726	50.4289215686275
16	Cuenca	103	16103	Hontanaya	453	223	230	49.2273730684327	50.7726269315673
16	Cuenca	104	16104	Hontecillas	94	43	51	45.7446808510638	54.2553191489362
16	Cuenca	106	16106	Horcajo de Santiago	3585	1792	1793	49.9860529986053	50.0139470013947
16	Cuenca	107	16107	Huélamo	142	76	66	53.5211267605634	46.4788732394366
16	Cuenca	108	16108	Huelves	70	28	42	40	60
16	Cuenca	109	16109	Huérguina	130	67	63	51.5384615384615	48.4615384615385
16	Cuenca	110	16110	Huerta de la Obispalía	155	88	67	56.7741935483871	43.2258064516129
16	Cuenca	111	16111	Huerta del Marquesado	230	134	96	58.2608695652174	41.7391304347826
16	Cuenca	112	16112	Huete	2229	1131	1098	50.7402422611036	49.2597577388964
16	Cuenca	113	16113	Iniesta	3945	1976	1969	50.0887198986058	49.9112801013942
16	Cuenca	115	16115	Laguna del Marquesado	76	41	35	53.9473684210526	46.0526315789474
16	Cuenca	116	16116	Lagunaseca	123	55	68	44.7154471544715	55.2845528455285
16	Cuenca	117	16117	Landete	1541	767	774	49.7728747566515	50.2271252433485
16	Cuenca	118	16118	Ledaña	1902	939	963	49.3690851735016	50.6309148264984
16	Cuenca	119	16119	Leganiel	230	115	115	50	50
16	Cuenca	121	16121	Majadas (Las)	373	182	191	48.7935656836461	51.2064343163539
16	Cuenca	122	16122	Mariana	317	151	166	47.6340694006309	52.3659305993691
16	Cuenca	123	16123	Masegosa	127	69	58	54.3307086614173	45.6692913385827
16	Cuenca	124	16124	Mesas (Las)	2469	1263	1206	51.1543134872418	48.8456865127582
16	Cuenca	125	16125	Minglanilla	2265	1151	1114	50.8167770419426	49.1832229580574
16	Cuenca	126	16126	Mira	1185	605	580	51.0548523206751	48.9451476793249
16	Cuenca	128	16128	Monreal del Llano	83	42	41	50.6024096385542	49.3975903614458
16	Cuenca	129	16129	Montalbanejo	197	91	106	46.1928934010152	53.8071065989848
16	Cuenca	130	16130	Montalbo	754	388	366	51.4588859416446	48.5411140583554
16	Cuenca	131	16131	Monteagudo de las Salinas	134	80	54	59.7014925373134	40.2985074626866
16	Cuenca	132	16132	Mota de Altarejos	61	38	23	62.2950819672131	37.7049180327869
16	Cuenca	133	16133	Mota del Cuervo	5540	2746	2794	49.5667870036101	50.4332129963899
16	Cuenca	134	16134	Motilla del Palancar	5169	2616	2553	50.6094022054556	49.3905977945444
16	Cuenca	135	16135	Moya	317	172	145	54.2586750788644	45.7413249211356
16	Cuenca	137	16137	Narboneta	120	56	64	46.6666666666667	53.3333333333333
16	Cuenca	139	16139	Olivares de Júcar	561	292	269	52.0499108734403	47.9500891265597
16	Cuenca	140	16140	Olmeda de la Cuesta	49	26	23	53.0612244897959	46.9387755102041
16	Cuenca	141	16141	Olmeda del Rey	248	119	129	47.9838709677419	52.0161290322581
16	Cuenca	142	16142	Olmedilla de Alarcón	179	93	86	51.9553072625698	48.0446927374302
16	Cuenca	143	16143	Olmedilla de Eliz	31	17	14	54.8387096774194	45.1612903225806
16	Cuenca	145	16145	Osa de la Vega	643	317	326	49.3001555209953	50.6998444790047
16	Cuenca	146	16146	Pajarón	140	73	67	52.1428571428571	47.8571428571429
16	Cuenca	147	16147	Pajaroncillo	97	49	48	50.5154639175258	49.4845360824742
16	Cuenca	148	16148	Palomares del Campo	1007	493	514	48.9572989076465	51.0427010923535
16	Cuenca	149	16149	Palomera	165	77	88	46.6666666666667	53.3333333333333
16	Cuenca	150	16150	Paracuellos	155	70	85	45.1612903225806	54.8387096774194
16	Cuenca	151	16151	Paredes	78	39	39	50	50
16	Cuenca	152	16152	Parra de las Vegas (La)	62	34	28	54.8387096774194	45.1612903225806
16	Cuenca	153	16153	Pedernoso (El)	1321	660	661	49.9621498864497	50.0378501135503
16	Cuenca	154	16154	Pedroñeras (Las)	6460	3303	3157	51.1300309597523	48.8699690402477
16	Cuenca	155	16155	Peral (El)	730	369	361	50.5479452054795	49.4520547945205
16	Cuenca	156	16156	Peraleja (La)	171	83	88	48.5380116959064	51.4619883040936
16	Cuenca	157	16157	Pesquera (La)	282	146	136	51.7730496453901	48.2269503546099
16	Cuenca	158	16158	Picazo (El)	709	346	363	48.8011283497884	51.1988716502116
16	Cuenca	159	16159	Pinarejo	409	206	203	50.3667481662592	49.6332518337408
16	Cuenca	160	16160	Pineda de Gigüela	150	81	69	54	46
16	Cuenca	161	16161	Piqueras del Castillo	81	46	35	56.7901234567901	43.2098765432099
16	Cuenca	162	16162	Portalrubio de Guadamejud	90	43	47	47.7777777777778	52.2222222222222
16	Cuenca	163	16163	Portilla	93	46	47	49.4623655913979	50.5376344086022
16	Cuenca	165	16165	Poyatos	115	65	50	56.5217391304348	43.4782608695652
16	Cuenca	166	16166	Pozoamargo	328	155	173	47.2560975609756	52.7439024390244
16	Cuenca	167	16167	Pozorrubio	501	238	263	47.5049900199601	52.4950099800399
16	Cuenca	169	16169	Pozuelo (El)	88	46	42	52.2727272727273	47.7272727272727
16	Cuenca	170	16170	Priego	1035	524	511	50.6280193236715	49.3719806763285
16	Cuenca	171	16171	Provencio (El)	2555	1276	1279	49.9412915851272	50.0587084148728
16	Cuenca	172	16172	Puebla de Almenara	550	284	266	51.6363636363636	48.3636363636364
16	Cuenca	173	16173	Puebla de Don Francisco	369	182	187	49.3224932249323	50.6775067750677
16	Cuenca	174	16174	Puebla del Salvador	286	153	133	53.4965034965035	46.5034965034965
16	Cuenca	175	16175	Quintanar del Rey	6175	3150	3025	51.0121457489879	48.9878542510122
16	Cuenca	176	16176	Rada de Haro	62	30	32	48.3870967741936	51.6129032258065
16	Cuenca	177	16177	Reíllo	144	72	72	50	50
16	Cuenca	181	16181	Rozalén del Monte	120	52	68	43.3333333333333	56.6666666666667
16	Cuenca	185	16185	Saceda-Trasierra	98	53	45	54.0816326530612	45.9183673469388
16	Cuenca	186	16186	Saelices	672	341	331	50.7440476190476	49.2559523809524
16	Cuenca	187	16187	Salinas del Manzano	118	67	51	56.7796610169492	43.2203389830509
16	Cuenca	188	16188	Salmeroncillos	184	90	94	48.9130434782609	51.0869565217391
16	Cuenca	189	16189	Salvacañete	336	184	152	54.7619047619048	45.2380952380952
16	Cuenca	190	16190	San Clemente	6368	3165	3203	49.7016331658291	50.2983668341709
16	Cuenca	191	16191	San Lorenzo de la Parrilla	1438	720	718	50.0695410292072	49.9304589707928
16	Cuenca	192	16192	San Martín de Boniches	99	49	50	49.4949494949495	50.5050505050505
16	Cuenca	193	16193	San Pedro Palmiches	96	49	47	51.0416666666667	48.9583333333333
16	Cuenca	194	16194	Santa Cruz de Moya	416	211	205	50.7211538461539	49.2788461538462
16	Cuenca	195	16195	Santa María del Campo Rus	764	383	381	50.130890052356	49.869109947644
16	Cuenca	196	16196	Santa María de los Llanos	845	434	411	51.3609467455621	48.6390532544379
16	Cuenca	197	16197	Santa María del Val	122	68	54	55.7377049180328	44.2622950819672
16	Cuenca	198	16198	Sisante	1799	899	900	49.9722067815453	50.0277932184547
16	Cuenca	199	16199	Solera de Gabaldón	53	26	27	49.0566037735849	50.9433962264151
16	Cuenca	202	16202	Talayuelas	1181	613	568	51.9051651143099	48.0948348856901
16	Cuenca	203	16203	Tarancón	11490	5672	5818	49.3646649260226	50.6353350739774
16	Cuenca	204	16204	Tébar	403	214	189	53.1017369727047	46.8982630272953
16	Cuenca	205	16205	Tejadillos	165	84	81	50.9090909090909	49.0909090909091
16	Cuenca	206	16206	Tinajas	365	195	170	53.4246575342466	46.5753424657534
16	Cuenca	209	16209	Torralba	187	96	91	51.3368983957219	48.6631016042781
16	Cuenca	211	16211	Torrejoncillo del Rey	695	327	368	47.0503597122302	52.9496402877698
16	Cuenca	212	16212	Torrubia del Campo	357	171	186	47.8991596638655	52.1008403361345
16	Cuenca	213	16213	Torrubia del Castillo	41	21	20	51.219512195122	48.7804878048781
16	Cuenca	215	16215	Tragacete	364	199	165	54.6703296703297	45.3296703296703
16	Cuenca	216	16216	Tresjuncos	498	254	244	51.004016064257	48.995983935743
16	Cuenca	217	16217	Tribaldos	144	63	81	43.75	56.25
16	Cuenca	218	16218	Uclés	313	148	165	47.2843450479233	52.7156549520767
16	Cuenca	219	16219	Uña	141	73	68	51.7730496453901	48.2269503546099
16	Cuenca	224	16224	Valdemeca	109	57	52	52.2935779816514	47.7064220183486
16	Cuenca	225	16225	Valdemorillo de la Sierra	99	54	45	54.5454545454545	45.4545454545455
16	Cuenca	227	16227	Valdemoro-Sierra	202	110	92	54.4554455445545	45.5445544554456
16	Cuenca	228	16228	Valdeolivas	289	153	136	52.9411764705882	47.0588235294118
16	Cuenca	231	16231	Valhermoso de la Fuente	58	28	30	48.2758620689655	51.7241379310345
16	Cuenca	234	16234	Valsalobre	64	32	32	50	50
16	Cuenca	236	16236	Valverde de Júcar	1407	702	705	49.8933901918977	50.1066098081023
16	Cuenca	237	16237	Valverdejo	153	78	75	50.9803921568627	49.0196078431373
16	Cuenca	238	16238	Vara de Rey	686	343	343	50	50
16	Cuenca	239	16239	Vega del Codorno	229	119	110	51.9650655021834	48.0349344978166
16	Cuenca	240	16240	Vellisca	178	88	90	49.438202247191	50.561797752809
16	Cuenca	242	16242	Villaconejos de Trabaque	513	263	250	51.2670565302144	48.7329434697856
16	Cuenca	243	16243	Villaescusa de Haro	595	295	300	49.5798319327731	50.4201680672269
16	Cuenca	244	16244	Villagarcía del Llano	967	479	488	49.5346432264736	50.4653567735264
16	Cuenca	245	16245	Villalba de la Sierra	547	286	261	52.2851919561243	47.7148080438757
16	Cuenca	246	16246	Villalba del Rey	698	353	345	50.5730659025788	49.4269340974212
16	Cuenca	247	16247	Villalgordo del Marquesado	126	62	64	49.2063492063492	50.7936507936508
16	Cuenca	248	16248	Villalpardo	1120	578	542	51.6071428571429	48.3928571428571
16	Cuenca	249	16249	Villamayor de Santiago	2716	1344	1372	49.4845360824742	50.5154639175258
16	Cuenca	250	16250	Villanueva de Guadamejud	125	60	65	48	52
16	Cuenca	251	16251	Villanueva de la Jara	2483	1256	1227	50.5839710028192	49.4160289971808
16	Cuenca	253	16253	Villar de Cañas	446	215	231	48.2062780269058	51.7937219730942
16	Cuenca	254	16254	Villar de Domingo García	288	145	143	50.3472222222222	49.6527777777778
16	Cuenca	255	16255	Villar de la Encina	237	117	120	49.3670886075949	50.6329113924051
16	Cuenca	258	16258	Villar del Humo	466	247	219	53.0042918454936	46.9957081545064
16	Cuenca	259	16259	Villar del Infantado	44	25	19	56.8181818181818	43.1818181818182
16	Cuenca	263	16263	Villar de Olalla	920	471	449	51.195652173913	48.804347826087
16	Cuenca	264	16264	Villarejo de Fuentes	809	384	425	47.4660074165637	52.5339925834363
16	Cuenca	265	16265	Villarejo de la Peñuela	32	15	17	46.875	53.125
16	Cuenca	266	16266	Villarejo-Periesteban	545	275	270	50.4587155963303	49.5412844036697
16	Cuenca	269	16269	Villares del Saz	698	354	344	50.7163323782235	49.2836676217765
16	Cuenca	270	16270	Villarrubio	256	134	122	52.34375	47.65625
16	Cuenca	271	16271	Villarta	818	428	390	52.3227383863081	47.6772616136919
16	Cuenca	272	16272	Villas de la Ventosa	374	201	173	53.7433155080214	46.2566844919786
16	Cuenca	273	16273	Villaverde y Pasaconsol	434	209	225	48.1566820276498	51.8433179723502
16	Cuenca	274	16274	Víllora	238	119	119	50	50
16	Cuenca	275	16275	Vindel	20	13	7	65	35
16	Cuenca	276	16276	Yémeda	32	14	18	43.75	56.25
16	Cuenca	277	16277	Zafra de Záncara	201	103	98	51.2437810945274	48.7562189054726
16	Cuenca	278	16278	Zafrilla	132	60	72	45.4545454545455	54.5454545454545
16	Cuenca	279	16279	Zarza de Tajo	270	126	144	46.6666666666667	53.3333333333333
16	Cuenca	280	16280	Zarzuela	295	148	147	50.1694915254237	49.8305084745763
16	Cuenca	901	16901	Campos del Paraíso	1107	518	589	46.7931345980127	53.2068654019874
16	Cuenca	902	16902	Valdetórtola	141	79	62	56.0283687943262	43.9716312056738
16	Cuenca	903	16903	Valeras (Las)	1352	668	684	49.4082840236686	50.5917159763314
16	Cuenca	904	16904	Fuentenava de Jábaga	390	197	193	50.5128205128205	49.4871794871795
16	Cuenca	905	16905	Arcas del Villar	681	347	334	50.9544787077827	49.0455212922173
16	Cuenca	906	16906	Valdecolmenas (Los)	121	66	55	54.5454545454545	45.4545454545455
16	Cuenca	908	16908	Pozorrubielos de la Mancha	301	152	149	50.4983388704319	49.5016611295681
16	Cuenca	909	16909	Sotorribas	1021	506	515	49.5592556317336	50.4407443682664
16	Cuenca	910	16910	Villar y Velasco	123	68	55	55.2845528455285	44.7154471544715
17	Girona	001	17001	Agullana	655	332	323	50.6870229007634	49.3129770992366
17	Girona	002	17002	Aiguaviva	515	261	254	50.6796116504854	49.3203883495146
17	Girona	003	17003	Albanyà	128	68	60	53.125	46.875
17	Girona	004	17004	Albons	572	300	272	52.4475524475525	47.5524475524476
17	Girona	005	17005	Far d'Empordà (El)	387	202	185	52.1963824289406	47.8036175710594
17	Girona	006	17006	Alp	1194	620	574	51.9262981574539	48.0737018425461
17	Girona	007	17007	Amer	2220	1092	1128	49.1891891891892	50.8108108108108
17	Girona	008	17008	Anglès	5009	2527	2482	50.4491914553803	49.5508085446197
17	Girona	009	17009	Arbúcies	5026	2543	2483	50.5968961400716	49.4031038599284
17	Girona	010	17010	Argelaguer	379	206	173	54.3535620052771	45.646437994723
17	Girona	011	17011	Armentera (L')	756	375	381	49.6031746031746	50.3968253968254
17	Girona	012	17012	Avinyonet de Puigventós	618	315	303	50.9708737864078	49.0291262135922
17	Girona	013	17013	Begur	3411	1729	1682	50.6889475227206	49.3110524772794
17	Girona	014	17014	Vajol (La)	96	50	46	52.0833333333333	47.9166666666667
17	Girona	015	17015	Banyoles	15084	7410	7674	49.1249005568815	50.8750994431185
17	Girona	016	17016	Bàscara	822	422	400	51.338199513382	48.661800486618
17	Girona	018	17018	Bellcaire d'Empordà	535	274	261	51.2149532710281	48.785046728972
17	Girona	019	17019	Besalú	1996	971	1025	48.6472945891784	51.3527054108216
17	Girona	020	17020	Bescanó	3187	1603	1584	50.2980859742705	49.7019140257295
17	Girona	021	17021	Beuda	133	73	60	54.8872180451128	45.1127819548872
17	Girona	022	17022	Bisbal d'Empordà (La)	8264	4070	4194	49.2497579864472	50.7502420135528
17	Girona	023	17023	Blanes	30441	15272	15169	50.1691797247134	49.8308202752866
17	Girona	024	17024	Bolvir	284	144	140	50.7042253521127	49.2957746478873
17	Girona	025	17025	Bordils	1383	697	686	50.3976861894432	49.6023138105568
17	Girona	026	17026	Borrassà	533	268	265	50.281425891182	49.718574108818
17	Girona	027	17027	Breda	3345	1717	1628	51.3303437967115	48.6696562032885
17	Girona	028	17028	Brunyola	383	195	188	50.9138381201044	49.0861618798956
17	Girona	029	17029	Boadella d'Empordà	219	110	109	50.2283105022831	49.7716894977169
17	Girona	030	17030	Cabanes	798	409	389	51.2531328320802	48.7468671679198
17	Girona	031	17031	Cabanelles	226	129	97	57.0796460176991	42.9203539823009
17	Girona	032	17032	Cadaqués	2301	1117	1184	48.5441112559757	51.4558887440243
17	Girona	033	17033	Caldes de Malavella	4031	2038	1993	50.5581741503349	49.4418258496651
17	Girona	034	17034	Calonge	6783	3398	3385	50.0958278048061	49.9041721951939
17	Girona	035	17035	Camós	637	327	310	51.3343799058085	48.6656200941915
17	Girona	036	17036	Campdevànol	3370	1652	1718	49.0207715133531	50.9792284866469
17	Girona	037	17037	Campelles	125	67	58	53.6	46.4
17	Girona	038	17038	Campllong	307	158	149	51.4657980456026	48.5342019543974
17	Girona	039	17039	Camprodon	2319	1138	1181	49.0728762397585	50.9271237602415
17	Girona	040	17040	Canet d'Adri	519	270	249	52.0231213872832	47.9768786127168
17	Girona	041	17041	Cantallops	267	136	131	50.936329588015	49.063670411985
17	Girona	042	17042	Capmany	409	203	206	49.6332518337408	50.3667481662592
17	Girona	043	17043	Queralbs	201	115	86	57.2139303482587	42.7860696517413
17	Girona	044	17044	Cassà de la Selva	7692	3834	3858	49.8439937597504	50.1560062402496
17	Girona	046	17046	Castellfollit de la Roca	963	478	485	49.6365524402908	50.3634475597093
17	Girona	047	17047	Castelló d'Empúries	6266	3202	3064	51.1011809766996	48.8988190233003
17	Girona	048	17048	Castell-Platja d'Aro	6688	3382	3306	50.5681818181818	49.4318181818182
17	Girona	049	17049	Celrà	2635	1293	1342	49.0702087286528	50.9297912713472
17	Girona	050	17050	Cervià de Ter	607	306	301	50.4118616144975	49.5881383855025
17	Girona	051	17051	Cistella	231	115	116	49.7835497835498	50.2164502164502
17	Girona	052	17052	Siurana	159	80	79	50.314465408805	49.685534591195
17	Girona	054	17054	Colera	592	310	282	52.3648648648649	47.6351351351351
17	Girona	055	17055	Colomers	196	100	96	51.0204081632653	48.9795918367347
17	Girona	056	17056	Cornellà del Terri	1921	963	958	50.1301405517959	49.8698594482041
17	Girona	057	17057	Corçà	1153	574	579	49.7831743278404	50.2168256721596
17	Girona	058	17058	Crespià	205	102	103	49.7560975609756	50.2439024390244
17	Girona	060	17060	Darnius	517	275	242	53.1914893617021	46.8085106382979
17	Girona	061	17061	Das	158	85	73	53.7974683544304	46.2025316455696
17	Girona	062	17062	Escala (L')	6285	3155	3130	50.1988862370724	49.8011137629276
17	Girona	063	17063	Espinelves	179	90	89	50.2793296089386	49.7206703910615
17	Girona	064	17064	Espolla	373	187	186	50.1340482573727	49.8659517426273
17	Girona	065	17065	Esponellà	402	200	202	49.7512437810945	50.2487562189055
17	Girona	066	17066	Figueres	34023	16529	17494	48.5818416953238	51.4181583046763
17	Girona	067	17067	Flaçà	845	417	428	49.3491124260355	50.6508875739645
17	Girona	068	17068	Foixà	322	155	167	48.1366459627329	51.8633540372671
17	Girona	069	17069	Fontanals de Cerdanya	399	197	202	49.3734335839599	50.6265664160401
17	Girona	070	17070	Fontanilles	153	83	70	54.2483660130719	45.7516339869281
17	Girona	071	17071	Fontcoberta	1110	553	557	49.8198198198198	50.1801801801802
17	Girona	073	17073	Fornells de la Selva	1489	723	766	48.556077904634	51.443922095366
17	Girona	074	17074	Fortià	525	259	266	49.3333333333333	50.6666666666667
17	Girona	075	17075	Garrigàs	339	182	157	53.6873156342183	46.3126843657817
17	Girona	076	17076	Garrigoles	150	81	69	54	46
17	Girona	077	17077	Garriguella	726	369	357	50.8264462809917	49.1735537190083
17	Girona	078	17078	Ger	375	200	175	53.3333333333333	46.6666666666667
17	Girona	079	17079	Girona	73637	35415	38222	48.0940288170349	51.9059711829651
17	Girona	080	17080	Gombrèn	235	113	122	48.0851063829787	51.9148936170213
17	Girona	081	17081	Gualta	293	150	143	51.1945392491467	48.8054607508532
17	Girona	082	17082	Guils de Cerdanya	334	164	170	49.1017964071856	50.8982035928144
17	Girona	083	17083	Hostalric	2901	1420	1481	48.9486384005515	51.0513615994485
17	Girona	084	17084	Isòvol	204	113	91	55.3921568627451	44.6078431372549
17	Girona	085	17085	Jafre	317	163	154	51.4195583596215	48.5804416403786
17	Girona	086	17086	Jonquera (La)	2565	1288	1277	50.2144249512671	49.7855750487329
17	Girona	087	17087	Juià	266	123	143	46.2406015037594	53.7593984962406
17	Girona	088	17088	Lladó	502	257	245	51.195219123506	48.804780876494
17	Girona	089	17089	Llagostera	5769	2927	2842	50.7366961345121	49.263303865488
17	Girona	090	17090	Llambilles	472	242	230	51.271186440678	48.728813559322
17	Girona	091	17091	Llanars	489	249	240	50.920245398773	49.079754601227
17	Girona	092	17092	Llançà	4063	2007	2056	49.3969972926409	50.6030027073591
17	Girona	093	17093	Llers	954	484	470	50.7337526205451	49.2662473794549
17	Girona	094	17094	Llívia	1013	535	478	52.8134254689042	47.1865745310958
17	Girona	095	17095	Lloret de Mar	20045	10081	9964	50.291843352457	49.708156647543
17	Girona	096	17096	Llosses (Les)	275	147	128	53.4545454545455	46.5454545454545
17	Girona	097	17097	Madremanya	185	83	102	44.8648648648649	55.1351351351351
17	Girona	098	17098	Maià de Montcal	321	160	161	49.8442367601246	50.1557632398754
17	Girona	099	17099	Meranges	83	49	34	59.0361445783133	40.9638554216867
17	Girona	100	17100	Masarac	245	119	126	48.5714285714286	51.4285714285714
17	Girona	101	17101	Massanes	542	288	254	53.1365313653137	46.8634686346863
17	Girona	102	17102	Maçanet de Cabrenys	664	342	322	51.5060240963855	48.4939759036145
17	Girona	103	17103	Maçanet de la Selva	3814	1953	1861	51.2060828526481	48.7939171473519
17	Girona	105	17105	Mieres	336	163	173	48.5119047619048	51.4880952380952
17	Girona	106	17106	Mollet de Peralada	189	104	85	55.026455026455	44.973544973545
17	Girona	107	17107	Molló	339	174	165	51.3274336283186	48.6725663716814
17	Girona	109	17109	Montagut	792	409	383	51.6414141414141	48.3585858585859
17	Girona	110	17110	Mont-ras	1644	871	773	52.9805352798054	47.0194647201947
17	Girona	111	17111	Navata	708	349	359	49.2937853107345	50.7062146892655
17	Girona	112	17112	Ogassa	242	142	100	58.6776859504132	41.3223140495868
17	Girona	114	17114	Olot	27967	13521	14446	48.3462652411771	51.6537347588229
17	Girona	115	17115	Ordis	285	151	134	52.9824561403509	47.0175438596491
17	Girona	116	17116	Osor	464	250	214	53.8793103448276	46.1206896551724
17	Girona	117	17117	Palafrugell	18154	9126	9028	50.2699129668393	49.7300870331607
17	Girona	118	17118	Palamós	14959	7386	7573	49.3749582191323	50.6250417808677
17	Girona	119	17119	Palau de Santa Eulàlia	90	54	36	60	40
17	Girona	120	17120	Palau-saverdera	931	467	464	50.1611170784103	49.8388829215897
17	Girona	121	17121	Palau-sator	293	152	141	51.8771331058021	48.122866894198
17	Girona	123	17123	Palol de Revardit	386	201	185	52.0725388601036	47.9274611398964
17	Girona	124	17124	Pals	1912	975	937	50.9937238493724	49.0062761506276
17	Girona	125	17125	Pardines	143	72	71	50.3496503496504	49.6503496503497
17	Girona	126	17126	Parlavà	330	171	159	51.8181818181818	48.1818181818182
17	Girona	128	17128	Pau	417	210	207	50.3597122302158	49.6402877697842
17	Girona	129	17129	Pedret i Marzà	127	65	62	51.1811023622047	48.8188976377953
17	Girona	130	17130	Pera (La)	367	187	180	50.9536784741144	49.0463215258856
17	Girona	132	17132	Peralada	1277	651	626	50.9788566953798	49.0211433046202
17	Girona	133	17133	Planes d'Hostoles (Les)	1724	855	869	49.5939675174014	50.4060324825986
17	Girona	134	17134	Planoles	273	142	131	52.014652014652	47.985347985348
17	Girona	135	17135	Pont de Molins	430	230	200	53.4883720930233	46.5116279069767
17	Girona	136	17136	Pontós	217	121	96	55.7603686635945	44.2396313364055
17	Girona	137	17137	Porqueres	3622	1780	1842	49.1441192711209	50.8558807288791
17	Girona	138	17138	Portbou	1511	761	750	50.3639973527465	49.6360026472535
17	Girona	139	17139	Preses (Les)	1373	668	705	48.652585579024	51.347414420976
17	Girona	140	17140	Port de la Selva (El)	877	440	437	50.1710376282782	49.8289623717218
17	Girona	141	17141	Puigcerdà	6902	3529	3373	51.1301072152999	48.8698927847001
17	Girona	142	17142	Quart	2402	1231	1171	51.2489592006661	48.7510407993339
17	Girona	143	17143	Rabós	145	69	76	47.5862068965517	52.4137931034483
17	Girona	144	17144	Regencós	287	166	121	57.8397212543554	42.1602787456446
17	Girona	145	17145	Ribes de Freser	2096	1017	1079	48.5209923664122	51.4790076335878
17	Girona	146	17146	Riells i Viabrea	2043	1073	970	52.5208027410671	47.4791972589329
17	Girona	147	17147	Ripoll	10733	5180	5553	48.2623683965341	51.737631603466
17	Girona	148	17148	Riudarenes	1302	678	624	52.073732718894	47.926267281106
17	Girona	149	17149	Riudaura	417	210	207	50.3597122302158	49.6402877697842
17	Girona	150	17150	Riudellots de la Selva	1548	796	752	51.421188630491	48.5788113695091
17	Girona	151	17151	Riumors	192	95	97	49.4791666666667	50.5208333333333
17	Girona	152	17152	Roses	12857	6502	6355	50.5716730185891	49.4283269814109
17	Girona	153	17153	Rupià	190	101	89	53.1578947368421	46.8421052631579
17	Girona	154	17154	Sales de Llierca	89	49	40	55.0561797752809	44.9438202247191
17	Girona	155	17155	Salt	22017	10935	11082	49.666167052732	50.333832947268
17	Girona	157	17157	Sant Andreu Salou	138	65	73	47.1014492753623	52.8985507246377
17	Girona	158	17158	Sant Climent Sescebes	404	204	200	50.4950495049505	49.5049504950495
17	Girona	159	17159	Sant Feliu de Buixalleu	727	387	340	53.232462173315	46.767537826685
17	Girona	160	17160	Sant Feliu de Guíxols	18403	9031	9372	49.0735206216378	50.9264793783622
17	Girona	161	17161	Sant Feliu de Pallerols	1155	564	591	48.8311688311688	51.1688311688312
17	Girona	162	17162	Sant Ferriol	196	110	86	56.1224489795918	43.8775510204082
17	Girona	163	17163	Sant Gregori	2335	1213	1122	51.948608137045	48.051391862955
17	Girona	164	17164	Sant Hilari Sacalm	4985	2543	2442	51.0130391173521	48.9869608826479
17	Girona	165	17165	Sant Jaume de Llierca	714	352	362	49.2997198879552	50.7002801120448
17	Girona	166	17166	Sant Jordi Desvalls	587	302	285	51.4480408858603	48.5519591141397
17	Girona	167	17167	Sant Joan de les Abadesses	3672	1810	1862	49.2919389978214	50.7080610021787
17	Girona	168	17168	Sant Joan de Mollet	354	171	183	48.3050847457627	51.6949152542373
17	Girona	169	17169	Sant Julià de Ramis	2018	1016	1002	50.3468780971259	49.6531219028741
17	Girona	170	17170	Vallfogona de Ripollès	219	114	105	52.0547945205479	47.9452054794521
17	Girona	171	17171	Sant Llorenç de la Muga	182	86	96	47.2527472527472	52.7472527472528
17	Girona	172	17172	Sant Martí de Llémena	478	245	233	51.255230125523	48.744769874477
17	Girona	173	17173	Sant Martí Vell	161	82	79	50.9316770186335	49.0683229813665
17	Girona	174	17174	Sant Miquel de Campmajor	206	116	90	56.3106796116505	43.6893203883495
17	Girona	175	17175	Sant Miquel de Fluvià	625	318	307	50.88	49.12
17	Girona	176	17176	Sant Mori	158	75	83	47.4683544303798	52.5316455696203
17	Girona	177	17177	Sant Pau de Segúries	655	333	322	50.8396946564886	49.1603053435115
17	Girona	178	17178	Sant Pere Pescador	1428	788	640	55.1820728291317	44.8179271708684
17	Girona	180	17180	Santa Coloma de Farners	8867	4510	4357	50.8627495206947	49.1372504793053
17	Girona	181	17181	Santa Cristina d'Aro	2902	1518	1384	52.3087525844245	47.6912474155755
17	Girona	182	17182	Santa Llogaia d'Àlguema	300	157	143	52.3333333333333	47.6666666666667
17	Girona	183	17183	Sant Aniol de Finestres	270	148	122	54.8148148148148	45.1851851851852
17	Girona	184	17184	Santa Pau	1484	755	729	50.8760107816712	49.1239892183288
17	Girona	185	17185	Sant Joan les Fonts	2756	1364	1392	49.4920174165457	50.5079825834543
17	Girona	186	17186	Sarrià de Ter	3457	1711	1746	49.4937807347411	50.5062192652589
17	Girona	187	17187	Saus	688	340	348	49.4186046511628	50.5813953488372
17	Girona	188	17188	Selva de Mar (La)	190	96	94	50.5263157894737	49.4736842105263
17	Girona	189	17189	Cellera de Ter (La)	2019	1002	1017	49.62852897474	50.37147102526
17	Girona	190	17190	Serinyà	837	436	401	52.0908004778972	47.9091995221028
17	Girona	191	17191	Serra de Daró	186	95	91	51.0752688172043	48.9247311827957
17	Girona	192	17192	Setcases	163	87	76	53.3742331288344	46.6257668711656
17	Girona	193	17193	Sils	3078	1558	1520	50.6172839506173	49.3827160493827
17	Girona	194	17194	Susqueda	87	49	38	56.3218390804598	43.6781609195402
17	Girona	195	17195	Tallada d'Empordà (La)	332	173	159	52.1084337349398	47.8915662650602
17	Girona	196	17196	Terrades	200	95	105	47.5	52.5
17	Girona	197	17197	Torrent	172	84	88	48.8372093023256	51.1627906976744
17	Girona	198	17198	Torroella de Fluvià	319	180	139	56.4263322884012	43.5736677115987
17	Girona	199	17199	Torroella de Montgrí	8454	4281	4173	50.638750887154	49.361249112846
17	Girona	200	17200	Tortellà	717	363	354	50.6276150627615	49.3723849372385
17	Girona	201	17201	Toses	151	87	64	57.6158940397351	42.3841059602649
17	Girona	202	17202	Tossa de Mar	4195	2083	2112	49.6543504171633	50.3456495828367
17	Girona	203	17203	Ultramort	203	114	89	56.1576354679803	43.8423645320197
17	Girona	204	17204	Ullà	814	425	389	52.2113022113022	47.7886977886978
17	Girona	205	17205	Ullastret	234	122	112	52.1367521367522	47.8632478632479
17	Girona	206	17206	Urús	188	101	87	53.7234042553192	46.2765957446809
17	Girona	207	17207	Vall d'en Bas (La)	2552	1311	1241	51.371473354232	48.628526645768
17	Girona	208	17208	Vall de Bianya (La)	1130	569	561	50.353982300885	49.646017699115
17	Girona	209	17209	Vall-llobrega	377	141	236	37.4005305039788	62.5994694960212
17	Girona	210	17210	Ventalló	608	317	291	52.1381578947369	47.8618421052632
17	Girona	211	17211	Verges	1134	566	568	49.9118165784832	50.0881834215168
17	Girona	212	17212	Vidrà	158	78	80	49.3670886075949	50.6329113924051
17	Girona	213	17213	Vidreres	4740	2405	2335	50.7383966244726	49.2616033755274
17	Girona	214	17214	Vilabertran	784	397	387	50.6377551020408	49.3622448979592
17	Girona	215	17215	Vilablareix	1842	916	926	49.728555917481	50.271444082519
17	Girona	216	17216	Viladasens	185	96	89	51.8918918918919	48.1081081081081
17	Girona	217	17217	Viladamat	417	221	196	52.9976019184652	47.0023980815348
17	Girona	218	17218	Vilademuls	720	365	355	50.6944444444444	49.3055555555556
17	Girona	220	17220	Viladrau	856	426	430	49.7663551401869	50.2336448598131
17	Girona	221	17221	Vilafant	4100	2047	2053	49.9268292682927	50.0731707317073
17	Girona	222	17222	Vilaür	125	72	53	57.6	42.4
17	Girona	223	17223	Vilajuïga	953	474	479	49.7376705141658	50.2623294858342
17	Girona	224	17224	Vilallonga de Ter	421	232	189	55.1068883610451	44.8931116389549
17	Girona	225	17225	Vilamacolum	261	138	123	52.8735632183908	47.1264367816092
17	Girona	226	17226	Vilamalla	761	408	353	53.6136662286465	46.3863337713535
17	Girona	227	17227	Vilamaniscle	120	65	55	54.1666666666667	45.8333333333333
17	Girona	228	17228	Vilanant	308	155	153	50.3246753246753	49.6753246753247
17	Girona	230	17230	Vila-sacra	383	190	193	49.6083550913838	50.3916449086162
17	Girona	232	17232	Vilopriu	161	83	78	51.5527950310559	48.4472049689441
17	Girona	233	17233	Vilobí d'Onyar	2223	1170	1053	52.6315789473684	47.3684210526316
17	Girona	234	17234	Biure	217	107	110	49.3087557603687	50.6912442396313
17	Girona	901	17901	Cruïlles. Monells i Sant Sadurní de l'Heura	1096	543	553	49.543795620438	50.456204379562
17	Girona	902	17902	Forallac	1650	809	841	49.030303030303	50.969696969697
17	Girona	903	17903	Sant Julià del Llor i Bonmatí	921	467	454	50.7057546145494	49.2942453854506
18	Granada	001	18001	Agrón	392	202	190	51.530612244898	48.469387755102
18	Granada	002	18002	Alamedilla	898	455	443	50.6681514476615	49.3318485523385
18	Granada	003	18003	Albolote	13048	6546	6502	50.1686082158185	49.8313917841815
18	Granada	004	18004	Albondón	996	495	501	49.6987951807229	50.3012048192771
18	Granada	005	18005	Albuñán	474	237	237	50	50
18	Granada	006	18006	Albuñol	5462	2733	2729	50.0366166239473	49.9633833760527
18	Granada	007	18007	Albuñuelas	1215	632	583	52.0164609053498	47.9835390946502
18	Granada	010	18010	Aldeire	785	398	387	50.7006369426752	49.2993630573248
18	Granada	011	18011	Alfacar	4300	2179	2121	50.6744186046512	49.3255813953488
18	Granada	012	18012	Algarinejo	5269	2701	2568	51.2620990700323	48.7379009299677
18	Granada	013	18013	Alhama de Granada	5927	2986	2941	50.3796186941117	49.6203813058883
18	Granada	014	18014	Alhendín	4224	2141	2083	50.686553030303	49.313446969697
18	Granada	015	18015	Alicún de Ortega	672	356	316	52.9761904761905	47.0238095238095
18	Granada	016	18016	Almegíjar	427	219	208	51.288056206089	48.711943793911
18	Granada	017	18017	Almuñécar	21275	10498	10777	49.3443008225617	50.6556991774383
18	Granada	018	18018	Alquife	897	451	446	50.2787068004459	49.7212931995541
18	Granada	020	18020	Arenas del Rey	1979	1033	946	52.1980798383022	47.8019201616978
18	Granada	021	18021	Armilla	14030	6927	7103	49.3727726300784	50.6272273699216
18	Granada	022	18022	Atarfe	10975	5430	5545	49.4760820045558	50.5239179954442
18	Granada	023	18023	Baza	20818	10261	10557	49.2890767604957	50.7109232395043
18	Granada	024	18024	Beas de Granada	968	505	463	52.1694214876033	47.8305785123967
18	Granada	025	18025	Beas de Guadix	375	195	180	52	48
18	Granada	027	18027	Benalúa	3241	1627	1614	50.2005553841407	49.7994446158593
18	Granada	028	18028	Benalúa de las Villas	1450	721	729	49.7241379310345	50.2758620689655
18	Granada	029	18029	Benamaurel	2410	1227	1183	50.9128630705394	49.0871369294606
18	Granada	030	18030	Bérchules	789	417	372	52.851711026616	47.148288973384
18	Granada	032	18032	Bubión	378	186	192	49.2063492063492	50.7936507936508
18	Granada	033	18033	Busquístar	363	196	167	53.9944903581267	46.0055096418733
18	Granada	034	18034	Cacín	796	399	397	50.1256281407035	49.8743718592965
18	Granada	035	18035	Cádiar	1588	820	768	51.6372795969773	48.3627204030227
18	Granada	036	18036	Cájar	3239	1545	1694	47.6999073788206	52.3000926211794
18	Granada	037	18037	Calicasas	586	294	292	50.1706484641638	49.8293515358362
18	Granada	038	18038	Campotéjar	1444	738	706	51.1080332409972	48.8919667590028
18	Granada	039	18039	Caniles	4886	2404	2482	49.2018010642653	50.7981989357348
18	Granada	040	18040	Cáñar	340	162	178	47.6470588235294	52.3529411764706
18	Granada	042	18042	Capileira	524	252	272	48.0916030534351	51.9083969465649
18	Granada	043	18043	Carataunas	196	101	95	51.530612244898	48.469387755102
18	Granada	044	18044	Cástaras	291	153	138	52.5773195876289	47.4226804123711
18	Granada	045	18045	Castilléjar	1760	855	905	48.5795454545455	51.4204545454545
18	Granada	046	18046	Castril	2883	1470	1413	50.9885535900104	49.0114464099896
18	Granada	047	18047	Cenes de la Vega	5193	2647	2546	50.9724629308685	49.0275370691315
18	Granada	048	18048	Cijuela	1537	762	775	49.5770982433312	50.4229017566688
18	Granada	049	18049	Cogollos de Guadix	746	388	358	52.0107238605898	47.9892761394102
18	Granada	050	18050	Cogollos de la Vega	1972	1006	966	51.0141987829615	48.9858012170385
18	Granada	051	18051	Colomera	1610	819	791	50.8695652173913	49.1304347826087
18	Granada	053	18053	Cortes de Baza	2717	1375	1342	50.6072874493927	49.3927125506073
18	Granada	054	18054	Cortes y Graena	1073	554	519	51.6309412861137	48.3690587138863
18	Granada	056	18056	Cúllar	4836	2403	2433	49.6898263027295	50.3101736972705
18	Granada	057	18057	Cúllar Vega	3499	1754	1745	50.1286081737639	49.8713918262361
18	Granada	059	18059	Chauchina	4124	2032	2092	49.2725509214355	50.7274490785645
18	Granada	061	18061	Chimeneas	1518	772	746	50.8563899868248	49.1436100131752
18	Granada	062	18062	Churriana de la Vega	7056	3478	3578	49.2913832199547	50.7086167800454
18	Granada	063	18063	Darro	1488	739	749	49.6639784946237	50.3360215053764
18	Granada	064	18064	Dehesas de Guadix	641	321	320	50.0780031201248	49.9219968798752
18	Granada	066	18066	Deifontes	2369	1181	1188	49.852258336851	50.147741663149
18	Granada	067	18067	Diezma	907	476	431	52.4807056229327	47.5192943770673
18	Granada	068	18068	Dílar	1474	732	742	49.6607869742198	50.3392130257802
18	Granada	069	18069	Dólar	613	298	315	48.6133768352365	51.3866231647635
18	Granada	070	18070	Dúdar	272	137	135	50.3676470588235	49.6323529411765
18	Granada	071	18071	Dúrcal	5571	2736	2835	49.1114701130856	50.8885298869144
18	Granada	072	18072	Escúzar	828	419	409	50.6038647342995	49.3961352657005
18	Granada	074	18074	Ferreira	361	176	185	48.7534626038781	51.2465373961219
18	Granada	076	18076	Fonelas	1187	589	598	49.6208930075821	50.3791069924179
18	Granada	078	18078	Freila	962	485	477	50.4158004158004	49.5841995841996
18	Granada	079	18079	Fuente Vaqueros	3960	1952	2008	49.2929292929293	50.7070707070707
18	Granada	082	18082	Galera	1309	652	657	49.8090145148969	50.1909854851031
18	Granada	083	18083	Gobernador	356	174	182	48.876404494382	51.123595505618
18	Granada	084	18084	Gójar	3584	1851	1733	51.6462053571429	48.3537946428571
18	Granada	085	18085	Gor	1158	582	576	50.259067357513	49.740932642487
18	Granada	086	18086	Gorafe	557	269	288	48.294434470377	51.705565529623
18	Granada	087	18087	Granada	244486	113780	130706	46.5384520995067	53.4615479004933
18	Granada	088	18088	Guadahortuna	2262	1167	1095	51.5915119363395	48.4084880636605
18	Granada	089	18089	Guadix	19542	9606	9936	49.1556647221369	50.8443352778631
18	Granada	093	18093	Gualchos	2970	1497	1473	50.4040404040404	49.5959595959596
18	Granada	094	18094	Güejar Sierra	2702	1385	1317	51.2583271650629	48.7416728349371
18	Granada	095	18095	Güevéjar	1549	779	770	50.2905100064558	49.7094899935442
18	Granada	096	18096	Huélago	561	292	269	52.0499108734403	47.9500891265597
18	Granada	097	18097	Huéneja	1220	606	614	49.672131147541	50.327868852459
18	Granada	098	18098	Huéscar	8065	3981	4084	49.3614383137012	50.6385616862988
18	Granada	099	18099	Huétor de Santillán	1645	852	793	51.7933130699088	48.2066869300912
18	Granada	100	18100	Huétor Tájar	8206	4077	4129	49.6831586643919	50.3168413356081
18	Granada	101	18101	Huétor Vega	8870	4469	4401	50.3833145434047	49.6166854565953
18	Granada	102	18102	Illora	10495	5270	5225	50.2143878037161	49.7856121962839
18	Granada	103	18103	Itrabo	1021	496	525	48.5798237022527	51.4201762977473
18	Granada	105	18105	Iznalloz	6964	3505	3459	50.3302699597932	49.6697300402068
18	Granada	107	18107	Jayena	1342	676	666	50.3725782414307	49.6274217585693
18	Granada	108	18108	Jerez del Marquesado	1106	551	555	49.8191681735986	50.1808318264015
18	Granada	109	18109	Jete	765	361	404	47.1895424836601	52.8104575163399
18	Granada	111	18111	Jun	1779	903	876	50.7588532883643	49.2411467116358
18	Granada	112	18112	Juviles	177	90	87	50.8474576271186	49.1525423728814
18	Granada	114	18114	Calahorra (La)	888	436	452	49.0990990990991	50.9009009009009
18	Granada	115	18115	Láchar	2426	1221	1205	50.3297609233306	49.6702390766694
18	Granada	116	18116	Lanjarón	3802	1868	1934	49.132035770647	50.867964229353
18	Granada	117	18117	Lanteira	599	303	296	50.5843071786311	49.4156928213689
18	Granada	119	18119	Lecrín	2293	1132	1161	49.3676406454427	50.6323593545574
18	Granada	120	18120	Lentegí	343	162	181	47.2303206997085	52.7696793002916
18	Granada	121	18121	Lobras	173	85	88	49.1329479768786	50.8670520231214
18	Granada	122	18122	Loja	19701	9777	9924	49.6269224912441	50.3730775087559
18	Granada	123	18123	Lugros	406	201	205	49.5073891625616	50.4926108374384
18	Granada	124	18124	Lújar	535	284	251	53.0841121495327	46.9158878504673
18	Granada	126	18126	Malahá (La)	1658	836	822	50.4221954161641	49.577804583836
18	Granada	127	18127	Maracena	14651	7275	7376	49.6553136304689	50.3446863695311
18	Granada	128	18128	Marchal	405	190	215	46.9135802469136	53.0864197530864
18	Granada	132	18132	Moclín	4436	2178	2258	49.0982867448152	50.9017132551849
18	Granada	133	18133	Molvízar	2722	1335	1387	49.0448199853049	50.9551800146951
18	Granada	134	18134	Monachil	5199	2653	2546	51.0290440469321	48.9709559530679
18	Granada	135	18135	Montefrío	6794	3400	3394	50.0441566087724	49.9558433912276
18	Granada	136	18136	Montejícar	2825	1421	1404	50.3008849557522	49.6991150442478
18	Granada	137	18137	Montillana	1378	692	686	50.2177068214804	49.7822931785196
18	Granada	138	18138	Moraleda de Zafayona	2736	1402	1334	51.2426900584795	48.7573099415205
18	Granada	140	18140	Motril	50172	24742	25430	49.314358606394	50.685641393606
18	Granada	141	18141	Murtas	797	412	385	51.693851944793	48.306148055207
18	Granada	143	18143	Nigüelas	1100	557	543	50.6363636363636	49.3636363636364
18	Granada	144	18144	Nívar	663	337	326	50.8295625942685	49.1704374057315
18	Granada	145	18145	Ogíjares	8798	4452	4346	50.6024096385542	49.3975903614458
18	Granada	146	18146	Orce	1440	713	727	49.5138888888889	50.4861111111111
18	Granada	147	18147	Órgiva	5035	2512	2523	49.8907646474677	50.1092353525323
18	Granada	148	18148	Otívar	1043	524	519	50.2396931927133	49.7603068072867
18	Granada	149	18149	Otura	4306	2150	2156	49.9303297724106	50.0696702275894
18	Granada	150	18150	Padul	6766	3380	3386	49.9556606562223	50.0443393437777
18	Granada	151	18151	Pampaneira	345	176	169	51.0144927536232	48.9855072463768
18	Granada	152	18152	Pedro Martínez	1373	683	690	49.7450837581937	50.2549162418063
18	Granada	153	18153	Peligros	7401	3700	3701	49.9932441561951	50.0067558438049
18	Granada	154	18154	Peza (La)	1433	753	680	52.5471039776692	47.4528960223308
18	Granada	157	18157	Pinos Genil	1181	611	570	51.735817104149	48.264182895851
18	Granada	158	18158	Pinos Puente	13368	6759	6609	50.5610412926391	49.4389587073609
18	Granada	159	18159	Píñar	1329	690	639	51.9187358916479	48.0812641083521
18	Granada	161	18161	Polícar	296	157	139	53.0405405405405	46.9594594594595
18	Granada	162	18162	Polopos	1225	628	597	51.265306122449	48.734693877551
18	Granada	163	18163	Pórtugos	451	218	233	48.3370288248337	51.6629711751663
18	Granada	164	18164	Puebla de Don Fadrique	2478	1233	1245	49.7578692493947	50.2421307506053
18	Granada	165	18165	Pulianas	3973	2042	1931	51.39692927259	48.60307072741
18	Granada	167	18167	Purullena	2427	1190	1237	49.0317264112073	50.9682735887928
18	Granada	168	18168	Quéntar	1086	543	543	50	50
18	Granada	170	18170	Rubite	389	204	185	52.4421593830334	47.5578406169666
18	Granada	171	18171	Salar	2781	1377	1404	49.5145631067961	50.4854368932039
18	Granada	173	18173	Salobreña	10168	5051	5117	49.6754523996853	50.3245476003147
18	Granada	174	18174	Santa Cruz del Comercio	539	277	262	51.39146567718	48.60853432282
18	Granada	175	18175	Santa Fe	12730	6297	6433	49.4658287509819	50.5341712490181
18	Granada	176	18176	Soportújar	268	143	125	53.3582089552239	46.6417910447761
18	Granada	177	18177	Sorvilán	633	325	308	51.3428120063191	48.6571879936809
18	Granada	178	18178	Torre-Cardela	1176	583	593	49.5748299319728	50.4251700680272
18	Granada	179	18179	Torvizcón	916	463	453	50.5458515283843	49.4541484716157
18	Granada	180	18180	Trevélez	762	404	358	53.0183727034121	46.9816272965879
18	Granada	181	18181	Turón	359	201	158	55.9888579387187	44.0111420612813
18	Granada	182	18182	Ugíjar	2464	1233	1231	50.0405844155844	49.9594155844156
18	Granada	183	18183	Válor	921	464	457	50.3800217155266	49.6199782844734
18	Granada	184	18184	Vélez de Benaudalla	2467	1210	1257	49.0474260235103	50.9525739764897
18	Granada	185	18185	Ventas de Huelma	653	327	326	50.0765696784073	49.9234303215926
18	Granada	187	18187	Villanueva de las Torres	903	470	433	52.0487264673311	47.9512735326689
18	Granada	188	18188	Villanueva Mesía	1954	963	991	49.2835209825998	50.7164790174002
18	Granada	189	18189	Víznar	745	398	347	53.4228187919463	46.5771812080537
18	Granada	192	18192	Zafarraya	2176	1138	1038	52.2977941176471	47.7022058823529
18	Granada	193	18193	Zubia (La)	12850	6317	6533	49.15953307393	50.84046692607
18	Granada	194	18194	Zújar	2752	1407	1345	51.1264534883721	48.8735465116279
18	Granada	901	18901	Taha (La)	789	396	393	50.1901140684411	49.8098859315589
18	Granada	902	18902	Valle (El)	1283	626	657	48.7918939984412	51.2081060015589
18	Granada	903	18903	Nevada	1375	698	677	50.7636363636364	49.2363636363636
18	Granada	904	18904	Alpujarra de la Sierra	1191	598	593	50.2099076406381	49.7900923593619
18	Granada	905	18905	Gabias (Las)	8577	4348	4229	50.6937157514282	49.3062842485718
18	Granada	906	18906	Guajares (Los)	1292	673	619	52.0897832817338	47.9102167182663
18	Granada	907	18907	Valle del Zalabí	2320	1142	1178	49.2241379310345	50.7758620689655
18	Granada	908	18908	Villamena	995	473	522	47.5376884422111	52.4623115577889
18	Granada	909	18909	Morelábor	942	490	452	52.0169851380043	47.9830148619958
18	Granada	910	18910	Pinar (El)	1198	611	587	51.0016694490818	48.9983305509182
18	Granada	911	18911	Vegas del Genil	2893	1452	1441	50.1901140684411	49.8098859315589
18	Granada	912	18912	Cuevas del Campo	2161	1066	1095	49.3290143452106	50.6709856547895
18	Granada	913	18913	Zagra	1151	572	579	49.6959165942659	50.3040834057341
19	Guadalajara	001	19001	Abánades	116	66	50	56.8965517241379	43.1034482758621
19	Guadalajara	002	19002	Ablanque	153	77	76	50.3267973856209	49.6732026143791
19	Guadalajara	003	19003	Adobes	41	20	21	48.7804878048781	51.219512195122
19	Guadalajara	004	19004	Alaminos	81	38	43	46.9135802469136	53.0864197530864
19	Guadalajara	005	19005	Alarilla	136	83	53	61.0294117647059	38.9705882352941
19	Guadalajara	006	19006	Albalate de Zorita	910	493	417	54.1758241758242	45.8241758241758
19	Guadalajara	007	19007	Albares	484	243	241	50.2066115702479	49.7933884297521
19	Guadalajara	008	19008	Albendiego	46	26	20	56.5217391304348	43.4782608695652
19	Guadalajara	009	19009	Alcocer	313	157	156	50.1597444089457	49.8402555910543
19	Guadalajara	010	19010	Alcolea de las Peñas	29	15	14	51.7241379310345	48.2758620689655
19	Guadalajara	011	19011	Alcolea del Pinar	413	208	205	50.363196125908	49.636803874092
19	Guadalajara	013	19013	Alcoroches	182	102	80	56.043956043956	43.956043956044
19	Guadalajara	015	19015	Aldeanueva de Guadalajara	104	45	59	43.2692307692308	56.7307692307692
19	Guadalajara	016	19016	Algar de Mesa	80	43	37	53.75	46.25
19	Guadalajara	017	19017	Algora	124	67	57	54.0322580645161	45.9677419354839
19	Guadalajara	018	19018	Alhóndiga	225	124	101	55.1111111111111	44.8888888888889
19	Guadalajara	019	19019	Alique	40	13	27	32.5	67.5
19	Guadalajara	020	19020	Almadrones	97	64	33	65.979381443299	34.020618556701
19	Guadalajara	021	19021	Almoguera	1009	522	487	51.7343904856293	48.2656095143707
19	Guadalajara	022	19022	Almonacid de Zorita	870	413	457	47.4712643678161	52.5287356321839
19	Guadalajara	023	19023	Alocén	146	67	79	45.8904109589041	54.1095890410959
19	Guadalajara	024	19024	Alovera	1864	967	897	51.8776824034335	48.1223175965665
19	Guadalajara	027	19027	Alustante	253	139	114	54.9407114624506	45.0592885375494
19	Guadalajara	031	19031	Angón	45	25	20	55.5555555555556	44.4444444444444
19	Guadalajara	032	19032	Anguita	275	142	133	51.6363636363636	48.3636363636364
19	Guadalajara	033	19033	Anquela del Ducado	94	50	44	53.1914893617021	46.8085106382979
19	Guadalajara	034	19034	Anquela del Pedregal	24	15	9	62.5	37.5
19	Guadalajara	036	19036	Aranzueque	378	184	194	48.6772486772487	51.3227513227513
19	Guadalajara	037	19037	Arbancón	217	117	100	53.9170506912442	46.0829493087558
19	Guadalajara	038	19038	Arbeteta	87	41	46	47.1264367816092	52.8735632183908
19	Guadalajara	039	19039	Argecilla	107	64	43	59.8130841121495	40.1869158878505
19	Guadalajara	040	19040	Armallones	63	36	27	57.1428571428571	42.8571428571429
19	Guadalajara	041	19041	Armuña de Tajuña	108	60	48	55.5555555555556	44.4444444444444
19	Guadalajara	042	19042	Arroyo de las Fraguas	42	22	20	52.3809523809524	47.6190476190476
19	Guadalajara	043	19043	Atanzón	98	57	41	58.1632653061225	41.8367346938776
19	Guadalajara	044	19044	Atienza	465	245	220	52.6881720430108	47.3118279569893
19	Guadalajara	045	19045	Auñón	255	134	121	52.5490196078431	47.4509803921569
19	Guadalajara	046	19046	Azuqueca de Henares	19491	9898	9593	50.7824123954646	49.2175876045354
19	Guadalajara	047	19047	Baides	80	40	40	50	50
19	Guadalajara	048	19048	Baños de Tajo	29	18	11	62.0689655172414	37.9310344827586
19	Guadalajara	049	19049	Bañuelos	31	18	13	58.0645161290323	41.9354838709677
19	Guadalajara	050	19050	Barriopedro	32	13	19	40.625	59.375
19	Guadalajara	051	19051	Berninches	117	66	51	56.4102564102564	43.5897435897436
19	Guadalajara	052	19052	Bodera (La)	56	31	25	55.3571428571429	44.6428571428571
19	Guadalajara	053	19053	Brihuega	2895	1491	1404	51.5025906735751	48.4974093264249
19	Guadalajara	054	19054	Budia	281	154	127	54.8042704626335	45.1957295373665
19	Guadalajara	055	19055	Bujalaro	88	46	42	52.2727272727273	47.7272727272727
19	Guadalajara	057	19057	Bustares	95	55	40	57.8947368421053	42.1052631578947
19	Guadalajara	058	19058	Cabanillas del Campo	2717	1397	1320	51.417004048583	48.582995951417
19	Guadalajara	059	19059	Campillo de Dueñas	132	76	56	57.5757575757576	42.4242424242424
19	Guadalajara	060	19060	Campillo de Ranas	152	83	69	54.6052631578947	45.3947368421053
19	Guadalajara	061	19061	Campisábalos	76	34	42	44.7368421052632	55.2631578947369
19	Guadalajara	064	19064	Canredondo	103	51	52	49.5145631067961	50.4854368932039
19	Guadalajara	065	19065	Cantalojas	158	83	75	52.5316455696203	47.4683544303798
19	Guadalajara	066	19066	Cañizar	104	48	56	46.1538461538462	53.8461538461539
19	Guadalajara	067	19067	Cardoso de la Sierra (El)	93	60	33	64.5161290322581	35.4838709677419
19	Guadalajara	070	19070	Casa de Uceda	108	55	53	50.9259259259259	49.0740740740741
19	Guadalajara	071	19071	Casar (El)	3404	1758	1646	51.6451233842538	48.3548766157462
19	Guadalajara	073	19073	Casas de San Galindo	35	21	14	60	40
19	Guadalajara	074	19074	Caspueñas	79	47	32	59.4936708860759	40.5063291139241
19	Guadalajara	075	19075	Castejón de Henares	107	58	49	54.2056074766355	45.7943925233645
19	Guadalajara	076	19076	Castellar de la Muela	55	27	28	49.0909090909091	50.9090909090909
19	Guadalajara	078	19078	Castilforte	47	27	20	57.4468085106383	42.5531914893617
19	Guadalajara	079	19079	Castilnuevo	11	5	6	45.4545454545455	54.5454545454545
19	Guadalajara	080	19080	Cendejas de Enmedio	124	63	61	50.8064516129032	49.1935483870968
19	Guadalajara	081	19081	Cendejas de la Torre	89	51	38	57.3033707865169	42.6966292134831
19	Guadalajara	082	19082	Centenera	72	39	33	54.1666666666667	45.8333333333333
19	Guadalajara	086	19086	Cifuentes	2195	1112	1083	50.6605922551253	49.3394077448747
19	Guadalajara	087	19087	Cincovillas	41	21	20	51.219512195122	48.7804878048781
19	Guadalajara	088	19088	Ciruelas	117	64	53	54.7008547008547	45.2991452991453
19	Guadalajara	089	19089	Ciruelos del Pinar	58	33	25	56.8965517241379	43.1034482758621
19	Guadalajara	090	19090	Cobeta	117	63	54	53.8461538461539	46.1538461538462
19	Guadalajara	091	19091	Cogollor	50	27	23	54	46
19	Guadalajara	092	19092	Cogolludo	610	341	269	55.9016393442623	44.0983606557377
19	Guadalajara	095	19095	Condemios de Abajo	29	17	12	58.6206896551724	41.3793103448276
19	Guadalajara	096	19096	Condemios de Arriba	161	80	81	49.6894409937888	50.3105590062112
19	Guadalajara	097	19097	Congostrina	45	22	23	48.8888888888889	51.1111111111111
19	Guadalajara	098	19098	Copernal	31	17	14	54.8387096774194	45.1612903225806
19	Guadalajara	099	19099	Corduente	456	249	207	54.6052631578947	45.3947368421053
19	Guadalajara	102	19102	Cubillo de Uceda (El)	131	63	68	48.0916030534351	51.9083969465649
19	Guadalajara	103	19103	Checa	410	223	187	54.390243902439	45.609756097561
19	Guadalajara	104	19104	Chequilla	21	12	9	57.1428571428571	42.8571428571429
19	Guadalajara	105	19105	Chiloeches	1040	540	500	51.9230769230769	48.0769230769231
19	Guadalajara	106	19106	Chillarón del Rey	123	63	60	51.219512195122	48.7804878048781
19	Guadalajara	107	19107	Driebes	363	190	173	52.3415977961433	47.6584022038568
19	Guadalajara	108	19108	Durón	122	60	62	49.1803278688525	50.8196721311475
19	Guadalajara	109	19109	Embid	66	36	30	54.5454545454545	45.4545454545455
19	Guadalajara	110	19110	Escamilla	127	54	73	42.5196850393701	57.4803149606299
19	Guadalajara	111	19111	Escariche	192	101	91	52.6041666666667	47.3958333333333
19	Guadalajara	112	19112	Escopete	60	20	40	33.3333333333333	66.6666666666667
19	Guadalajara	113	19113	Espinosa de Henares	576	285	291	49.4791666666667	50.5208333333333
19	Guadalajara	114	19114	Esplegares	63	38	25	60.3174603174603	39.6825396825397
19	Guadalajara	115	19115	Establés	45	24	21	53.3333333333333	46.6666666666667
19	Guadalajara	116	19116	Estriégana	25	16	9	64	36
19	Guadalajara	117	19117	Fontanar	958	500	458	52.1920668058455	47.8079331941545
19	Guadalajara	118	19118	Fuembellida	16	9	7	56.25	43.75
19	Guadalajara	119	19119	Fuencemillán	107	56	51	52.3364485981308	47.6635514018692
19	Guadalajara	120	19120	Fuentelahiguera de Albatages	159	79	80	49.685534591195	50.314465408805
19	Guadalajara	121	19121	Fuentelencina	181	101	80	55.8011049723757	44.1988950276243
19	Guadalajara	122	19122	Fuentelsaz	133	62	71	46.6165413533835	53.3834586466165
19	Guadalajara	123	19123	Fuentelviejo	68	36	32	52.9411764705882	47.0588235294118
19	Guadalajara	124	19124	Fuentenovilla	226	124	102	54.8672566371681	45.1327433628319
19	Guadalajara	125	19125	Gajanejos	79	45	34	56.9620253164557	43.0379746835443
19	Guadalajara	126	19126	Galápagos	316	165	151	52.2151898734177	47.7848101265823
19	Guadalajara	127	19127	Galve de Sorbe	157	75	82	47.7707006369427	52.2292993630573
19	Guadalajara	129	19129	Gascueña de Bornova	48	26	22	54.1666666666667	45.8333333333333
19	Guadalajara	130	19130	Guadalajara	66103	32254	33849	48.7935494606901	51.2064505393099
19	Guadalajara	132	19132	Henche	89	49	40	55.0561797752809	44.9438202247191
19	Guadalajara	133	19133	Heras de Ayuso	116	59	57	50.8620689655172	49.1379310344828
19	Guadalajara	134	19134	Herrería	33	17	16	51.5151515151515	48.4848484848485
19	Guadalajara	135	19135	Hiendelaencina	135	70	65	51.8518518518519	48.1481481481482
19	Guadalajara	136	19136	Hijes	26	14	12	53.8461538461539	46.1538461538462
19	Guadalajara	138	19138	Hita	257	144	113	56.0311284046693	43.9688715953307
19	Guadalajara	139	19139	Hombrados	43	24	19	55.8139534883721	44.1860465116279
19	Guadalajara	142	19142	Hontoba	187	92	95	49.1978609625668	50.8021390374332
19	Guadalajara	143	19143	Horche	1463	751	712	51.3328776486671	48.6671223513329
19	Guadalajara	145	19145	Hortezuela de Océn	81	44	37	54.320987654321	45.679012345679
19	Guadalajara	146	19146	Huerce (La)	41	23	18	56.0975609756098	43.9024390243903
19	Guadalajara	147	19147	Huérmeces del Cerro	61	39	22	63.9344262295082	36.0655737704918
19	Guadalajara	148	19148	Huertahernando	70	43	27	61.4285714285714	38.5714285714286
19	Guadalajara	150	19150	Hueva	142	67	75	47.1830985915493	52.8169014084507
19	Guadalajara	151	19151	Humanes	1209	614	595	50.7857733664185	49.2142266335815
19	Guadalajara	152	19152	Illana	675	351	324	52	48
19	Guadalajara	153	19153	Iniéstola	14	8	6	57.1428571428571	42.8571428571429
19	Guadalajara	154	19154	Inviernas (Las)	98	55	43	56.1224489795918	43.8775510204082
19	Guadalajara	155	19155	Irueste	68	38	30	55.8823529411765	44.1176470588235
19	Guadalajara	156	19156	Jadraque	1274	639	635	50.1569858712716	49.8430141287284
19	Guadalajara	157	19157	Jirueque	91	50	41	54.9450549450549	45.0549450549451
19	Guadalajara	159	19159	Ledanca	134	73	61	54.4776119402985	45.5223880597015
19	Guadalajara	160	19160	Loranca de Tajuña	346	194	152	56.0693641618497	43.9306358381503
19	Guadalajara	161	19161	Lupiana	262	144	118	54.9618320610687	45.0381679389313
19	Guadalajara	162	19162	Luzaga	114	55	59	48.2456140350877	51.7543859649123
19	Guadalajara	163	19163	Luzón	82	40	42	48.7804878048781	51.219512195122
19	Guadalajara	165	19165	Majaelrayo	56	32	24	57.1428571428571	42.8571428571429
19	Guadalajara	166	19166	Málaga del Fresno	212	111	101	52.3584905660377	47.6415094339623
19	Guadalajara	167	19167	Malaguilla	145	84	61	57.9310344827586	42.0689655172414
19	Guadalajara	168	19168	Mandayona	430	206	224	47.906976744186	52.093023255814
19	Guadalajara	169	19169	Mantiel	88	45	43	51.1363636363636	48.8636363636364
19	Guadalajara	170	19170	Maranchón	248	139	109	56.0483870967742	43.9516129032258
19	Guadalajara	171	19171	Marchamalo	4299	2237	2062	52.0353570597813	47.9646429402187
19	Guadalajara	172	19172	Masegoso de Tajuña	105	54	51	51.4285714285714	48.5714285714286
19	Guadalajara	173	19173	Matarrubia	51	32	19	62.7450980392157	37.2549019607843
19	Guadalajara	174	19174	Matillas	203	106	97	52.2167487684729	47.7832512315271
19	Guadalajara	175	19175	Mazarete	71	32	39	45.0704225352113	54.9295774647887
19	Guadalajara	176	19176	Mazuecos	367	191	176	52.0435967302452	47.9564032697548
19	Guadalajara	177	19177	Medranda	126	61	65	48.4126984126984	51.5873015873016
19	Guadalajara	178	19178	Megina	79	40	39	50.6329113924051	49.3670886075949
19	Guadalajara	179	19179	Membrillera	99	42	57	42.4242424242424	57.5757575757576
19	Guadalajara	181	19181	Miedes de Atienza	99	51	48	51.5151515151515	48.4848484848485
19	Guadalajara	182	19182	Mierla (La)	26	14	12	53.8461538461539	46.1538461538462
19	Guadalajara	183	19183	Milmarcos	116	58	58	50	50
19	Guadalajara	184	19184	Millana	114	59	55	51.7543859649123	48.2456140350877
19	Guadalajara	185	19185	Miñosa (La)	47	28	19	59.5744680851064	40.4255319148936
19	Guadalajara	186	19186	Mirabueno	120	64	56	53.3333333333333	46.6666666666667
19	Guadalajara	187	19187	Miralrío	90	49	41	54.4444444444444	45.5555555555556
19	Guadalajara	188	19188	Mochales	114	53	61	46.4912280701754	53.5087719298246
19	Guadalajara	189	19189	Mohernando	123	66	57	53.6585365853659	46.3414634146342
19	Guadalajara	190	19190	Molina de Aragón	3304	1691	1613	51.180387409201	48.819612590799
19	Guadalajara	191	19191	Monasterio	17	6	11	35.2941176470588	64.7058823529412
19	Guadalajara	192	19192	Mondéjar	2138	1067	1071	49.9064546304958	50.0935453695042
19	Guadalajara	193	19193	Montarrón	58	33	25	56.8965517241379	43.1034482758621
19	Guadalajara	194	19194	Moratilla de los Meleros	96	51	45	53.125	46.875
19	Guadalajara	195	19195	Morenilla	55	32	23	58.1818181818182	41.8181818181818
19	Guadalajara	196	19196	Muduex	114	58	56	50.8771929824562	49.1228070175439
19	Guadalajara	197	19197	Navas de Jadraque (Las)	29	16	13	55.1724137931034	44.8275862068966
19	Guadalajara	198	19198	Negredo	21	10	11	47.6190476190476	52.3809523809524
19	Guadalajara	199	19199	Ocentejo	53	23	30	43.3962264150943	56.6037735849057
19	Guadalajara	200	19200	Olivar (El)	134	62	72	46.2686567164179	53.7313432835821
19	Guadalajara	201	19201	Olmeda de Cobeta	72	28	44	38.8888888888889	61.1111111111111
19	Guadalajara	202	19202	Olmeda de Jadraque (La)	32	13	19	40.625	59.375
19	Guadalajara	203	19203	Ordial (El)	51	19	32	37.2549019607843	62.7450980392157
19	Guadalajara	204	19204	Orea	289	154	135	53.2871972318339	46.7128027681661
19	Guadalajara	208	19208	Pálmaces de Jadraque	69	37	32	53.6231884057971	46.3768115942029
19	Guadalajara	209	19209	Pardos	64	33	31	51.5625	48.4375
19	Guadalajara	210	19210	Paredes de Sigüenza	55	30	25	54.5454545454545	45.4545454545455
19	Guadalajara	211	19211	Pareja	504	258	246	51.1904761904762	48.8095238095238
19	Guadalajara	212	19212	Pastrana	1128	567	561	50.2659574468085	49.7340425531915
19	Guadalajara	213	19213	Pedregal (El)	106	57	49	53.7735849056604	46.2264150943396
19	Guadalajara	214	19214	Peñalén	138	77	61	55.7971014492754	44.2028985507246
19	Guadalajara	215	19215	Peñalver	237	136	101	57.3839662447257	42.6160337552743
19	Guadalajara	216	19216	Peralejos de las Truchas	170	90	80	52.9411764705882	47.0588235294118
19	Guadalajara	217	19217	Peralveche	166	89	77	53.6144578313253	46.3855421686747
19	Guadalajara	218	19218	Pinilla de Jadraque	88	44	44	50	50
19	Guadalajara	219	19219	Pinilla de Molina	26	16	10	61.5384615384615	38.4615384615385
19	Guadalajara	220	19220	Pioz	431	234	197	54.292343387471	45.707656612529
19	Guadalajara	221	19221	Piqueras	71	42	29	59.1549295774648	40.8450704225352
19	Guadalajara	222	19222	Pobo de Dueñas (El)	172	94	78	54.6511627906977	45.3488372093023
19	Guadalajara	223	19223	Poveda de la Sierra	195	102	93	52.3076923076923	47.6923076923077
19	Guadalajara	224	19224	Pozo de Almoguera	181	95	86	52.4861878453039	47.5138121546961
19	Guadalajara	225	19225	Pozo de Guadalajara	381	199	182	52.2309711286089	47.7690288713911
19	Guadalajara	226	19226	Prádena de Atienza	46	28	18	60.8695652173913	39.1304347826087
19	Guadalajara	227	19227	Prados Redondos	84	51	33	60.7142857142857	39.2857142857143
19	Guadalajara	228	19228	Puebla de Beleña	46	28	18	60.8695652173913	39.1304347826087
19	Guadalajara	229	19229	Puebla de Valles	70	39	31	55.7142857142857	44.2857142857143
19	Guadalajara	230	19230	Quer	82	41	41	50	50
19	Guadalajara	231	19231	Rebollosa de Jadraque	32	19	13	59.375	40.625
19	Guadalajara	232	19232	Recuenco (El)	111	55	56	49.5495495495496	50.4504504504505
19	Guadalajara	233	19233	Renera	64	34	30	53.125	46.875
19	Guadalajara	234	19234	Retiendas	54	26	28	48.1481481481482	51.8518518518519
19	Guadalajara	235	19235	Riba de Saelices	171	94	77	54.9707602339181	45.0292397660819
19	Guadalajara	237	19237	Rillo de Gallo	60	34	26	56.6666666666667	43.3333333333333
19	Guadalajara	238	19238	Riofrío del Llano	63	35	28	55.5555555555556	44.4444444444444
19	Guadalajara	239	19239	Robledillo de Mohernando	174	88	86	50.5747126436782	49.4252873563218
19	Guadalajara	240	19240	Robledo de Corpes	104	50	54	48.0769230769231	51.9230769230769
19	Guadalajara	241	19241	Romanillos de Atienza	63	37	26	58.7301587301587	41.2698412698413
19	Guadalajara	242	19242	Romanones	140	78	62	55.7142857142857	44.2857142857143
19	Guadalajara	243	19243	Rueda de la Sierra	66	34	32	51.5151515151515	48.4848484848485
19	Guadalajara	244	19244	Sacecorbo	161	90	71	55.9006211180124	44.0993788819876
19	Guadalajara	245	19245	Sacedón	1554	791	763	50.9009009009009	49.0990990990991
19	Guadalajara	246	19246	Saelices de la Sal	66	34	32	51.5151515151515	48.4848484848485
19	Guadalajara	247	19247	Salmerón	252	131	121	51.984126984127	48.015873015873
19	Guadalajara	248	19248	San Andrés del Congosto	84	44	40	52.3809523809524	47.6190476190476
19	Guadalajara	249	19249	San Andrés del Rey	46	19	27	41.304347826087	58.695652173913
19	Guadalajara	250	19250	Santiuste	26	15	11	57.6923076923077	42.3076923076923
19	Guadalajara	251	19251	Saúca	73	35	38	47.9452054794521	52.0547945205479
19	Guadalajara	252	19252	Sayatón	150	81	69	54	46
19	Guadalajara	254	19254	Selas	60	26	34	43.3333333333333	56.6666666666667
19	Guadalajara	255	19255	Setiles	162	88	74	54.320987654321	45.679012345679
19	Guadalajara	256	19256	Sienes	83	47	36	56.6265060240964	43.3734939759036
19	Guadalajara	257	19257	Sigüenza	4594	2299	2295	50.0435350457118	49.9564649542882
19	Guadalajara	258	19258	Solanillos del Extremo	124	64	60	51.6129032258065	48.3870967741936
19	Guadalajara	259	19259	Somolinos	51	25	26	49.0196078431373	50.9803921568627
19	Guadalajara	260	19260	Sotillo (El)	47	25	22	53.1914893617021	46.8085106382979
19	Guadalajara	261	19261	Sotodosos	64	30	34	46.875	53.125
19	Guadalajara	262	19262	Tamajón	238	116	122	48.7394957983193	51.2605042016807
19	Guadalajara	263	19263	Taragudo	33	20	13	60.6060606060606	39.3939393939394
19	Guadalajara	264	19264	Taravilla	72	38	34	52.7777777777778	47.2222222222222
19	Guadalajara	265	19265	Tartanedo	195	95	100	48.7179487179487	51.2820512820513
19	Guadalajara	266	19266	Tendilla	338	178	160	52.6627218934911	47.3372781065089
19	Guadalajara	267	19267	Terzaga	32	19	13	59.375	40.625
19	Guadalajara	268	19268	Tierzo	53	28	25	52.8301886792453	47.1698113207547
19	Guadalajara	269	19269	Toba (La)	120	69	51	57.5	42.5
19	Guadalajara	270	19270	Tordelrábano	12	5	7	41.6666666666667	58.3333333333333
19	Guadalajara	271	19271	Tordellego	74	36	38	48.6486486486487	51.3513513513514
19	Guadalajara	272	19272	Tordesilos	139	72	67	51.7985611510791	48.2014388489209
19	Guadalajara	274	19274	Torija	449	222	227	49.4432071269488	50.5567928730512
19	Guadalajara	277	19277	Torrecuadrada de Molina	22	14	8	63.6363636363636	36.3636363636364
19	Guadalajara	278	19278	Torrecuadradilla	61	37	24	60.655737704918	39.344262295082
19	Guadalajara	279	19279	Torre del Burgo	74	45	29	60.8108108108108	39.1891891891892
19	Guadalajara	280	19280	Torrejón del Rey	1211	621	590	51.2799339388935	48.7200660611065
19	Guadalajara	281	19281	Torremocha de Jadraque	18	13	5	72.2222222222222	27.7777777777778
19	Guadalajara	282	19282	Torremocha del Campo	317	173	144	54.5741324921136	45.4258675078864
19	Guadalajara	283	19283	Torremocha del Pinar	67	30	37	44.7761194029851	55.2238805970149
19	Guadalajara	284	19284	Torremochuela	16	10	6	62.5	37.5
19	Guadalajara	285	19285	Torrubia	44	24	20	54.5454545454545	45.4545454545455
19	Guadalajara	286	19286	Tórtola de Henares	434	227	207	52.3041474654378	47.6958525345622
19	Guadalajara	287	19287	Tortuera	223	117	106	52.4663677130045	47.5336322869955
19	Guadalajara	288	19288	Tortuero	37	22	15	59.4594594594595	40.5405405405405
19	Guadalajara	289	19289	Traíd	62	29	33	46.7741935483871	53.2258064516129
19	Guadalajara	290	19290	Trijueque	465	245	220	52.6881720430108	47.3118279569893
19	Guadalajara	291	19291	Trillo	1387	711	676	51.2617159336698	48.7382840663302
19	Guadalajara	293	19293	Uceda	930	466	464	50.1075268817204	49.8924731182796
19	Guadalajara	294	19294	Ujados	33	17	16	51.5151515151515	48.4848484848485
19	Guadalajara	296	19296	Utande	57	37	20	64.9122807017544	35.0877192982456
19	Guadalajara	297	19297	Valdarachas	28	11	17	39.2857142857143	60.7142857142857
19	Guadalajara	298	19298	Valdearenas	81	40	41	49.3827160493827	50.6172839506173
19	Guadalajara	299	19299	Valdeavellano	89	49	40	55.0561797752809	44.9438202247191
19	Guadalajara	300	19300	Valdeaveruelo	318	172	146	54.0880503144654	45.9119496855346
19	Guadalajara	301	19301	Valdeconcha	85	44	41	51.764705882353	48.2352941176471
19	Guadalajara	302	19302	Valdegrudas	57	32	25	56.140350877193	43.859649122807
19	Guadalajara	303	19303	Valdelcubo	66	38	28	57.5757575757576	42.4242424242424
19	Guadalajara	304	19304	Valdenuño Fernández	152	83	69	54.6052631578947	45.3947368421053
19	Guadalajara	305	19305	Valdepeñas de la Sierra	226	121	105	53.5398230088496	46.4601769911504
19	Guadalajara	306	19306	Valderrebollo	37	19	18	51.3513513513514	48.6486486486487
19	Guadalajara	307	19307	Valdesotos	38	15	23	39.4736842105263	60.5263157894737
19	Guadalajara	308	19308	Valfermoso de Tajuña	103	54	49	52.4271844660194	47.5728155339806
19	Guadalajara	309	19309	Valhermoso	48	29	19	60.4166666666667	39.5833333333333
19	Guadalajara	310	19310	Valtablado del Río	14	9	5	64.2857142857143	35.7142857142857
19	Guadalajara	311	19311	Valverde de los Arroyos	102	54	48	52.9411764705882	47.0588235294118
19	Guadalajara	314	19314	Viana de Jadraque	53	32	21	60.377358490566	39.622641509434
19	Guadalajara	317	19317	Villanueva de Alcorón	279	154	125	55.1971326164875	44.8028673835126
19	Guadalajara	318	19318	Villanueva de Argecilla	40	21	19	52.5	47.5
19	Guadalajara	319	19319	Villanueva de la Torre	1309	687	622	52.4828113063407	47.5171886936593
19	Guadalajara	321	19321	Villares de Jadraque	54	27	27	50	50
19	Guadalajara	322	19322	Villaseca de Henares	72	37	35	51.3888888888889	48.6111111111111
19	Guadalajara	323	19323	Villaseca de Uceda	67	35	32	52.2388059701493	47.7611940298507
19	Guadalajara	324	19324	Villel de Mesa	255	133	122	52.1568627450981	47.843137254902
19	Guadalajara	325	19325	Viñuelas	125	75	50	60	40
19	Guadalajara	326	19326	Yebes	167	117	50	70.059880239521	29.940119760479
19	Guadalajara	327	19327	Yebra	524	271	253	51.7175572519084	48.2824427480916
19	Guadalajara	329	19329	Yélamos de Abajo	112	54	58	48.2142857142857	51.7857142857143
19	Guadalajara	330	19330	Yélamos de Arriba	167	91	76	54.4910179640719	45.5089820359281
19	Guadalajara	331	19331	Yunquera de Henares	2039	1031	1008	50.564001961746	49.4359980382541
19	Guadalajara	332	19332	Yunta (La)	168	82	86	48.8095238095238	51.1904761904762
19	Guadalajara	333	19333	Zaorejas	206	116	90	56.3106796116505	43.6893203883495
19	Guadalajara	334	19334	Zarzuela de Jadraque	44	17	27	38.6363636363636	61.3636363636364
19	Guadalajara	335	19335	Zorita de los Canes	96	52	44	54.1666666666667	45.8333333333333
19	Guadalajara	901	19901	Semillas	42	21	21	50	50
20	Guipúzcoa	001	20001	Abaltzisketa	258	153	105	59.3023255813954	40.6976744186047
20	Guipúzcoa	002	20002	Aduna	315	169	146	53.6507936507937	46.3492063492063
20	Guipúzcoa	003	20003	Aizarnazabal	534	284	250	53.1835205992509	46.8164794007491
20	Guipúzcoa	004	20004	Albiztur	291	162	129	55.6701030927835	44.3298969072165
20	Guipúzcoa	005	20005	Alegia	1595	813	782	50.9717868338558	49.0282131661442
20	Guipúzcoa	006	20006	Alkiza	254	143	111	56.2992125984252	43.7007874015748
20	Guipúzcoa	007	20007	Altzo	331	171	160	51.6616314199396	48.3383685800604
20	Guipúzcoa	008	20008	Amezketa	989	516	473	52.1739130434783	47.8260869565217
20	Guipúzcoa	009	20009	Andoain	14153	7091	7062	50.1024517770084	49.8975482229916
20	Guipúzcoa	010	20010	Anoeta	1707	878	829	51.4352665495021	48.5647334504979
20	Guipúzcoa	011	20011	Antzuola	1896	967	929	51.0021097046413	48.9978902953587
20	Guipúzcoa	012	20012	Arama	167	82	85	49.1017964071856	50.8982035928144
20	Guipúzcoa	013	20013	Aretxabaleta	6101	3108	2993	50.9424684477954	49.0575315522046
20	Guipúzcoa	014	20014	Asteasu	1187	635	552	53.4962089300758	46.5037910699242
20	Guipúzcoa	015	20015	Ataun	1558	811	747	52.0539152759949	47.9460847240051
20	Guipúzcoa	016	20016	Aia	1650	916	734	55.5151515151515	44.4848484848485
20	Guipúzcoa	017	20017	Azkoitia	10192	5065	5127	49.6958398744113	50.3041601255887
20	Guipúzcoa	018	20018	Azpeitia	13657	6854	6803	50.1867174342828	49.8132825657172
20	Guipúzcoa	019	20019	Beasain	12134	6060	6074	49.9423108620405	50.0576891379595
20	Guipúzcoa	020	20020	Beizama	160	90	70	56.25	43.75
20	Guipúzcoa	021	20021	Belauntza	321	174	147	54.2056074766355	45.7943925233645
20	Guipúzcoa	022	20022	Berastegi	977	534	443	54.6571136131013	45.3428863868987
20	Guipúzcoa	023	20023	Berrobi	553	298	255	53.8878842676311	46.1121157323689
20	Guipúzcoa	024	20024	Bidegoyan	417	234	183	56.1151079136691	43.8848920863309
20	Guipúzcoa	025	20025	Zegama	1276	655	621	51.3322884012539	48.6677115987461
20	Guipúzcoa	026	20026	Zerain	246	127	119	51.6260162601626	48.3739837398374
20	Guipúzcoa	027	20027	Zestoa	3140	1623	1517	51.687898089172	48.312101910828
20	Guipúzcoa	028	20028	Zizurkil	2843	1450	1393	51.0024621878298	48.9975378121702
20	Guipúzcoa	029	20029	Deba	5092	2577	2515	50.6087981146897	49.3912018853103
20	Guipúzcoa	030	20030	Eibar	28942	14165	14777	48.9427130122314	51.0572869877686
20	Guipúzcoa	031	20031	Elduain	193	99	94	51.2953367875648	48.7046632124352
20	Guipúzcoa	032	20032	Elgoibar	10702	5358	5344	50.0654083348907	49.9345916651093
20	Guipúzcoa	033	20033	Elgeta	968	496	472	51.2396694214876	48.7603305785124
20	Guipúzcoa	034	20034	Eskoriatza	3943	2028	1915	51.4329190971342	48.5670809028658
20	Guipúzcoa	035	20035	Ezkio-Itsaso	555	298	257	53.6936936936937	46.3063063063063
20	Guipúzcoa	036	20036	Hondarribia	14863	7431	7432	49.9966359416	50.0033640584001
20	Guipúzcoa	037	20037	Gaintza	133	83	50	62.406015037594	37.593984962406
20	Guipúzcoa	038	20038	Gabiria	430	238	192	55.3488372093023	44.6511627906977
20	Guipúzcoa	039	20039	Getaria	2436	1228	1208	50.4105090311987	49.5894909688013
20	Guipúzcoa	040	20040	Hernani	18698	9295	9403	49.7111990587229	50.2888009412771
20	Guipúzcoa	041	20041	Hernialde	289	146	143	50.5190311418685	49.4809688581315
20	Guipúzcoa	042	20042	Ibarra	4334	2252	2082	51.9612367328103	48.0387632671897
20	Guipúzcoa	043	20043	Idiazabal	2038	1032	1006	50.6378802747792	49.3621197252208
20	Guipúzcoa	044	20044	Ikaztegieta	382	196	186	51.3089005235602	48.6910994764398
20	Guipúzcoa	045	20045	Irun	56515	27635	28880	48.8985225161462	51.1014774838538
20	Guipúzcoa	046	20046	Irura	749	390	359	52.0694259012016	47.9305740987984
20	Guipúzcoa	047	20047	Itsasondo	588	292	296	49.6598639455782	50.3401360544218
20	Guipúzcoa	048	20048	Larraul	147	86	61	58.5034013605442	41.4965986394558
20	Guipúzcoa	049	20049	Lazkao	4876	2497	2379	51.2100082034455	48.7899917965546
20	Guipúzcoa	050	20050	Leaburu	351	186	165	52.991452991453	47.008547008547
20	Guipúzcoa	051	20051	Legazpi	8958	4609	4349	51.4512167894619	48.5487832105381
20	Guipúzcoa	052	20052	Legorreta	1399	713	686	50.9649749821301	49.0350250178699
20	Guipúzcoa	053	20053	Lezo	5799	2903	2896	50.060355233661	49.939644766339
20	Guipúzcoa	054	20054	Lizartza	592	304	288	51.3513513513514	48.6486486486487
20	Guipúzcoa	055	20055	Arrasate o Mondragón	23718	11863	11855	50.0168648284004	49.9831351715996
20	Guipúzcoa	056	20056	Mutriku	4790	2384	2406	49.7703549060543	50.2296450939457
20	Guipúzcoa	057	20057	Mutiloa	165	85	80	51.5151515151515	48.4848484848485
20	Guipúzcoa	058	20058	Olaberria	923	477	446	51.6793066088841	48.3206933911159
20	Guipúzcoa	059	20059	Oñati	10717	5367	5350	50.0793132406457	49.9206867593543
20	Guipúzcoa	060	20060	Orexa	81	45	36	55.5555555555556	44.4444444444444
20	Guipúzcoa	061	20061	Orio	4388	2221	2167	50.6153144940747	49.3846855059253
20	Guipúzcoa	062	20062	Ormaiztegi	1159	592	567	51.0785159620362	48.9214840379638
20	Guipúzcoa	063	20063	Oiartzun	9185	4627	4558	50.3756124115406	49.6243875884595
20	Guipúzcoa	064	20064	Pasaia	16776	8137	8639	48.5038149737721	51.496185026228
20	Guipúzcoa	065	20065	Soraluze/Placencia de las Armas	4270	2119	2151	49.6252927400468	50.3747072599532
20	Guipúzcoa	066	20066	Errezil	631	339	292	53.7242472266244	46.2757527733756
20	Guipúzcoa	067	20067	Errenteria	39200	19292	19908	49.2142857142857	50.7857142857143
20	Guipúzcoa	068	20068	Leintz-Gatzaga	258	143	115	55.4263565891473	44.5736434108527
20	Guipúzcoa	069	20069	Donostia-San Sebastián	180277	84663	95614	46.9627295772617	53.0372704227383
20	Guipúzcoa	070	20070	Segura	1247	622	625	49.8797113071371	50.1202886928629
20	Guipúzcoa	071	20071	Tolosa	18076	8708	9368	48.1743748616951	51.8256251383049
20	Guipúzcoa	072	20072	Urnieta	5488	2806	2682	51.1297376093295	48.8702623906706
20	Guipúzcoa	073	20073	Usurbil	5292	2716	2576	51.3227513227513	48.6772486772487
20	Guipúzcoa	074	20074	Bergara	15089	7515	7574	49.8044933395189	50.1955066604812
20	Guipúzcoa	075	20075	Villabona	5531	2790	2741	50.4429578738022	49.5570421261978
20	Guipúzcoa	076	20076	Ordizia	9089	4405	4684	48.4651776873143	51.5348223126857
20	Guipúzcoa	077	20077	Urretxu	6428	3225	3203	50.1711263223398	49.8288736776602
20	Guipúzcoa	078	20078	Zaldibia	1525	789	736	51.7377049180328	48.2622950819672
20	Guipúzcoa	079	20079	Zarautz	20638	10198	10440	49.4137028781859	50.5862971218141
20	Guipúzcoa	080	20080	Zumarraga	10300	5151	5149	50.0097087378641	49.9902912621359
20	Guipúzcoa	081	20081	Zumaia	8392	4183	4209	49.8450905624404	50.1549094375596
20	Guipúzcoa	901	20901	Mendaro	1378	709	669	51.4513788098694	48.5486211901306
20	Guipúzcoa	902	20902	Lasarte-Oria	17561	8750	8811	49.8263196856671	50.1736803143329
20	Guipúzcoa	903	20903	Astigarraga	3435	1714	1721	49.8981077147016	50.1018922852984
20	Guipúzcoa	904	20904	Baliarrain	88	45	43	51.1363636363636	48.8636363636364
20	Guipúzcoa	905	20905	Orendain	146	84	62	57.5342465753425	42.4657534246575
20	Guipúzcoa	906	20906	Altzaga	98	50	48	51.0204081632653	48.9795918367347
20	Guipúzcoa	907	20907	Gaztelu	157	88	69	56.0509554140127	43.9490445859873
21	Huelva	001	21001	Alájar	776	392	384	50.5154639175258	49.4845360824742
21	Huelva	002	21002	Aljaraque	10806	5414	5392	50.101795298908	49.898204701092
21	Huelva	003	21003	Almendro (El)	864	448	416	51.8518518518519	48.1481481481482
21	Huelva	004	21004	Almonaster la Real	1963	960	1003	48.9047376464595	51.0952623535405
21	Huelva	005	21005	Almonte	17444	8774	8670	50.2980967667966	49.7019032332034
21	Huelva	006	21006	Alosno	4834	2324	2510	48.0761274306992	51.9238725693008
21	Huelva	007	21007	Aracena	6756	3287	3469	48.6530491415038	51.3469508584962
21	Huelva	008	21008	Aroche	3503	1738	1765	49.6146160433914	50.3853839566086
21	Huelva	009	21009	Arroyomolinos de León	1157	594	563	51.3396715643907	48.6603284356093
21	Huelva	010	21010	Ayamonte	16939	8322	8617	49.1292284078163	50.8707715921837
21	Huelva	011	21011	Beas	4124	2062	2062	50	50
21	Huelva	012	21012	Berrocal	409	201	208	49.1442542787286	50.8557457212714
21	Huelva	013	21013	Bollullos Par del Condado	12822	6378	6444	49.7426298549368	50.2573701450632
21	Huelva	014	21014	Bonares	5122	2609	2513	50.9371339320578	49.0628660679422
21	Huelva	015	21015	Cabezas Rubias	962	498	464	51.7671517671518	48.2328482328482
21	Huelva	016	21016	Cala	1414	704	710	49.7878359264498	50.2121640735502
21	Huelva	017	21017	Calañas	4725	2315	2410	48.994708994709	51.005291005291
21	Huelva	018	21018	Campillo (El)	2430	1169	1261	48.1069958847737	51.8930041152263
21	Huelva	019	21019	Campofrío	844	428	416	50.7109004739336	49.2890995260664
21	Huelva	020	21020	Cañaveral de León	501	240	261	47.9041916167665	52.0958083832335
21	Huelva	021	21021	Cartaya	12584	6291	6293	49.9920534011443	50.0079465988557
21	Huelva	022	21022	Castaño del Robledo	200	106	94	53	47
21	Huelva	023	21023	Cerro de Andévalo (El)	2741	1337	1404	48.7778183144838	51.2221816855162
21	Huelva	024	21024	Corteconcepción	672	339	333	50.4464285714286	49.5535714285714
21	Huelva	025	21025	Cortegana	5084	2519	2565	49.5476003147128	50.4523996852872
21	Huelva	026	21026	Cortelazor	317	158	159	49.8422712933754	50.1577287066246
21	Huelva	027	21027	Cumbres de Enmedio	62	31	31	50	50
21	Huelva	028	21028	Cumbres de San Bartolomé	575	286	289	49.7391304347826	50.2608695652174
21	Huelva	029	21029	Cumbres Mayores	2119	1039	1080	49.0325625294951	50.9674374705049
21	Huelva	030	21030	Chucena	1964	989	975	50.3564154786151	49.6435845213849
21	Huelva	031	21031	Encinasola	1789	876	913	48.9659027389603	51.0340972610397
21	Huelva	032	21032	Escacena del Campo	2190	1094	1096	49.9543378995434	50.0456621004566
21	Huelva	033	21033	Fuenteheridos	636	320	316	50.314465408805	49.685534591195
21	Huelva	034	21034	Galaroza	1603	769	834	47.9725514660012	52.0274485339988
21	Huelva	035	21035	Gibraleón	10827	5495	5332	50.7527477602291	49.2472522397709
21	Huelva	036	21036	Granada de Río-Tinto (La)	222	115	107	51.8018018018018	48.1981981981982
21	Huelva	037	21037	Granado (El)	661	359	302	54.3116490166415	45.6883509833586
21	Huelva	038	21038	Higuera de la Sierra	1258	634	624	50.3974562798092	49.6025437201908
21	Huelva	039	21039	Hinojales	432	218	214	50.462962962963	49.537037037037
21	Huelva	040	21040	Hinojos	3556	1799	1757	50.5905511811024	49.4094488188976
21	Huelva	041	21041	Huelva	140985	68077	72908	48.2866971663652	51.7133028336348
21	Huelva	042	21042	Isla Cristina	18236	9155	9081	50.2028953717921	49.7971046282079
21	Huelva	043	21043	Jabugo	2558	1284	1274	50.1954652071931	49.8045347928069
21	Huelva	044	21044	Lepe	19086	9784	9302	51.2627056481191	48.737294351881
21	Huelva	045	21045	Linares de la Sierra	316	153	163	48.4177215189873	51.5822784810127
21	Huelva	046	21046	Lucena del Puerto	2237	1167	1070	52.1680822530174	47.8319177469826
21	Huelva	047	21047	Manzanilla	2504	1237	1267	49.4009584664537	50.5990415335463
21	Huelva	048	21048	Marines (Los)	328	162	166	49.390243902439	50.609756097561
21	Huelva	049	21049	Minas de Riotinto	4888	2325	2563	47.5654664484452	52.4345335515548
21	Huelva	050	21050	Moguer	14389	7324	7065	50.8999930502467	49.1000069497533
21	Huelva	051	21051	Nava (La)	319	167	152	52.3510971786834	47.6489028213166
21	Huelva	052	21052	Nerva	6413	3106	3307	48.432870731327	51.567129268673
21	Huelva	053	21053	Niebla	3847	1938	1909	50.3769170782428	49.6230829217572
21	Huelva	054	21054	Palma del Condado (La)	9695	4798	4897	49.4894275399691	50.5105724600309
21	Huelva	055	21055	Palos de la Frontera	7115	3638	3477	51.1314125087843	48.8685874912157
21	Huelva	056	21056	Paterna del Campo	3894	1991	1903	51.1299435028249	48.8700564971751
21	Huelva	057	21057	Paymogo	1269	621	648	48.936170212766	51.063829787234
21	Huelva	058	21058	Puebla de Guzmán	3253	1648	1605	50.6609283738088	49.3390716261912
21	Huelva	059	21059	Puerto Moral	254	125	129	49.2125984251969	50.7874015748032
21	Huelva	060	21060	Punta Umbría	11987	6081	5906	50.7299574539084	49.2700425460916
21	Huelva	061	21061	Rociana del Condado	6292	3217	3075	51.1284170375079	48.8715829624921
21	Huelva	062	21062	Rosal de la Frontera	1865	893	972	47.8820375335121	52.1179624664879
21	Huelva	063	21063	San Bartolomé de la Torre	2945	1490	1455	50.5942275042445	49.4057724957555
21	Huelva	064	21064	San Juan del Puerto	5933	2961	2972	49.9072981628181	50.0927018371819
21	Huelva	065	21065	Sanlúcar de Guadiana	397	197	200	49.6221662468514	50.3778337531486
21	Huelva	066	21066	San Silvestre de Guzmán	647	320	327	49.4590417310665	50.5409582689335
21	Huelva	067	21067	Santa Ana la Real	509	239	270	46.9548133595285	53.0451866404715
21	Huelva	068	21068	Santa Bárbara de Casa	1337	672	665	50.261780104712	49.738219895288
21	Huelva	069	21069	Santa Olalla del Cala	2244	1127	1117	50.222816399287	49.777183600713
21	Huelva	070	21070	Trigueros	7213	3596	3617	49.8544295022875	50.1455704977125
21	Huelva	071	21071	Valdelarco	275	132	143	48	52
21	Huelva	072	21072	Valverde del Camino	12480	6052	6428	48.4935897435897	51.5064102564102
21	Huelva	073	21073	Villablanca	2053	1060	993	51.631758402338	48.368241597662
21	Huelva	074	21074	Villalba del Alcor	3604	1795	1809	49.8057713651498	50.1942286348502
21	Huelva	075	21075	Villanueva de las Cruces	423	202	221	47.7541371158392	52.2458628841608
21	Huelva	076	21076	Villanueva de los Castillejos	2682	1319	1363	49.1797166293811	50.8202833706189
21	Huelva	077	21077	Villarrasa	2130	1082	1048	50.7981220657277	49.2018779342723
21	Huelva	078	21078	Zalamea la Real	3455	1693	1762	49.0014471780029	50.9985528219971
21	Huelva	079	21079	Zufre	1054	555	499	52.6565464895636	47.3434535104364
22	Huesca	001	22001	Abiego	292	145	147	49.6575342465753	50.3424657534247
22	Huesca	002	22002	Abizanda	137	72	65	52.5547445255475	47.4452554744526
22	Huesca	003	22003	Adahuesca	154	81	73	52.5974025974026	47.4025974025974
22	Huesca	004	22004	Agüero	172	92	80	53.4883720930233	46.5116279069767
22	Huesca	006	22006	Aisa	383	206	177	53.7859007832898	46.2140992167102
22	Huesca	007	22007	Albalate de Cinca	1149	592	557	51.5230635335074	48.4769364664926
22	Huesca	008	22008	Albalatillo	258	128	130	49.6124031007752	50.3875968992248
22	Huesca	009	22009	Albelda	937	481	456	51.3340448239061	48.6659551760939
22	Huesca	011	22011	Albero Alto	101	52	49	51.4851485148515	48.5148514851485
22	Huesca	012	22012	Albero Bajo	109	59	50	54.1284403669725	45.8715596330275
22	Huesca	013	22013	Alberuela de Tubo	388	192	196	49.4845360824742	50.5154639175258
22	Huesca	014	22014	Alcalá de Gurrea	319	153	166	47.9623824451411	52.0376175548589
22	Huesca	015	22015	Alcalá del Obispo	356	186	170	52.247191011236	47.7528089887641
22	Huesca	016	22016	Alcampell	911	444	467	48.7376509330406	51.2623490669594
22	Huesca	017	22017	Alcolea de Cinca	1214	614	600	50.5766062602965	49.4233937397035
22	Huesca	018	22018	Alcubierre	467	249	218	53.3190578158458	46.6809421841542
22	Huesca	019	22019	Alerre	195	102	93	52.3076923076923	47.6923076923077
22	Huesca	020	22020	Alfántega	117	61	56	52.1367521367522	47.8632478632479
22	Huesca	021	22021	Almudévar	2324	1188	1136	51.118760757315	48.881239242685
22	Huesca	022	22022	Almunia de San Juan	682	346	336	50.733137829912	49.266862170088
22	Huesca	023	22023	Almuniente	621	320	301	51.5297906602254	48.4702093397746
22	Huesca	024	22024	Alquézar	310	157	153	50.6451612903226	49.3548387096774
22	Huesca	025	22025	Altorricón	1462	760	702	51.983584131327	48.0164158686731
22	Huesca	027	22027	Angüés	435	237	198	54.4827586206897	45.5172413793104
22	Huesca	028	22028	Ansó	529	268	261	50.6616257088847	49.3383742911153
22	Huesca	029	22029	Antillón	164	83	81	50.609756097561	49.390243902439
22	Huesca	032	22032	Aragüés del Puerto	135	81	54	60	40
22	Huesca	035	22035	Arén	384	200	184	52.0833333333333	47.9166666666667
22	Huesca	036	22036	Argavieso	129	74	55	57.3643410852713	42.6356589147287
22	Huesca	037	22037	Arguis	68	39	29	57.3529411764706	42.6470588235294
22	Huesca	039	22039	Ayerbe	1106	561	545	50.7233273056058	49.2766726943942
22	Huesca	040	22040	Azanuy-Alins	193	86	107	44.559585492228	55.440414507772
22	Huesca	041	22041	Azara	216	108	108	50	50
22	Huesca	042	22042	Azlor	158	81	77	51.2658227848101	48.7341772151899
22	Huesca	043	22043	Baélls	153	85	68	55.5555555555556	44.4444444444444
22	Huesca	044	22044	Bailo	307	180	127	58.6319218241042	41.3680781758958
22	Huesca	045	22045	Baldellou	144	79	65	54.8611111111111	45.1388888888889
22	Huesca	046	22046	Ballobar	1062	534	528	50.2824858757062	49.7175141242938
22	Huesca	047	22047	Banastás	190	101	89	53.1578947368421	46.8421052631579
22	Huesca	048	22048	Barbastro	14671	7147	7524	48.7151523413537	51.2848476586463
22	Huesca	049	22049	Barbués	122	63	59	51.6393442622951	48.3606557377049
22	Huesca	050	22050	Barbuñales	112	58	54	51.7857142857143	48.2142857142857
22	Huesca	051	22051	Bárcabo	113	62	51	54.8672566371681	45.1327433628319
22	Huesca	052	22052	Belver de Cinca	1368	718	650	52.4853801169591	47.5146198830409
22	Huesca	053	22053	Benabarre	1139	594	545	52.1510096575944	47.8489903424056
22	Huesca	054	22054	Benasque	1496	792	704	52.9411764705882	47.0588235294118
22	Huesca	055	22055	Berbegal	466	233	233	50	50
22	Huesca	057	22057	Bielsa	474	240	234	50.6329113924051	49.3670886075949
22	Huesca	058	22058	Bierge	223	126	97	56.5022421524664	43.4977578475336
22	Huesca	059	22059	Biescas	1294	681	613	52.6275115919629	47.3724884080371
22	Huesca	060	22060	Binaced	1589	809	780	50.9125235997483	49.0874764002517
22	Huesca	061	22061	Binéfar	8228	4130	4098	50.1944579484686	49.8055420515314
22	Huesca	062	22062	Bisaurri	216	123	93	56.9444444444444	43.0555555555556
22	Huesca	063	22063	Biscarrués	232	123	109	53.0172413793103	46.9827586206897
22	Huesca	064	22064	Blecua y Torres	182	92	90	50.5494505494506	49.4505494505495
22	Huesca	066	22066	Boltaña	855	436	419	50.9941520467836	49.0058479532164
22	Huesca	067	22067	Bonansa	76	40	36	52.6315789473684	47.3684210526316
22	Huesca	068	22068	Borau	74	40	34	54.0540540540541	45.945945945946
22	Huesca	069	22069	Broto	518	266	252	51.3513513513514	48.6486486486487
22	Huesca	072	22072	Caldearenas	259	145	114	55.984555984556	44.015444015444
22	Huesca	074	22074	Campo	342	164	178	47.953216374269	52.046783625731
22	Huesca	075	22075	Camporrélls	248	127	121	51.2096774193548	48.7903225806452
22	Huesca	076	22076	Canal de Berdún	434	238	196	54.8387096774194	45.1612903225806
22	Huesca	077	22077	Candasnos	538	281	257	52.2304832713755	47.7695167286245
22	Huesca	078	22078	Canfranc	531	292	239	54.9905838041431	45.0094161958569
22	Huesca	079	22079	Capdesaso	173	80	93	46.242774566474	53.757225433526
22	Huesca	080	22080	Capella	393	203	190	51.6539440203562	48.3460559796438
22	Huesca	081	22081	Casbas de Huesca	304	161	143	52.9605263157895	47.0394736842105
22	Huesca	082	22082	Castejón del Puente	423	225	198	53.1914893617021	46.8085106382979
22	Huesca	083	22083	Castejón de Monegros	707	357	350	50.4950495049505	49.5049504950495
22	Huesca	084	22084	Castejón de Sos	572	297	275	51.9230769230769	48.0769230769231
22	Huesca	085	22085	Castelflorite	148	76	72	51.3513513513514	48.6486486486487
22	Huesca	086	22086	Castiello de Jaca	185	98	87	52.972972972973	47.027027027027
22	Huesca	087	22087	Castigaleu	102	58	44	56.8627450980392	43.1372549019608
22	Huesca	088	22088	Castillazuelo	230	109	121	47.3913043478261	52.6086956521739
22	Huesca	089	22089	Castillonroy	423	206	217	48.6997635933806	51.3002364066194
22	Huesca	090	22090	Colungo	124	67	57	54.0322580645161	45.9677419354839
22	Huesca	094	22094	Chalamera	159	90	69	56.6037735849057	43.3962264150943
22	Huesca	095	22095	Chía	113	63	50	55.7522123893805	44.2477876106195
22	Huesca	096	22096	Chimillas	186	100	86	53.7634408602151	46.2365591397849
22	Huesca	099	22099	Esplús	756	361	395	47.7513227513228	52.2486772486772
22	Huesca	102	22102	Estada	206	106	100	51.4563106796116	48.5436893203884
22	Huesca	103	22103	Estadilla	913	465	448	50.9309967141292	49.0690032858708
22	Huesca	105	22105	Estopiñán del Castillo	181	100	81	55.2486187845304	44.7513812154696
22	Huesca	106	22106	Fago	39	25	14	64.1025641025641	35.8974358974359
22	Huesca	107	22107	Fanlo	176	100	76	56.8181818181818	43.1818181818182
22	Huesca	109	22109	Fiscal	254	142	112	55.9055118110236	44.0944881889764
22	Huesca	110	22110	Fonz	1113	571	542	51.3027852650494	48.6972147349506
22	Huesca	111	22111	Foradada del Toscar	242	117	125	48.3471074380165	51.6528925619835
22	Huesca	112	22112	Fraga	12000	5999	6001	49.9916666666667	50.0083333333333
22	Huesca	113	22113	Fueva (La)	615	326	289	53.0081300813008	46.9918699186992
22	Huesca	114	22114	Gistaín	175	102	73	58.2857142857143	41.7142857142857
22	Huesca	115	22115	Grado (El)	566	300	266	53.0035335689046	46.9964664310954
22	Huesca	116	22116	Grañén	1966	1010	956	51.3733468972533	48.6266531027467
22	Huesca	117	22117	Graus	3199	1612	1587	50.3907471084714	49.6092528915286
22	Huesca	119	22119	Gurrea de Gállego	1834	938	896	51.1450381679389	48.8549618320611
22	Huesca	122	22122	Hoz de Jaca	77	34	43	44.1558441558442	55.8441558441558
22	Huesca	124	22124	Huerto	263	144	119	54.7528517110266	45.2471482889734
22	Huesca	125	22125	Huesca	45653	22002	23651	48.1939850612227	51.8060149387773
22	Huesca	126	22126	Ibieca	101	50	51	49.5049504950495	50.4950495049505
22	Huesca	127	22127	Igriés	225	114	111	50.6666666666667	49.3333333333333
22	Huesca	128	22128	Ilche	279	146	133	52.3297491039427	47.6702508960574
22	Huesca	129	22129	Isábena	253	130	123	51.3833992094862	48.6166007905138
22	Huesca	130	22130	Jaca	11414	5656	5758	49.5531803048887	50.4468196951113
22	Huesca	131	22131	Jasa	127	73	54	57.4803149606299	42.5196850393701
22	Huesca	133	22133	Labuerda	172	90	82	52.3255813953488	47.6744186046512
22	Huesca	135	22135	Laluenga	266	137	129	51.5037593984962	48.4962406015038
22	Huesca	136	22136	Lalueza	1207	639	568	52.9411764705882	47.0588235294118
22	Huesca	137	22137	Lanaja	1569	812	757	51.7527087316762	48.2472912683238
22	Huesca	139	22139	Laperdiguera	99	49	50	49.4949494949495	50.5050505050505
22	Huesca	141	22141	Lascellas-Ponzano	164	85	79	51.8292682926829	48.1707317073171
22	Huesca	142	22142	Lascuarre	164	90	74	54.8780487804878	45.1219512195122
22	Huesca	143	22143	Laspaúles	290	159	131	54.8275862068966	45.1724137931035
22	Huesca	144	22144	Laspuña	274	149	125	54.3795620437956	45.6204379562044
22	Huesca	149	22149	Loarre	407	215	192	52.8255528255528	47.1744471744472
22	Huesca	150	22150	Loporzano	519	271	248	52.2157996146435	47.7842003853565
22	Huesca	151	22151	Loscorrales	120	67	53	55.8333333333333	44.1666666666667
22	Huesca	155	22155	Monesma y Cajigar	102	51	51	50	50
22	Huesca	156	22156	Monflorite-Lascasas	201	110	91	54.726368159204	45.273631840796
22	Huesca	157	22157	Montanuy	307	174	133	56.6775244299674	43.3224755700326
22	Huesca	158	22158	Monzón	14665	7359	7306	50.1807023525401	49.8192976474599
22	Huesca	160	22160	Naval	295	151	144	51.1864406779661	48.8135593220339
22	Huesca	162	22162	Novales	184	93	91	50.5434782608696	49.4565217391304
22	Huesca	163	22163	Nueno	240	136	104	56.6666666666667	43.3333333333333
22	Huesca	164	22164	Olvena	56	25	31	44.6428571428571	55.3571428571429
22	Huesca	165	22165	Ontiñena	652	326	326	50	50
22	Huesca	167	22167	Osso de Cinca	730	400	330	54.7945205479452	45.2054794520548
22	Huesca	168	22168	Palo	27	15	12	55.5555555555556	44.4444444444444
22	Huesca	170	22170	Panticosa	709	356	353	50.2115655853314	49.7884344146686
22	Huesca	172	22172	Peñalba	795	395	400	49.685534591195	50.314465408805
22	Huesca	173	22173	Peñas de Riglos (Las)	279	157	122	56.2724014336918	43.7275985663082
22	Huesca	174	22174	Peralta de Alcofea	725	358	367	49.3793103448276	50.6206896551724
22	Huesca	175	22175	Peralta de Calasanz	271	148	123	54.6125461254613	45.3874538745388
22	Huesca	176	22176	Peraltilla	169	91	78	53.8461538461539	46.1538461538462
22	Huesca	177	22177	Perarrúa	127	62	65	48.8188976377953	51.1811023622047
22	Huesca	178	22178	Pertusa	153	81	72	52.9411764705882	47.0588235294118
22	Huesca	181	22181	Piracés	100	64	36	64	36
22	Huesca	182	22182	Plan	322	173	149	53.7267080745342	46.2732919254658
22	Huesca	184	22184	Poleñino	260	132	128	50.7692307692308	49.2307692307692
22	Huesca	186	22186	Pozán de Vero	259	123	136	47.4903474903475	52.5096525096525
22	Huesca	187	22187	Puebla de Castro (La)	335	172	163	51.3432835820896	48.6567164179104
22	Huesca	188	22188	Puente de Montañana	127	61	66	48.0314960629921	51.9685039370079
22	Huesca	189	22189	Puértolas	209	115	94	55.0239234449761	44.9760765550239
22	Huesca	190	22190	Pueyo de Araguás (El)	160	100	60	62.5	37.5
22	Huesca	193	22193	Pueyo de Santa Cruz	340	171	169	50.2941176470588	49.7058823529412
22	Huesca	195	22195	Quicena	149	79	70	53.0201342281879	46.9798657718121
22	Huesca	197	22197	Robres	670	347	323	51.7910447761194	48.2089552238806
22	Huesca	199	22199	Sabiñánigo	8483	4287	4196	50.5363668513498	49.4636331486502
22	Huesca	200	22200	Sahún	289	159	130	55.0173010380623	44.9826989619377
22	Huesca	201	22201	Salas Altas	380	196	184	51.5789473684211	48.421052631579
22	Huesca	202	22202	Salas Bajas	142	70	72	49.2957746478873	50.7042253521127
22	Huesca	203	22203	Salillas	117	62	55	52.991452991453	47.008547008547
22	Huesca	204	22204	Sallent de Gállego	1053	550	503	52.2317188983856	47.7682811016144
22	Huesca	205	22205	San Esteban de Litera	604	302	302	50	50
22	Huesca	206	22206	Sangarrén	279	136	143	48.7455197132617	51.2544802867384
22	Huesca	207	22207	San Juan de Plan	152	81	71	53.2894736842105	46.7105263157895
22	Huesca	208	22208	Santa Cilia	170	97	73	57.0588235294118	42.9411764705882
22	Huesca	209	22209	Santa Cruz de la Serós	139	80	59	57.5539568345324	42.4460431654676
22	Huesca	212	22212	Santaliestra y San Quílez	95	54	41	56.8421052631579	43.1578947368421
22	Huesca	213	22213	Sariñena	4021	2019	2002	50.2113902014424	49.7886097985576
22	Huesca	214	22214	Secastilla	162	71	91	43.8271604938272	56.1728395061728
22	Huesca	215	22215	Seira	209	105	104	50.2392344497608	49.7607655502392
22	Huesca	217	22217	Sena	562	295	267	52.491103202847	47.508896797153
22	Huesca	218	22218	Senés de Alcubierre	61	31	30	50.8196721311475	49.1803278688525
22	Huesca	220	22220	Sesa	260	133	127	51.1538461538462	48.8461538461539
22	Huesca	221	22221	Sesué	119	60	59	50.4201680672269	49.5798319327731
22	Huesca	222	22222	Siétamo	366	205	161	56.0109289617486	43.9890710382514
22	Huesca	223	22223	Sopeira	113	57	56	50.4424778761062	49.5575221238938
22	Huesca	225	22225	Tamarite de Litera	3751	1876	1875	50.0133297787257	49.9866702212743
22	Huesca	226	22226	Tardienta	1070	547	523	51.1214953271028	48.8785046728972
22	Huesca	227	22227	Tella-Sin	275	144	131	52.3636363636364	47.6363636363636
22	Huesca	228	22228	Tierz	180	89	91	49.4444444444444	50.5555555555556
22	Huesca	229	22229	Tolva	197	105	92	53.2994923857868	46.7005076142132
22	Huesca	230	22230	Torla	317	168	149	52.9968454258675	47.0031545741325
22	Huesca	232	22232	Torralba de Aragón	126	60	66	47.6190476190476	52.3809523809524
22	Huesca	233	22233	Torre la Ribera	116	65	51	56.0344827586207	43.9655172413793
22	Huesca	234	22234	Torrente de Cinca	1081	538	543	49.7687326549491	50.2312673450509
22	Huesca	235	22235	Torres de Alcanadre	137	80	57	58.3941605839416	41.6058394160584
22	Huesca	236	22236	Torres de Barbués	363	182	181	50.137741046832	49.8622589531681
22	Huesca	239	22239	Tramaced	106	64	42	60.377358490566	39.622641509434
22	Huesca	242	22242	Valfarta	96	55	41	57.2916666666667	42.7083333333333
22	Huesca	243	22243	Valle de Bardají	56	29	27	51.7857142857143	48.2142857142857
22	Huesca	244	22244	Valle de Lierp	59	31	28	52.5423728813559	47.4576271186441
22	Huesca	245	22245	Velilla de Cinca	479	238	241	49.6868475991649	50.3131524008351
22	Huesca	246	22246	Veracruz	111	59	52	53.1531531531532	46.8468468468469
22	Huesca	247	22247	Viacamp y Litera	30	20	10	66.6666666666667	33.3333333333333
22	Huesca	248	22248	Vicién	125	65	60	52	48
22	Huesca	249	22249	Villanova	140	70	70	50	50
22	Huesca	250	22250	Villanúa	345	174	171	50.4347826086956	49.5652173913044
22	Huesca	251	22251	Villanueva de Sigena	508	251	257	49.4094488188976	50.5905511811024
22	Huesca	252	22252	Yebra de Basa	166	96	70	57.8313253012048	42.1686746987952
22	Huesca	253	22253	Yésero	76	40	36	52.6315789473684	47.3684210526316
22	Huesca	254	22254	Zaidín	1669	833	836	49.9101258238466	50.0898741761534
22	Huesca	901	22901	Valle de Hecho	992	512	480	51.6129032258065	48.3870967741936
22	Huesca	902	22902	Puente la Reina de Jaca	232	121	111	52.1551724137931	47.8448275862069
22	Huesca	903	22903	San Miguel del Cinca	915	473	442	51.6939890710382	48.3060109289618
22	Huesca	904	22904	Sotonera (La)	1108	590	518	53.2490974729242	46.7509025270758
22	Huesca	905	22905	Lupiñén-Ortilla	359	191	168	53.2033426183844	46.7966573816156
22	Huesca	906	22906	Santa María de Dulcis	216	112	104	51.8518518518519	48.1481481481482
22	Huesca	907	22907	Aínsa-Sobrarbe	1595	829	766	51.974921630094	48.025078369906
22	Huesca	908	22908	Hoz y Costean	224	127	97	56.6964285714286	43.3035714285714
22	Huesca	909	22909	Vencillón	465	238	227	51.1827956989247	48.8172043010753
23	Jaén	001	23001	Albánchez de Úbeda	1497	760	737	50.7682030728123	49.2317969271877
23	Jaén	002	23002	Alcalá la Real	21599	10627	10972	49.2013519144405	50.7986480855595
23	Jaén	003	23003	Alcaudete	11367	5625	5742	49.4853523357086	50.5146476642914
23	Jaén	004	23004	Aldeaquemada	602	314	288	52.1594684385382	47.8405315614618
23	Jaén	005	23005	Andújar	37621	18559	19062	49.331490391005	50.668509608995
23	Jaén	006	23006	Arjona	5634	2848	2786	50.550230741924	49.449769258076
23	Jaén	007	23007	Arjonilla	3917	1955	1962	49.9106459024764	50.0893540975236
23	Jaén	008	23008	Arquillos	1970	985	985	50	50
23	Jaén	009	23009	Baeza	15738	7720	8018	49.0532469182869	50.9467530817131
23	Jaén	010	23010	Bailén	17472	8903	8569	50.955815018315	49.044184981685
23	Jaén	011	23011	Baños de la Encina	2721	1385	1336	50.9004042631386	49.0995957368614
23	Jaén	012	23012	Beas de Segura	8029	4118	3911	51.2890770955287	48.7109229044713
23	Jaén	014	23014	Begíjar	3136	1573	1563	50.1594387755102	49.8405612244898
23	Jaén	015	23015	Bélmez de la Moraleda	1959	1001	958	51.0974987238387	48.9025012761613
23	Jaén	016	23016	Benatae	574	319	255	55.5749128919861	44.4250871080139
23	Jaén	017	23017	Cabra del Santo Cristo	2250	1149	1101	51.0666666666667	48.9333333333333
23	Jaén	018	23018	Cambil	3108	1638	1470	52.7027027027027	47.2972972972973
23	Jaén	019	23019	Campillo de Arenas	2179	1109	1070	50.8949059201469	49.1050940798531
23	Jaén	020	23020	Canena	2122	1025	1097	48.3034872761546	51.6965127238454
23	Jaén	021	23021	Carboneros	679	336	343	49.4845360824742	50.5154639175258
23	Jaén	024	23024	Carolina (La)	14938	7360	7578	49.2703173115544	50.7296826884456
23	Jaén	025	23025	Castellar	3676	1853	1823	50.4080522306855	49.5919477693145
23	Jaén	026	23026	Castillo de Locubín	5166	2535	2631	49.0708478513357	50.9291521486644
23	Jaén	027	23027	Cazalilla	829	421	408	50.7840772014475	49.2159227985525
23	Jaén	028	23028	Cazorla	8397	4083	4314	48.6245087531261	51.3754912468739
23	Jaén	029	23029	Chiclana de Segura	1346	675	671	50.148588410104	49.851411589896
23	Jaén	030	23030	Chilluévar	1721	852	869	49.5061011040093	50.4938988959907
23	Jaén	031	23031	Escañuela	935	464	471	49.6256684491979	50.3743315508021
23	Jaén	032	23032	Espelúy	788	393	395	49.8730964467005	50.1269035532995
23	Jaén	033	23033	Frailes	1858	948	910	51.0226049515608	48.9773950484392
23	Jaén	034	23034	Fuensanta de Martos	3330	1661	1669	49.8798798798799	50.1201201201201
23	Jaén	035	23035	Fuerte del Rey	1157	576	581	49.7839239412273	50.2160760587727
23	Jaén	037	23037	Génave	691	364	327	52.6772793053546	47.3227206946454
23	Jaén	038	23038	Guardia de Jaén (La)	2062	1074	988	52.0853540252182	47.9146459747818
23	Jaén	039	23039	Guarromán	2802	1376	1426	49.1077801570307	50.8922198429693
23	Jaén	040	23040	Lahiguera	1913	945	968	49.398849973863	50.601150026137
23	Jaén	041	23041	Higuera de Calatrava	691	356	335	51.5195369030391	48.4804630969609
23	Jaén	042	23042	Hinojares	501	239	262	47.7045908183633	52.2954091816367
23	Jaén	043	23043	Hornos	718	347	371	48.3286908077994	51.6713091922006
23	Jaén	044	23044	Huelma	6232	3191	3041	51.2034659820282	48.7965340179718
23	Jaén	045	23045	Huesa	2719	1367	1352	50.2758367046708	49.7241632953292
23	Jaén	046	23046	Ibros	3015	1513	1502	50.1824212271974	49.8175787728026
23	Jaén	047	23047	Iruela (La)	1907	967	940	50.7079181961196	49.2920818038804
23	Jaén	048	23048	Iznatoraf	1218	608	610	49.9178981937603	50.0821018062397
23	Jaén	049	23049	Jabalquinto	2547	1267	1280	49.7447978013349	50.2552021986651
23	Jaén	050	23050	Jaén	110781	53491	57290	48.2853557920582	51.7146442079418
23	Jaén	051	23051	Jamilena	3301	1683	1618	50.9845501363223	49.0154498636777
23	Jaén	052	23052	Jimena	1582	763	819	48.2300884955752	51.7699115044248
23	Jaén	053	23053	Jódar	11805	5848	5957	49.5383312155866	50.4616687844134
23	Jaén	054	23054	Larva	521	273	248	52.3992322456814	47.6007677543186
23	Jaén	055	23055	Linares	58034	28290	29744	48.7472860736809	51.252713926319
23	Jaén	056	23056	Lopera	3978	1953	2025	49.0950226244344	50.9049773755656
23	Jaén	057	23057	Lupión	1050	500	550	47.6190476190476	52.3809523809524
23	Jaén	058	23058	Mancha Real	9012	4616	4396	51.2205947625388	48.7794052374612
23	Jaén	059	23059	Marmolejo	7549	3800	3749	50.3377930851768	49.6622069148232
23	Jaén	060	23060	Martos	22732	10988	11744	48.3371458736583	51.6628541263417
23	Jaén	061	23061	Mengíbar	8339	4181	4158	50.1379062237678	49.8620937762322
23	Jaén	062	23062	Montizón	1969	1010	959	51.2950736414424	48.7049263585576
23	Jaén	063	23063	Navas de San Juan	5155	2552	2603	49.5053346265761	50.4946653734239
23	Jaén	064	23064	Noalejo	2278	1146	1132	50.3072870939421	49.6927129060579
23	Jaén	065	23065	Orcera	2258	1128	1130	49.955713020372	50.044286979628
23	Jaén	066	23066	Peal de Becerro	5310	2633	2677	49.5856873822976	50.4143126177025
23	Jaén	067	23067	Pegalajar	3074	1570	1504	51.0735198438517	48.9264801561483
23	Jaén	069	23069	Porcuna	6941	3470	3471	49.9927964270278	50.0072035729722
23	Jaén	070	23070	Pozo Alcón	5618	2819	2799	50.1779992880029	49.8220007119972
23	Jaén	071	23071	Puente de Génave	1972	974	998	49.3914807302231	50.6085192697769
23	Jaén	072	23072	Puerta de Segura (La)	2677	1339	1338	50.0186776242062	49.9813223757938
23	Jaén	073	23073	Quesada	6089	2995	3094	49.187058630317	50.812941369683
23	Jaén	074	23074	Rus	3747	1870	1877	49.9065919402188	50.0934080597812
23	Jaén	075	23075	Sabiote	4192	2120	2072	50.5725190839695	49.4274809160305
23	Jaén	076	23076	Santa Elena	992	528	464	53.2258064516129	46.7741935483871
23	Jaén	077	23077	Santiago de Calatrava	916	455	461	49.6724890829694	50.3275109170306
23	Jaén	079	23079	Santisteban del Puerto	4863	2472	2391	50.8328192473782	49.1671807526218
23	Jaén	080	23080	Santo Tomé	2315	1164	1151	50.280777537797	49.719222462203
23	Jaén	081	23081	Segura de la Sierra	2204	1103	1101	50.0453720508167	49.9546279491833
23	Jaén	082	23082	Siles	2636	1320	1316	50.0758725341426	49.9241274658574
23	Jaén	084	23084	Sorihuela del Guadalimar	1238	632	606	51.0500807754443	48.9499192245557
23	Jaén	085	23085	Torreblascopedro	2976	1493	1483	50.1680107526882	49.8319892473118
23	Jaén	086	23086	Torre del Campo	13052	6534	6518	50.0612932883849	49.9387067116151
23	Jaén	087	23087	Torredonjimeno	13846	6810	7036	49.1838798208869	50.8161201791131
23	Jaén	088	23088	Torreperogil	7424	3661	3763	49.3130387931034	50.6869612068966
23	Jaén	090	23090	Torres	1816	937	879	51.5969162995595	48.4030837004405
23	Jaén	091	23091	Torres de Albánchez	1021	510	511	49.951028403526	50.048971596474
23	Jaén	092	23092	Úbeda	32456	15815	16641	48.7275080108455	51.2724919891546
23	Jaén	093	23093	Valdepeñas de Jaén	4509	2283	2226	50.6320691949434	49.3679308050566
23	Jaén	094	23094	Vilches	5030	2504	2526	49.7813121272366	50.2186878727634
23	Jaén	095	23095	Villacarrillo	11067	5497	5570	49.6701906569079	50.3298093430921
23	Jaén	096	23096	Villanueva de la Reina	3304	1647	1657	49.8486682808717	50.1513317191283
23	Jaén	097	23097	Villanueva del Arzobispo	8650	4349	4301	50.2774566473988	49.7225433526012
23	Jaén	098	23098	Villardompardo	1258	620	638	49.2845786963434	50.7154213036566
23	Jaén	099	23099	Villares (Los)	4851	2424	2427	49.9690785405071	50.0309214594929
23	Jaén	101	23101	Villarrodrigo	565	279	286	49.3805309734513	50.6194690265487
23	Jaén	901	23901	Cárcheles	1537	756	781	49.1867273910215	50.8132726089785
23	Jaén	902	23902	Bedmar y Garcíez	3268	1641	1627	50.2141982864137	49.7858017135863
23	Jaén	903	23903	Villatorres	4197	2123	2074	50.5837502978318	49.4162497021682
23	Jaén	904	23904	Santiago-Pontones	4425	2250	2175	50.8474576271186	49.1525423728814
24	León	001	24001	Acebedo	284	155	129	54.5774647887324	45.4225352112676
24	León	002	24002	Algadefe	371	187	184	50.4043126684636	49.5956873315364
24	León	003	24003	Alija del Infantado	962	484	478	50.3118503118503	49.6881496881497
24	León	004	24004	Almanza	733	391	342	53.3424283765348	46.6575716234652
24	León	005	24005	Antigua (La)	625	332	293	53.12	46.88
24	León	006	24006	Ardón	683	354	329	51.8301610541728	48.1698389458272
24	León	007	24007	Arganza	959	476	483	49.6350364963504	50.3649635036496
24	León	008	24008	Astorga	12377	5864	6513	47.3782015027874	52.6217984972126
24	León	009	24009	Balboa	460	242	218	52.6086956521739	47.3913043478261
24	León	010	24010	Bañeza (La)	10404	5047	5357	48.5101883890811	51.4898116109189
24	León	011	24011	Barjas	403	219	184	54.3424317617866	45.6575682382134
24	León	012	24012	Barrios de Luna (Los)	347	171	176	49.2795389048991	50.7204610951009
24	León	014	24014	Bembibre	10734	5316	5418	49.5248742314142	50.4751257685858
24	León	015	24015	Benavides	3046	1542	1504	50.623768877216	49.376231122784
24	León	016	24016	Benuza	930	492	438	52.9032258064516	47.0967741935484
24	León	017	24017	Bercianos del Páramo	861	434	427	50.4065040650407	49.5934959349593
24	León	018	24018	Bercianos del Real Camino	221	111	110	50.2262443438914	49.7737556561086
24	León	019	24019	Berlanga del Bierzo	429	201	228	46.8531468531469	53.1468531468532
24	León	020	24020	Boca de Huérgano	600	328	272	54.6666666666667	45.3333333333333
24	León	021	24021	Boñar	2592	1263	1329	48.7268518518519	51.2731481481482
24	León	022	24022	Borrenes	510	259	251	50.7843137254902	49.2156862745098
24	León	023	24023	Brazuelo	347	174	173	50.1440922190202	49.8559077809798
24	León	024	24024	Burgo Ranero (El)	960	507	453	52.8125	47.1875
24	León	025	24025	Burón	404	216	188	53.4653465346535	46.5346534653465
24	León	026	24026	Bustillo del Páramo	1884	947	937	50.2653927813164	49.7346072186837
24	León	027	24027	Cabañas Raras	1320	677	643	51.2878787878788	48.7121212121212
24	León	028	24028	Cabreros del Río	602	311	291	51.6611295681063	48.3388704318937
24	León	029	24029	Cabrillanes	1139	560	579	49.1659350307287	50.8340649692713
24	León	030	24030	Cacabelos	4868	2441	2427	50.1437962202136	49.8562037797864
24	León	031	24031	Calzada del Coto	303	169	134	55.7755775577558	44.2244224422442
24	León	032	24032	Campazas	163	84	79	51.5337423312884	48.4662576687117
24	León	033	24033	Campo de Villavidel	345	177	168	51.304347826087	48.695652173913
24	León	034	24034	Camponaraya	3209	1558	1651	48.5509504518542	51.4490495481458
24	León	036	24036	Candín	444	241	203	54.2792792792793	45.7207207207207
24	León	037	24037	Cármenes	437	227	210	51.9450800915332	48.0549199084668
24	León	038	24038	Carracedelo	3552	1731	1821	48.7331081081081	51.2668918918919
24	León	039	24039	Carrizo	2735	1356	1379	49.5795246800731	50.4204753199269
24	León	040	24040	Carrocera	616	301	315	48.8636363636364	51.1363636363636
24	León	041	24041	Carucedo	665	318	347	47.8195488721804	52.1804511278196
24	León	042	24042	Castilfalé	105	53	52	50.4761904761905	49.5238095238095
24	León	043	24043	Castrillo de Cabrera	191	96	95	50.261780104712	49.738219895288
24	León	044	24044	Castrillo de la Valduerna	238	103	135	43.2773109243698	56.7226890756302
24	León	046	24046	Castrocalbón	1370	696	674	50.8029197080292	49.1970802919708
24	León	047	24047	Castrocontrigo	1186	587	599	49.4940978077572	50.5059021922428
24	León	049	24049	Castropodame	1921	983	938	51.1712649661635	48.8287350338366
24	León	050	24050	Castrotierra de Valmadrigal	155	77	78	49.6774193548387	50.3225806451613
24	León	051	24051	Cea	744	389	355	52.2849462365591	47.7150537634409
24	León	052	24052	Cebanico	250	134	116	53.6	46.4
24	León	053	24053	Cebrones del Río	702	347	355	49.4301994301994	50.5698005698006
24	León	054	24054	Cimanes de la Vega	688	341	347	49.5639534883721	50.4360465116279
24	León	055	24055	Cimanes del Tejar	1011	498	513	49.2581602373887	50.7418397626113
24	León	056	24056	Cistierna	4418	2149	2269	48.6419194205523	51.3580805794477
24	León	057	24057	Congosto	1734	828	906	47.7508650519031	52.2491349480969
24	León	058	24058	Corbillos de los Oteros	295	145	150	49.1525423728814	50.8474576271186
24	León	059	24059	Corullón	1211	607	604	50.1238645747316	49.8761354252684
24	León	060	24060	Crémenes	1098	528	570	48.0874316939891	51.9125683060109
24	León	061	24061	Cuadros	1676	805	871	48.0310262529833	51.9689737470167
24	León	062	24062	Cubillas de los Oteros	214	107	107	50	50
24	León	063	24063	Cubillas de Rueda	640	323	317	50.46875	49.53125
24	León	064	24064	Cubillos del Sil	1520	793	727	52.171052631579	47.8289473684211
24	León	065	24065	Chozas de Abajo	2144	1103	1041	51.4458955223881	48.5541044776119
24	León	066	24066	Destriana	854	405	449	47.423887587822	52.576112412178
24	León	067	24067	Encinedo	1037	525	512	50.6268081002893	49.3731918997107
24	León	068	24068	Ercina (La)	718	353	365	49.1643454038997	50.8356545961003
24	León	069	24069	Escobar de Campos	77	46	31	59.7402597402597	40.2597402597403
24	León	070	24070	Fabero	5924	2942	2982	49.66239027684	50.33760972316
24	León	071	24071	Folgoso de la Ribera	1364	663	701	48.6070381231672	51.3929618768328
24	León	073	24073	Fresno de la Vega	693	351	342	50.6493506493506	49.3506493506493
24	León	074	24074	Fuentes de Carbajal	136	71	65	52.2058823529412	47.7941176470588
24	León	076	24076	Garrafe de Torío	1191	602	589	50.5457598656591	49.4542401343409
24	León	077	24077	Gordaliza del Pino	353	177	176	50.1416430594901	49.8583569405099
24	León	078	24078	Gordoncillo	625	305	320	48.8	51.2
24	León	079	24079	Gradefes	1342	652	690	48.5842026825633	51.4157973174367
24	León	080	24080	Grajal de Campos	306	134	172	43.7908496732026	56.2091503267974
24	León	081	24081	Gusendos de los Oteros	213	108	105	50.7042253521127	49.2957746478873
24	León	082	24082	Hospital de Órbigo	1127	551	576	48.8908606921029	51.1091393078971
24	León	083	24083	Igüeña	1950	1015	935	52.0512820512821	47.948717948718
24	León	084	24084	Izagre	266	131	135	49.2481203007519	50.7518796992481
24	León	086	24086	Joarilla de las Matas	439	229	210	52.1640091116173	47.8359908883827
24	León	087	24087	Laguna Dalga	916	461	455	50.3275109170306	49.6724890829694
24	León	088	24088	Laguna de Negrillos	1537	777	760	50.5530253741054	49.4469746258946
24	León	089	24089	León	138006	64391	73615	46.6581163137835	53.3418836862165
24	León	090	24090	Lucillo	530	267	263	50.377358490566	49.622641509434
24	León	091	24091	Luyego	1006	480	526	47.713717693837	52.286282306163
24	León	092	24092	Llamas de la Ribera	1214	616	598	50.7413509060955	49.2586490939045
24	León	093	24093	Magaz de Cepeda	518	244	274	47.1042471042471	52.8957528957529
24	León	094	24094	Mansilla de las Mulas	1756	891	865	50.7403189066059	49.2596810933941
24	León	095	24095	Mansilla Mayor	424	210	214	49.5283018867925	50.4716981132076
24	León	096	24096	Maraña	181	94	87	51.9337016574586	48.0662983425414
24	León	097	24097	Matadeón de los Oteros	305	158	147	51.8032786885246	48.1967213114754
24	León	098	24098	Matallana de Torío	1691	842	849	49.7930218805441	50.2069781194559
24	León	099	24099	Matanza	297	150	147	50.5050505050505	49.4949494949495
24	León	100	24100	Molinaseca	783	407	376	51.9795657726692	48.0204342273308
24	León	101	24101	Murias de Paredes	657	303	354	46.1187214611872	53.8812785388128
24	León	102	24102	Noceda	936	465	471	49.6794871794872	50.3205128205128
24	León	103	24103	Oencia	531	289	242	54.4256120527307	45.5743879472693
24	León	104	24104	Omañas (Las)	446	228	218	51.1210762331839	48.8789237668162
24	León	105	24105	Onzonilla	1440	719	721	49.9305555555556	50.0694444444444
24	León	106	24106	Oseja de Sajambre	360	200	160	55.5555555555556	44.4444444444444
24	León	107	24107	Pajares de los Oteros	362	188	174	51.9337016574586	48.0662983425414
24	León	108	24108	Palacios de la Valduerna	549	256	293	46.6302367941712	53.3697632058288
24	León	109	24109	Palacios del Sil	1470	749	721	50.952380952381	49.047619047619
24	León	110	24110	Páramo del Sil	1831	930	901	50.791916985254	49.208083014746
24	León	112	24112	Peranzanes	344	190	154	55.2325581395349	44.7674418604651
24	León	113	24113	Pobladura de Pelayo García	584	295	289	50.513698630137	49.486301369863
24	León	114	24114	Pola de Gordón (La)	4974	2400	2574	48.2509047044632	51.7490952955368
24	León	115	24115	Ponferrada	62642	30472	32170	48.6446792886562	51.3553207113438
24	León	116	24116	Posada de Valdeón	490	264	226	53.8775510204082	46.1224489795918
24	León	117	24117	Pozuelo del Páramo	642	332	310	51.7133956386293	48.2866043613707
24	León	118	24118	Prado de la Guzpeña	168	88	80	52.3809523809524	47.6190476190476
24	León	119	24119	Priaranza del Bierzo	974	496	478	50.9240246406571	49.0759753593429
24	León	120	24120	Prioro	461	241	220	52.2776572668113	47.7223427331887
24	León	121	24121	Puebla de Lillo	733	385	348	52.5238744884038	47.4761255115962
24	León	122	24122	Puente de Domingo Flórez	1985	1050	935	52.896725440806	47.103274559194
24	León	123	24123	Quintana del Castillo	1133	597	536	52.6919682259488	47.3080317740512
24	León	124	24124	Quintana del Marco	541	278	263	51.3863216266174	48.6136783733826
24	León	125	24125	Quintana y Congosto	814	413	401	50.7371007371007	49.2628992628993
24	León	127	24127	Regueras de Arriba	404	209	195	51.7326732673267	48.2673267326733
24	León	129	24129	Reyero	156	81	75	51.9230769230769	48.0769230769231
24	León	130	24130	Riaño	627	344	283	54.8644338118022	45.1355661881978
24	León	131	24131	Riego de la Vega	1144	557	587	48.6888111888112	51.3111888111888
24	León	132	24132	Riello	977	508	469	51.9959058341863	48.0040941658137
24	León	133	24133	Rioseco de Tapia	566	300	266	53.0035335689046	46.9964664310954
24	León	134	24134	Robla (La)	5035	2492	2543	49.493545183714	50.506454816286
24	León	136	24136	Roperuelos del Páramo	823	407	416	49.453219927096	50.546780072904
24	León	137	24137	Sabero	1876	922	954	49.1471215351812	50.8528784648188
24	León	139	24139	Sahagún	3112	1487	1625	47.7827763496144	52.2172236503856
24	León	141	24141	San Adrián del Valle	159	74	85	46.5408805031447	53.4591194968554
24	León	142	24142	San Andrés del Rabanedo	24212	11779	12433	48.6494300346936	51.3505699653065
24	León	143	24143	Sancedo	593	299	294	50.4215851602024	49.5784148397976
24	León	144	24144	San Cristóbal de la Polantera	1091	550	541	50.4124656278643	49.5875343721357
24	León	145	24145	San Emiliano	911	466	445	51.152579582876	48.847420417124
24	León	146	24146	San Esteban de Nogales	358	164	194	45.8100558659218	54.1899441340782
24	León	148	24148	San Justo de la Vega	2289	1163	1126	50.8082131935343	49.1917868064657
24	León	149	24149	San Millán de los Caballeros	193	98	95	50.7772020725389	49.2227979274611
24	León	150	24150	San Pedro Bercianos	389	198	191	50.8997429305913	49.1002570694087
24	León	151	24151	Santa Colomba de Curueño	634	306	328	48.2649842271293	51.7350157728707
24	León	152	24152	Santa Colomba de Somoza	464	235	229	50.6465517241379	49.3534482758621
24	León	153	24153	Santa Cristina de Valmadrigal	366	191	175	52.1857923497268	47.8142076502732
24	León	154	24154	Santa Elena de Jamuz	1401	712	689	50.8208422555318	49.1791577444682
24	León	155	24155	Santa María de la Isla	705	369	336	52.3404255319149	47.6595744680851
24	León	156	24156	Santa María del Monte de Cea	398	193	205	48.4924623115578	51.5075376884422
24	León	157	24157	Santa María del Páramo	3173	1552	1621	48.9127009139616	51.0872990860385
24	León	158	24158	Santa María de Ordás	431	208	223	48.2598607888631	51.7401392111369
24	León	159	24159	Santa Marina del Rey	2594	1283	1311	49.4602929838088	50.5397070161912
24	León	160	24160	Santas Martas	1014	526	488	51.8737672583826	48.1262327416174
24	León	161	24161	Santiago Millas	351	179	172	50.997150997151	49.002849002849
24	León	162	24162	Santovenia de la Valdoncina	1698	835	863	49.1755005889282	50.8244994110718
24	León	163	24163	Sariegos	2230	1127	1103	50.5381165919283	49.4618834080718
24	León	164	24164	Sena de Luna	499	247	252	49.498997995992	50.501002004008
24	León	165	24165	Sobrado	559	291	268	52.0572450805009	47.9427549194991
24	León	166	24166	Soto de la Vega	1999	1014	985	50.7253626813407	49.2746373186593
24	León	167	24167	Soto y Amío	1074	518	556	48.2309124767225	51.7690875232775
24	León	168	24168	Toral de los Guzmanes	697	357	340	51.219512195122	48.7804878048781
24	León	169	24169	Toreno	4330	2207	2123	50.9699769053118	49.0300230946882
24	León	170	24170	Torre del Bierzo	3165	1589	1576	50.2053712480253	49.7946287519747
24	León	171	24171	Trabadelo	565	296	269	52.3893805309734	47.6106194690266
24	León	172	24172	Truchas	777	381	396	49.034749034749	50.965250965251
24	León	173	24173	Turcia	1322	659	663	49.8487140695915	50.1512859304085
24	León	174	24174	Urdiales del Páramo	719	372	347	51.7385257301808	48.2614742698192
24	León	175	24175	Valdefresno	1761	908	853	51.5616127200454	48.4383872799546
24	León	176	24176	Valdefuentes del Páramo	441	229	212	51.9274376417234	48.0725623582766
24	León	177	24177	Valdelugueros	442	246	196	55.6561085972851	44.3438914027149
24	León	178	24178	Valdemora	126	57	69	45.2380952380952	54.7619047619048
24	León	179	24179	Valdepiélago	435	219	216	50.3448275862069	49.6551724137931
24	León	180	24180	Valdepolo	1611	843	768	52.3277467411546	47.6722532588454
24	León	181	24181	Valderas	2174	1105	1069	50.8279668813247	49.1720331186753
24	León	182	24182	Valderrey	649	318	331	48.9984591679507	51.0015408320493
24	León	183	24183	Valderrueda	1278	648	630	50.7042253521127	49.2957746478873
24	León	184	24184	Valdesamario	278	137	141	49.2805755395684	50.7194244604317
24	León	185	24185	Val de San Lorenzo	767	368	399	47.9791395045632	52.0208604954368
24	León	187	24187	Valdevimbre	1208	615	593	50.9105960264901	49.0894039735099
24	León	188	24188	Valencia de Don Juan	4064	2016	2048	49.6062992125984	50.3937007874016
24	León	189	24189	Valverde de la Virgen	4152	2083	2069	50.1685934489403	49.8314065510597
24	León	190	24190	Valverde-Enrique	219	108	111	49.3150684931507	50.6849315068493
24	León	191	24191	Vallecillo	171	89	82	52.046783625731	47.953216374269
24	León	193	24193	Vecilla (La)	422	219	203	51.8957345971564	48.1042654028436
24	León	194	24194	Vegacervera	376	193	183	51.3297872340426	48.6702127659575
24	León	196	24196	Vega de Espinareda	2960	1479	1481	49.9662162162162	50.0337837837838
24	León	197	24197	Vega de Infanzones	892	436	456	48.8789237668162	51.1210762331839
24	León	198	24198	Vega de Valcarce	874	440	434	50.3432494279176	49.6567505720824
24	León	199	24199	Vegaquemada	548	263	285	47.992700729927	52.007299270073
24	León	201	24201	Vegas del Condado	1392	735	657	52.801724137931	47.198275862069
24	León	202	24202	Villablino	14169	7120	7049	50.2505469687346	49.7494530312654
24	León	203	24203	Villabraz	152	78	74	51.3157894736842	48.6842105263158
24	León	205	24205	Villadangos del Páramo	1024	513	511	50.09765625	49.90234375
24	León	206	24206	Villadecanes	2325	1161	1164	49.9354838709677	50.0645161290323
24	León	207	24207	Villademor de la Vega	465	247	218	53.1182795698925	46.8817204301075
24	León	209	24209	Villafranca del Bierzo	3807	1886	1921	49.5403204623063	50.4596795376937
24	León	210	24210	Villagatón	872	442	430	50.6880733944954	49.3119266055046
24	León	211	24211	Villamandos	435	207	228	47.5862068965517	52.4137931034483
24	León	212	24212	Villamañán	1437	717	720	49.8956158663883	50.1043841336117
24	León	213	24213	Villamartín de Don Sancho	194	101	93	52.0618556701031	47.9381443298969
24	León	214	24214	Villamejil	993	494	499	49.7482376636455	50.2517623363545
24	León	215	24215	Villamol	252	126	126	50	50
24	León	216	24216	Villamontán de la Valduerna	1109	560	549	50.4959422903517	49.5040577096483
24	León	217	24217	Villamoratiel de las Matas	185	110	75	59.4594594594595	40.5405405405405
24	León	218	24218	Villanueva de las Manzanas	608	296	312	48.6842105263158	51.3157894736842
24	León	219	24219	Villaobispo de Otero	718	360	358	50.1392757660167	49.8607242339833
24	León	221	24221	Villaquejida	1086	563	523	51.841620626151	48.158379373849
24	León	222	24222	Villaquilambre	8070	4041	4029	50.0743494423792	49.9256505576208
24	León	223	24223	Villarejo de Órbigo	3434	1670	1764	48.6313337216075	51.3686662783926
24	León	224	24224	Villares de Órbigo	953	484	469	50.7869884575026	49.2130115424974
24	León	225	24225	Villasabariego	1239	618	621	49.8789346246973	50.1210653753027
24	León	226	24226	Villaselán	321	173	148	53.8940809968847	46.1059190031153
24	León	227	24227	Villaturiel	1813	953	860	52.5648097076668	47.4351902923332
24	León	228	24228	Villazala	1052	547	505	51.9961977186312	48.0038022813688
24	León	229	24229	Villazanzo de Valderaduey	721	384	337	53.2593619972261	46.7406380027739
24	León	230	24230	Zotes del Páramo	665	355	310	53.3834586466165	46.6165413533835
24	León	901	24901	Villamanín	1301	645	656	49.5772482705611	50.4227517294389
24	León	902	24902	Villaornate y Castro	554	301	253	54.3321299638989	45.6678700361011
25	Lleida	001	25001	Abella de la Conca	197	106	91	53.8071065989848	46.1928934010152
25	Lleida	002	25002	Àger	528	284	244	53.7878787878788	46.2121212121212
25	Lleida	003	25003	Agramunt	4902	2506	2396	51.1219910240718	48.8780089759282
25	Lleida	004	25004	Alamús (Els)	698	350	348	50.1432664756447	49.8567335243553
25	Lleida	005	25005	Alàs i Cerc	400	213	187	53.25	46.75
25	Lleida	006	25006	Albagés (L')	510	265	245	51.9607843137255	48.0392156862745
25	Lleida	007	25007	Albatàrrec	1130	567	563	50.1769911504425	49.8230088495575
25	Lleida	008	25008	Albesa	1494	738	756	49.3975903614458	50.6024096385542
25	Lleida	009	25009	Albi (L')	782	407	375	52.0460358056266	47.9539641943734
25	Lleida	010	25010	Alcanó	259	133	126	51.3513513513514	48.6486486486487
25	Lleida	011	25011	Alcarràs	4767	2393	2374	50.1992867631634	49.8007132368366
25	Lleida	012	25012	Alcoletge	1770	919	851	51.9209039548023	48.0790960451977
25	Lleida	013	25013	Alfarràs	2905	1414	1491	48.6746987951807	51.3253012048193
25	Lleida	014	25014	Alfés	328	171	157	52.1341463414634	47.8658536585366
25	Lleida	015	25015	Algerri	521	254	267	48.7523992322457	51.2476007677543
25	Lleida	016	25016	Alguaire	2807	1425	1382	50.7659422871393	49.2340577128607
25	Lleida	017	25017	Alins	272	136	136	50	50
25	Lleida	019	25019	Almacelles	5564	2813	2751	50.5571531272466	49.4428468727534
25	Lleida	020	25020	Almatret	484	253	231	52.2727272727273	47.7272727272727
25	Lleida	021	25021	Almenar	3441	1763	1678	51.2351060738158	48.7648939261843
25	Lleida	022	25022	Alòs de Balaguer	187	109	78	58.2887700534759	41.7112299465241
25	Lleida	023	25023	Alpicat	4016	2005	2011	49.9252988047809	50.0747011952191
25	Lleida	024	25024	Alt Àneu	411	227	184	55.2311435523114	44.7688564476886
25	Lleida	025	25025	Naut Aran	1480	777	703	52.5	47.5
25	Lleida	027	25027	Anglesola	1277	652	625	51.0571652310102	48.9428347689898
25	Lleida	029	25029	Arbeca	2384	1220	1164	51.1744966442953	48.8255033557047
25	Lleida	030	25030	Pont de Bar (El)	160	88	72	55	45
25	Lleida	031	25031	Arres	63	32	31	50.7936507936508	49.2063492063492
25	Lleida	032	25032	Arsèguel	108	58	50	53.7037037037037	46.2962962962963
25	Lleida	033	25033	Artesa de Lleida	1326	683	643	51.5082956259427	48.4917043740573
25	Lleida	034	25034	Artesa de Segre	3169	1624	1545	51.2464499842222	48.7535500157779
25	Lleida	035	25035	Sentiu de Sió (La)	474	230	244	48.5232067510549	51.4767932489452
25	Lleida	036	25036	Aspa	267	135	132	50.561797752809	49.438202247191
25	Lleida	037	25037	Avellanes i Santa Linya (Les)	483	257	226	53.2091097308489	46.7908902691511
25	Lleida	038	25038	Aitona	2186	1086	1100	49.67978042086	50.32021957914
25	Lleida	039	25039	Baix Pallars	363	207	156	57.0247933884298	42.9752066115703
25	Lleida	040	25040	Balaguer	13275	6509	6766	49.0320150659134	50.9679849340866
25	Lleida	041	25041	Barbens	787	403	384	51.2071156289708	48.7928843710292
25	Lleida	042	25042	Baronia de Rialb (La)	266	139	127	52.2556390977444	47.7443609022556
25	Lleida	043	25043	Vall de Boí (La)	870	481	389	55.2873563218391	44.7126436781609
25	Lleida	044	25044	Bassella	308	156	152	50.6493506493506	49.3506493506493
25	Lleida	045	25045	Bausen	62	36	26	58.0645161290323	41.9354838709677
25	Lleida	046	25046	Belianes	550	260	290	47.2727272727273	52.7272727272727
25	Lleida	047	25047	Bellcaire d'Urgell	1307	626	681	47.8959449120122	52.1040550879878
25	Lleida	048	25048	Bell-lloc d'Urgell	2124	1050	1074	49.4350282485876	50.5649717514124
25	Lleida	049	25049	Bellmunt d'Urgell	231	113	118	48.9177489177489	51.0822510822511
25	Lleida	050	25050	Bellpuig	4041	2009	2032	49.715416975996	50.284583024004
25	Lleida	051	25051	Bellver de Cerdanya	1614	861	753	53.3457249070632	46.6542750929368
25	Lleida	052	25052	Bellvís	2173	1067	1106	49.1026231017027	50.8973768982973
25	Lleida	053	25053	Benavent de Segrià	904	469	435	51.8805309734513	48.1194690265487
25	Lleida	055	25055	Biosca	247	126	121	51.0121457489879	48.9878542510122
25	Lleida	056	25056	Bovera	396	202	194	51.010101010101	48.989898989899
25	Lleida	057	25057	Bòrdes (Es)	212	111	101	52.3584905660377	47.6415094339623
25	Lleida	058	25058	Borges Blanques (Les)	5212	2601	2611	49.9040675364543	50.0959324635457
25	Lleida	059	25059	Bossòst	866	434	432	50.1154734411086	49.8845265588915
25	Lleida	060	25060	Cabanabona	98	49	49	50	50
25	Lleida	061	25061	Cabó	123	71	52	57.7235772357724	42.2764227642277
25	Lleida	062	25062	Camarasa	885	449	436	50.7344632768362	49.2655367231638
25	Lleida	063	25063	Canejan	108	52	56	48.1481481481482	51.8518518518519
25	Lleida	064	25064	Castellar de la Ribera	153	70	83	45.7516339869281	54.2483660130719
25	Lleida	067	25067	Castelldans	959	483	476	50.3649635036496	49.6350364963504
25	Lleida	068	25068	Castellnou de Seana	701	362	339	51.6405135520685	48.3594864479315
25	Lleida	069	25069	Castelló de Farfanya	587	298	289	50.7666098807496	49.2333901192504
25	Lleida	070	25070	Castellserà	1107	541	566	48.8708220415538	51.1291779584463
25	Lleida	071	25071	Cava	57	34	23	59.6491228070175	40.3508771929825
25	Lleida	072	25072	Cervera	7437	3659	3778	49.1999462148716	50.8000537851284
25	Lleida	073	25073	Cervià de les Garrigues	845	438	407	51.8343195266272	48.1656804733728
25	Lleida	074	25074	Ciutadilla	213	108	105	50.7042253521127	49.2957746478873
25	Lleida	075	25075	Clariana de Cardener	145	75	70	51.7241379310345	48.2758620689655
25	Lleida	076	25076	Cogul (El)	232	121	111	52.1551724137931	47.8448275862069
25	Lleida	077	25077	Coll de Nargó	606	323	283	53.3003300330033	46.6996699669967
25	Lleida	078	25078	Corbins	1055	537	518	50.9004739336493	49.0995260663507
25	Lleida	079	25079	Cubells	382	194	188	50.7853403141361	49.2146596858639
25	Lleida	081	25081	Espluga Calba (L')	424	222	202	52.3584905660377	47.6415094339623
25	Lleida	082	25082	Espot	298	162	136	54.3624161073826	45.6375838926174
25	Lleida	085	25085	Estaràs	187	103	84	55.0802139037433	44.9197860962567
25	Lleida	086	25086	Esterri d'Àneu	646	319	327	49.3808049535604	50.6191950464396
25	Lleida	087	25087	Esterri de Cardós	75	40	35	53.3333333333333	46.6666666666667
25	Lleida	088	25088	Estamariu	123	66	57	53.6585365853659	46.3414634146342
25	Lleida	089	25089	Farrera	97	57	40	58.7628865979382	41.2371134020619
25	Lleida	092	25092	Floresta (La)	177	96	81	54.2372881355932	45.7627118644068
25	Lleida	093	25093	Fondarella	680	343	337	50.4411764705882	49.5588235294118
25	Lleida	094	25094	Foradada	215	125	90	58.1395348837209	41.8604651162791
25	Lleida	096	25096	Fuliola (La)	1251	630	621	50.3597122302158	49.6402877697842
25	Lleida	097	25097	Fulleda	116	61	55	52.5862068965517	47.4137931034483
25	Lleida	098	25098	Gavet de la Conca	322	159	163	49.3788819875776	50.6211180124224
25	Lleida	099	25099	Golmés	1336	644	692	48.2035928143713	51.7964071856287
25	Lleida	100	25100	Gósol	225	125	100	55.5555555555556	44.4444444444444
25	Lleida	101	25101	Granadella (La)	810	420	390	51.8518518518519	48.1481481481482
25	Lleida	102	25102	Granja d'Escarp (La)	1100	586	514	53.2727272727273	46.7272727272727
25	Lleida	103	25103	Granyanella	150	77	73	51.3333333333333	48.6666666666667
25	Lleida	104	25104	Granyena de Segarra	158	82	76	51.8987341772152	48.1012658227848
25	Lleida	105	25105	Granyena de les Garrigues	170	86	84	50.5882352941176	49.4117647058824
25	Lleida	109	25109	Guimerà	399	202	197	50.6265664160401	49.3734335839599
25	Lleida	110	25110	Guissona	3339	1700	1639	50.9134471398622	49.0865528601378
25	Lleida	111	25111	Guixers	151	91	60	60.2649006622517	39.7350993377483
25	Lleida	112	25112	Ivars de Noguera	338	171	167	50.5917159763314	49.4082840236686
25	Lleida	113	25113	Ivars d'Urgell	1764	907	857	51.4172335600907	48.5827664399093
25	Lleida	114	25114	Ivorra	153	72	81	47.0588235294118	52.9411764705882
25	Lleida	115	25115	Isona i Conca Dellà	1222	650	572	53.1914893617021	46.8085106382979
25	Lleida	118	25118	Juncosa	629	360	269	57.2337042925278	42.7662957074722
25	Lleida	119	25119	Juneda	2988	1503	1485	50.3012048192771	49.6987951807229
25	Lleida	120	25120	Lleida	112194	54537	57657	48.6095513129044	51.3904486870956
25	Lleida	121	25121	Les	697	351	346	50.3586800573888	49.6413199426112
25	Lleida	122	25122	Linyola	2401	1192	1209	49.6459808413161	50.3540191586839
25	Lleida	123	25123	Lladorre	234	119	115	50.8547008547009	49.1452991452991
25	Lleida	124	25124	Lladurs	244	128	116	52.4590163934426	47.5409836065574
25	Lleida	125	25125	Llardecans	625	322	303	51.52	48.48
25	Lleida	126	25126	Llavorsí	285	141	144	49.4736842105263	50.5263157894737
25	Lleida	127	25127	Lles de Cerdanya	288	161	127	55.9027777777778	44.0972222222222
25	Lleida	128	25128	Llimiana	147	81	66	55.1020408163265	44.8979591836735
25	Lleida	129	25129	Llobera	237	122	115	51.4767932489452	48.5232067510549
25	Lleida	130	25130	Maldà	292	153	139	52.3972602739726	47.6027397260274
25	Lleida	131	25131	Massalcoreig	638	305	333	47.8056426332288	52.1943573667712
25	Lleida	132	25132	Massoteres	183	95	88	51.9125683060109	48.0874316939891
25	Lleida	133	25133	Maials	985	493	492	50.0507614213198	49.9492385786802
25	Lleida	134	25134	Menàrguens	806	412	394	51.1166253101737	48.8833746898263
25	Lleida	135	25135	Miralcamp	1250	598	652	47.84	52.16
25	Lleida	136	25136	Molsosa (La)	133	68	65	51.1278195488722	48.8721804511278
25	Lleida	137	25137	Mollerussa	9581	4749	4832	49.5668510593884	50.4331489406116
25	Lleida	138	25138	Montgai	789	402	387	50.9505703422053	49.0494296577947
25	Lleida	139	25139	Montellà i Martinet	507	265	242	52.2682445759369	47.7317554240631
25	Lleida	140	25140	Montferrer i Castellbò	738	405	333	54.8780487804878	45.1219512195122
25	Lleida	141	25141	Montoliu de Segarra	192	109	83	56.7708333333333	43.2291666666667
25	Lleida	142	25142	Montoliu de Lleida	479	235	244	49.0605427974948	50.9394572025052
25	Lleida	143	25143	Montornès de Segarra	104	48	56	46.1538461538462	53.8461538461539
25	Lleida	145	25145	Nalec	105	50	55	47.6190476190476	52.3809523809524
25	Lleida	146	25146	Navès	272	131	141	48.1617647058824	51.8382352941177
25	Lleida	148	25148	Odèn	279	159	120	56.989247311828	43.010752688172
25	Lleida	149	25149	Oliana	1864	943	921	50.5901287553648	49.4098712446352
25	Lleida	150	25150	Oliola	227	125	102	55.0660792951542	44.9339207048458
25	Lleida	151	25151	Olius	555	282	273	50.8108108108108	49.1891891891892
25	Lleida	152	25152	Oluges (Les)	187	95	92	50.8021390374332	49.1978609625668
25	Lleida	153	25153	Omellons (Els)	264	135	129	51.1363636363636	48.8636363636364
25	Lleida	154	25154	Omells de na Gaia (Els)	152	82	70	53.9473684210526	46.0526315789474
25	Lleida	155	25155	Organyà	992	507	485	51.1088709677419	48.8911290322581
25	Lleida	156	25156	Os de Balaguer	768	401	367	52.2135416666667	47.7864583333333
25	Lleida	157	25157	Ossó de Sió	233	119	114	51.0729613733906	48.9270386266094
25	Lleida	158	25158	Palau d'Anglesola (El)	1682	831	851	49.4054696789536	50.5945303210464
25	Lleida	161	25161	Conca de Dalt	419	218	201	52.0286396181384	47.9713603818616
25	Lleida	163	25163	Coma i la Pedra (La)	240	147	93	61.25	38.75
25	Lleida	164	25164	Penelles	536	293	243	54.6641791044776	45.3358208955224
25	Lleida	165	25165	Peramola	394	212	182	53.8071065989848	46.1928934010152
25	Lleida	166	25166	Pinell de Solsonès	225	120	105	53.3333333333333	46.6666666666667
25	Lleida	167	25167	Pinós	320	174	146	54.375	45.625
25	Lleida	168	25168	Poal (El)	613	330	283	53.8336052202284	46.1663947797716
25	Lleida	169	25169	Pobla de Cérvoles (La)	212	119	93	56.1320754716981	43.8679245283019
25	Lleida	170	25170	Bellaguarda	354	174	180	49.1525423728814	50.8474576271186
25	Lleida	171	25171	Pobla de Segur (La)	2852	1385	1467	48.562412342216	51.437587657784
25	Lleida	172	25172	Ponts	2382	1204	1178	50.5457598656591	49.4542401343409
25	Lleida	173	25173	Pont de Suert (El)	2164	1094	1070	50.5545286506469	49.4454713493531
25	Lleida	174	25174	Portella (La)	576	311	265	53.9930555555556	46.0069444444444
25	Lleida	175	25175	Prats i Sansor	212	115	97	54.2452830188679	45.7547169811321
25	Lleida	176	25176	Preixana	440	216	224	49.0909090909091	50.9090909090909
25	Lleida	177	25177	Preixens	523	250	273	47.8011472275335	52.1988527724665
25	Lleida	179	25179	Prullans	219	116	103	52.9680365296804	47.0319634703196
25	Lleida	180	25180	Puiggròs	261	137	124	52.4904214559387	47.5095785440613
25	Lleida	181	25181	Puigverd d'Agramunt	243	136	107	55.9670781893004	44.0329218106996
25	Lleida	182	25182	Puigverd de Lleida	1043	511	532	48.993288590604	51.006711409396
25	Lleida	183	25183	Rialp	517	272	245	52.6112185686654	47.3887814313346
25	Lleida	185	25185	Ribera d'Urgellet	811	423	388	52.1578298397041	47.8421701602959
25	Lleida	186	25186	Riner	286	150	136	52.4475524475525	47.5524475524476
25	Lleida	189	25189	Rosselló	1852	903	949	48.7580993520518	51.2419006479482
25	Lleida	190	25190	Salàs de Pallars	330	163	167	49.3939393939394	50.6060606060606
25	Lleida	191	25191	Sanaüja	464	225	239	48.4913793103448	51.5086206896552
25	Lleida	192	25192	Sant Guim de Freixenet	1046	506	540	48.3747609942639	51.6252390057361
25	Lleida	193	25193	Sant Llorenç de Morunys	900	457	443	50.7777777777778	49.2222222222222
25	Lleida	194	25194	Sant Ramon	556	277	279	49.8201438848921	50.1798561151079
25	Lleida	196	25196	Sant Esteve de la Sarga	117	72	45	61.5384615384615	38.4615384615385
25	Lleida	197	25197	Sant Guim de la Plana	189	100	89	52.9100529100529	47.0899470899471
25	Lleida	200	25200	Sarroca de Lleida	481	242	239	50.3118503118503	49.6881496881497
25	Lleida	201	25201	Sarroca de Bellera	155	87	68	56.1290322580645	43.8709677419355
25	Lleida	202	25202	Senterada	112	59	53	52.6785714285714	47.3214285714286
25	Lleida	203	25203	Seu d'Urgell (La)	10943	5305	5638	48.4784793932194	51.5215206067806
25	Lleida	204	25204	Seròs	1737	927	810	53.3678756476684	46.6321243523316
25	Lleida	205	25205	Sidamon	527	264	263	50.0948766603416	49.9051233396584
25	Lleida	206	25206	Soleràs (El)	418	215	203	51.4354066985646	48.5645933014354
25	Lleida	207	25207	Solsona	7343	3649	3694	49.6935857279041	50.3064142720959
25	Lleida	208	25208	Soriguera	308	158	150	51.2987012987013	48.7012987012987
25	Lleida	209	25209	Sort	1791	897	894	50.0837520938024	49.9162479061977
25	Lleida	210	25210	Soses	1537	801	736	52.1145087833442	47.8854912166558
25	Lleida	211	25211	Sudanell	712	385	327	54.0730337078652	45.9269662921348
25	Lleida	212	25212	Sunyer	300	148	152	49.3333333333333	50.6666666666667
25	Lleida	215	25215	Talarn	364	184	180	50.5494505494506	49.4505494505495
25	Lleida	216	25216	Talavera	296	155	141	52.3648648648649	47.6351351351351
25	Lleida	217	25217	Tàrrega	12548	6063	6485	48.3184571246414	51.6815428753586
25	Lleida	218	25218	Tarrés	105	58	47	55.2380952380952	44.7619047619048
25	Lleida	219	25219	Tarroja de Segarra	178	88	90	49.438202247191	50.561797752809
25	Lleida	220	25220	Térmens	1404	706	698	50.2849002849003	49.7150997150997
25	Lleida	221	25221	Tírvia	122	67	55	54.9180327868853	45.0819672131148
25	Lleida	222	25222	Tiurana	23	16	7	69.5652173913043	30.4347826086957
25	Lleida	223	25223	Torà	1191	599	592	50.2938706968934	49.7061293031066
25	Lleida	224	25224	Torms (Els)	197	106	91	53.8071065989848	46.1928934010152
25	Lleida	225	25225	Tornabous	820	415	405	50.609756097561	49.390243902439
25	Lleida	226	25226	Torrebesses	323	159	164	49.2260061919505	50.7739938080495
25	Lleida	227	25227	Torre de Cabdella (La)	679	339	340	49.9263622974963	50.0736377025037
25	Lleida	228	25228	Torrefarrera	1734	884	850	50.9803921568627	49.0196078431373
25	Lleida	230	25230	Torregrossa	2242	1107	1135	49.3755575379126	50.6244424620874
25	Lleida	231	25231	Torrelameu	578	317	261	54.8442906574394	45.1557093425606
25	Lleida	232	25232	Torres de Segre	1815	932	883	51.3498622589532	48.6501377410468
25	Lleida	233	25233	Torre-serona	326	162	164	49.6932515337423	50.3067484662577
25	Lleida	234	25234	Tremp	5377	2650	2727	49.2839873535429	50.7160126464571
25	Lleida	238	25238	Vallbona de les Monges	266	128	138	48.1203007518797	51.8796992481203
25	Lleida	239	25239	Valls de Valira (Les)	757	413	344	54.557463672391	45.442536327609
25	Lleida	240	25240	Vallfogona de Balaguer	1505	756	749	50.2325581395349	49.7674418604651
25	Lleida	242	25242	Verdú	1041	498	543	47.8386167146974	52.1613832853026
25	Lleida	243	25243	Vielha e Mijaran	4139	2079	2060	50.2295240396231	49.7704759603769
25	Lleida	244	25244	Vilagrassa	453	243	210	53.6423841059603	46.3576158940397
25	Lleida	245	25245	Vilaller	578	303	275	52.4221453287197	47.5778546712803
25	Lleida	247	25247	Vilamòs	152	78	74	51.3157894736842	48.6842105263158
25	Lleida	248	25248	Vilanova de Bellpuig	1139	567	572	49.7805092186128	50.2194907813872
25	Lleida	249	25249	Vilanova de l'Aguda	273	140	133	51.2820512820513	48.7179487179487
25	Lleida	250	25250	Vilanova de Meià	473	244	229	51.5856236786469	48.4143763213531
25	Lleida	251	25251	Vilanova de Segrià	789	405	384	51.3307984790874	48.6692015209125
25	Lleida	252	25252	Vila-sana	514	252	262	49.0272373540856	50.9727626459144
25	Lleida	253	25253	Vilosell (El)	197	88	109	44.6700507614213	55.3299492385787
25	Lleida	254	25254	Vilanova de la Barca	921	459	462	49.8371335504886	50.1628664495114
25	Lleida	255	25255	Vinaixa	627	302	325	48.1658692185008	51.8341307814992
25	Lleida	901	25901	Vall de Cardós	318	166	152	52.2012578616352	47.7987421383648
25	Lleida	902	25902	Sant Martí de Riucorb	696	356	340	51.1494252873563	48.8505747126437
25	Lleida	903	25903	Guingueta d'Àneu (La)	313	161	152	51.4376996805112	48.5623003194888
25	Lleida	904	25904	Castell de Mur	149	78	71	52.3489932885906	47.6510067114094
25	Lleida	905	25905	Ribera d'Ondara	516	269	247	52.1317829457364	47.8682170542636
25	Lleida	906	25906	Valls d'Aguilar (Les)	296	161	135	54.3918918918919	45.6081081081081
25	Lleida	907	25907	Torrefeta i Florejacs	658	332	326	50.4559270516717	49.5440729483283
25	Lleida	908	25908	Fígols i Alinyà	296	162	134	54.7297297297297	45.2702702702703
25	Lleida	909	25909	Vansa i Fórnols (La)	170	87	83	51.1764705882353	48.8235294117647
25	Lleida	910	25910	Josa i Tuixén	169	90	79	53.2544378698225	46.7455621301775
25	Lleida	911	25911	Plans de Sió (Els)	595	308	287	51.764705882353	48.2352941176471
25	Lleida	912	25912	Gimenells i el Pla de la Font	1124	587	537	52.2241992882562	47.7758007117438
25	Lleida	913	25913	Riu de Cerdanya	81	39	42	48.1481481481482	51.8518518518519
26	Rioja (La)	001	26001	Ábalos	276	157	119	56.8840579710145	43.1159420289855
26	Rioja (La)	002	26002	Agoncillo	875	458	417	52.3428571428572	47.6571428571429
26	Rioja (La)	003	26003	Aguilar del Río Alhama	687	351	336	51.0917030567686	48.9082969432314
26	Rioja (La)	004	26004	Ajamil	61	39	22	63.9344262295082	36.0655737704918
26	Rioja (La)	005	26005	Albelda de Iregua	2299	1166	1133	50.7177033492823	49.2822966507177
26	Rioja (La)	006	26006	Alberite	2012	1006	1006	50	50
26	Rioja (La)	007	26007	Alcanadre	793	409	384	51.5762925598991	48.4237074401009
26	Rioja (La)	008	26008	Aldeanueva de Ebro	2491	1294	1197	51.9470092332397	48.0529907667603
26	Rioja (La)	009	26009	Alesanco	480	245	235	51.0416666666667	48.9583333333333
26	Rioja (La)	010	26010	Alesón	142	71	71	50	50
26	Rioja (La)	011	26011	Alfaro	9083	4566	4517	50.2697346691622	49.7302653308378
26	Rioja (La)	012	26012	Almarza de Cameros	39	24	15	61.5384615384615	38.4615384615385
26	Rioja (La)	013	26013	Anguciana	45	29	16	64.4444444444444	35.5555555555556
26	Rioja (La)	014	26014	Anguiano	585	322	263	55.042735042735	44.957264957265
26	Rioja (La)	015	26015	Arenzana de Abajo	308	160	148	51.9480519480519	48.0519480519481
26	Rioja (La)	016	26016	Arenzana de Arriba	39	21	18	53.8461538461539	46.1538461538462
26	Rioja (La)	017	26017	Arnedillo	439	212	227	48.2915717539863	51.7084282460137
26	Rioja (La)	018	26018	Arnedo	12855	6399	6456	49.7782963827305	50.2217036172695
26	Rioja (La)	019	26019	Arrúbal	434	225	209	51.8433179723502	48.1566820276498
26	Rioja (La)	020	26020	Ausejo	700	381	319	54.4285714285714	45.5714285714286
26	Rioja (La)	021	26021	Autol	1959	1005	954	51.301684532925	48.698315467075
26	Rioja (La)	022	26022	Azofra	344	186	158	54.0697674418605	45.9302325581395
26	Rioja (La)	023	26023	Badarán	729	391	338	53.6351165980796	46.3648834019204
26	Rioja (La)	024	26024	Bañares	390	198	192	50.7692307692308	49.2307692307692
26	Rioja (La)	025	26025	Baños de Rioja	110	64	46	58.1818181818182	41.8181818181818
26	Rioja (La)	026	26026	Baños de Río Tobía	1758	904	854	51.4220705346985	48.5779294653015
26	Rioja (La)	027	26027	Berceo	222	136	86	61.2612612612613	38.7387387387387
26	Rioja (La)	028	26028	Bergasa	137	75	62	54.7445255474453	45.2554744525548
26	Rioja (La)	029	26029	Bergasillas Bajera	30	17	13	56.6666666666667	43.3333333333333
26	Rioja (La)	030	26030	Bezares	31	19	12	61.2903225806452	38.7096774193548
26	Rioja (La)	031	26031	Bobadilla	162	93	69	57.4074074074074	42.5925925925926
26	Rioja (La)	032	26032	Brieva de Cameros	70	41	29	58.5714285714286	41.4285714285714
26	Rioja (La)	033	26033	Briñas	206	105	101	50.9708737864078	49.0291262135922
26	Rioja (La)	034	26034	Briones	818	432	386	52.8117359413203	47.1882640586797
26	Rioja (La)	035	26035	Cabezón de Cameros	30	21	9	70	30
26	Rioja (La)	036	26036	Calahorra	18924	9172	9752	48.4675544282393	51.5324455717607
26	Rioja (La)	037	26037	Camprovín	216	115	101	53.2407407407407	46.7592592592593
26	Rioja (La)	038	26038	Canales de la Sierra	83	44	39	53.0120481927711	46.9879518072289
26	Rioja (La)	039	26039	Canillas de Río Tuerto	67	32	35	47.7611940298507	52.2388059701493
26	Rioja (La)	040	26040	Cañas	111	51	60	45.945945945946	54.0540540540541
26	Rioja (La)	041	26041	Cárdenas	241	117	124	48.5477178423237	51.4522821576763
26	Rioja (La)	042	26042	Casalarreina	901	452	449	50.1664816870144	49.8335183129856
26	Rioja (La)	043	26043	Castañares de Rioja	459	230	229	50.1089324618736	49.8910675381264
26	Rioja (La)	044	26044	Castroviejo	61	31	30	50.8196721311475	49.1803278688525
26	Rioja (La)	045	26045	Cellorigo	21	11	10	52.3809523809524	47.6190476190476
26	Rioja (La)	046	26046	Cenicero	2055	1037	1018	50.4622871046229	49.5377128953771
26	Rioja (La)	047	26047	Cervera del Río Alhama	2960	1528	1432	51.6216216216216	48.3783783783784
26	Rioja (La)	048	26048	Cidamón	46	24	22	52.1739130434783	47.8260869565217
26	Rioja (La)	049	26049	Cihuri	153	80	73	52.2875816993464	47.7124183006536
26	Rioja (La)	050	26050	Cirueña	122	71	51	58.1967213114754	41.8032786885246
26	Rioja (La)	051	26051	Clavijo	190	100	90	52.6315789473684	47.3684210526316
26	Rioja (La)	052	26052	Cordovín	213	109	104	51.1737089201878	48.8262910798122
26	Rioja (La)	053	26053	Corera	250	120	130	48	52
26	Rioja (La)	054	26054	Cornago	567	307	260	54.1446208112875	45.8553791887125
26	Rioja (La)	055	26055	Corporales	62	31	31	50	50
26	Rioja (La)	056	26056	Cuzcurrita de Río Tirón	470	254	216	54.0425531914894	45.9574468085106
26	Rioja (La)	057	26057	Daroca de Rioja	53	32	21	60.377358490566	39.622641509434
26	Rioja (La)	058	26058	Enciso	169	104	65	61.5384615384615	38.4615384615385
26	Rioja (La)	059	26059	Entrena	1130	588	542	52.0353982300885	47.9646017699115
26	Rioja (La)	060	26060	Estollo	144	80	64	55.5555555555556	44.4444444444444
26	Rioja (La)	061	26061	Ezcaray	1861	995	866	53.465878559914	46.534121440086
26	Rioja (La)	062	26062	Foncea	123	65	58	52.8455284552846	47.1544715447155
26	Rioja (La)	063	26063	Fonzaleche	168	100	68	59.5238095238095	40.4761904761905
26	Rioja (La)	064	26064	Fuenmayor	2301	1166	1135	50.6736201651456	49.3263798348544
26	Rioja (La)	065	26065	Galbárruli	71	41	30	57.7464788732394	42.2535211267606
26	Rioja (La)	066	26066	Galilea	278	142	136	51.0791366906475	48.9208633093525
26	Rioja (La)	067	26067	Gallinero de Cameros	27	18	9	66.6666666666667	33.3333333333333
26	Rioja (La)	068	26068	Gimileo	91	42	49	46.1538461538462	53.8461538461539
26	Rioja (La)	069	26069	Grañón	412	215	197	52.1844660194175	47.8155339805825
26	Rioja (La)	070	26070	Grávalos	273	138	135	50.5494505494506	49.4505494505495
26	Rioja (La)	071	26071	Haro	9245	4556	4689	49.2806922660898	50.7193077339102
26	Rioja (La)	072	26072	Herce	352	182	170	51.7045454545455	48.2954545454546
26	Rioja (La)	073	26073	Herramélluri	162	86	76	53.0864197530864	46.9135802469136
26	Rioja (La)	074	26074	Hervías	180	93	87	51.6666666666667	48.3333333333333
26	Rioja (La)	075	26075	Hormilla	465	240	225	51.6129032258065	48.3870967741936
26	Rioja (La)	076	26076	Hormilleja	174	87	87	50	50
26	Rioja (La)	077	26077	Hornillos de Cameros	22	11	11	50	50
26	Rioja (La)	078	26078	Hornos de Moncalvillo	95	44	51	46.3157894736842	53.6842105263158
26	Rioja (La)	079	26079	Huércanos	889	459	430	51.6310461192351	48.3689538807649
26	Rioja (La)	080	26080	Igea	766	415	351	54.177545691906	45.822454308094
26	Rioja (La)	081	26081	Jalón de Cameros	47	27	20	57.4468085106383	42.5531914893617
26	Rioja (La)	082	26082	Laguna de Cameros	176	98	78	55.6818181818182	44.3181818181818
26	Rioja (La)	083	26083	Lagunilla del Jubera	332	178	154	53.6144578313253	46.3855421686747
26	Rioja (La)	084	26084	Lardero	3183	1592	1591	50.0157084511467	49.9842915488533
26	Rioja (La)	086	26086	Ledesma de la Cogolla	21	15	6	71.4285714285714	28.5714285714286
26	Rioja (La)	087	26087	Leiva	291	143	148	49.1408934707904	50.8591065292096
26	Rioja (La)	088	26088	Leza de Río Leza	28	19	9	67.8571428571429	32.1428571428571
26	Rioja (La)	089	26089	Logroño	128493	61723	66770	48.0360797864475	51.9639202135525
26	Rioja (La)	091	26091	Lumbreras	156	95	61	60.8974358974359	39.1025641025641
26	Rioja (La)	092	26092	Manjarrés	142	81	61	57.0422535211268	42.9577464788732
26	Rioja (La)	093	26093	Mansilla de la Sierra	49	33	16	67.3469387755102	32.6530612244898
26	Rioja (La)	094	26094	Manzanares de Rioja	116	64	52	55.1724137931034	44.8275862068966
26	Rioja (La)	095	26095	Matute	23	11	12	47.8260869565217	52.1739130434783
26	Rioja (La)	096	26096	Medrano	211	112	99	53.0805687203791	46.9194312796209
26	Rioja (La)	098	26098	Munilla	120	62	58	51.6666666666667	48.3333333333333
26	Rioja (La)	099	26099	Murillo de Río Leza	1461	741	720	50.7186858316222	49.2813141683778
26	Rioja (La)	100	26100	Muro de Aguas	70	41	29	58.5714285714286	41.4285714285714
26	Rioja (La)	101	26101	Muro en Cameros	40	26	14	65	35
26	Rioja (La)	102	26102	Nájera	7076	3542	3534	50.0565291124929	49.9434708875071
26	Rioja (La)	103	26103	Nalda	813	427	386	52.5215252152522	47.4784747847478
26	Rioja (La)	104	26104	Navajún	18	12	6	66.6666666666667	33.3333333333333
26	Rioja (La)	105	26105	Navarrete	2087	1077	1010	51.6051748921897	48.3948251078103
26	Rioja (La)	106	26106	Nestares	73	39	34	53.4246575342466	46.5753424657534
26	Rioja (La)	107	26107	Nieva de Cameros	114	59	55	51.7543859649123	48.2456140350877
26	Rioja (La)	108	26108	Ocón	328	196	132	59.7560975609756	40.2439024390244
26	Rioja (La)	109	26109	Ochánduri	100	50	50	50	50
26	Rioja (La)	110	26110	Ojacastro	249	148	101	59.4377510040161	40.5622489959839
26	Rioja (La)	111	26111	Ollauri	306	169	137	55.2287581699346	44.7712418300654
26	Rioja (La)	112	26112	Ortigosa de Cameros	316	168	148	53.1645569620253	46.8354430379747
26	Rioja (La)	113	26113	Pazuengos	46	28	18	60.8695652173913	39.1304347826087
26	Rioja (La)	114	26114	Pedroso	108	62	46	57.4074074074074	42.5925925925926
26	Rioja (La)	115	26115	Pinillos	31	17	14	54.8387096774194	45.1612903225806
26	Rioja (La)	117	26117	Pradejón	3019	1589	1430	52.6333222921497	47.3666777078503
26	Rioja (La)	118	26118	Pradillo	79	42	37	53.1645569620253	46.8354430379747
26	Rioja (La)	119	26119	Préjano	214	104	110	48.5981308411215	51.4018691588785
26	Rioja (La)	120	26120	Quel	1888	991	897	52.489406779661	47.510593220339
26	Rioja (La)	121	26121	Rabanera	38	27	11	71.0526315789474	28.9473684210526
26	Rioja (La)	122	26122	Rasillo de Cameros (El)	111	61	50	54.954954954955	45.0450450450451
26	Rioja (La)	123	26123	Redal (El)	200	102	98	51	49
26	Rioja (La)	124	26124	Ribafrecha	967	528	439	54.6018614270941	45.3981385729059
26	Rioja (La)	125	26125	Rincón de Soto	2474	1322	1152	53.4357316087308	46.5642683912692
26	Rioja (La)	126	26126	Robres del Castillo	16	10	6	62.5	37.5
26	Rioja (La)	127	26127	Rodezno	318	172	146	54.0880503144654	45.9119496855346
26	Rioja (La)	128	26128	Sajazarra	139	71	68	51.0791366906475	48.9208633093525
26	Rioja (La)	129	26129	San Asensio	1195	619	576	51.7991631799163	48.2008368200837
26	Rioja (La)	130	26130	San Millán de la Cogolla	264	162	102	61.3636363636364	38.6363636363636
26	Rioja (La)	131	26131	San Millán de Yécora	51	31	20	60.7843137254902	39.2156862745098
26	Rioja (La)	132	26132	San Román de Cameros	162	89	73	54.9382716049383	45.0617283950617
26	Rioja (La)	134	26134	Santa Coloma	142	88	54	61.9718309859155	38.0281690140845
26	Rioja (La)	135	26135	Santa Engracia del Jubera	201	117	84	58.2089552238806	41.7910447761194
26	Rioja (La)	136	26136	Santa Eulalia Bajera	119	68	51	57.1428571428571	42.8571428571429
26	Rioja (La)	138	26138	Santo Domingo de la Calzada	5724	2878	2846	50.2795248078267	49.7204751921733
26	Rioja (La)	139	26139	San Torcuato	97	55	42	56.701030927835	43.298969072165
26	Rioja (La)	140	26140	Santurde de Rioja	290	145	145	50	50
26	Rioja (La)	141	26141	Santurdejo	184	102	82	55.4347826086957	44.5652173913043
26	Rioja (La)	142	26142	San Vicente de la Sonsierra	1104	571	533	51.7210144927536	48.2789855072464
26	Rioja (La)	143	26143	Sojuela	81	47	34	58.0246913580247	41.9753086419753
26	Rioja (La)	144	26144	Sorzano	218	112	106	51.3761467889908	48.6238532110092
26	Rioja (La)	145	26145	Sotés	217	128	89	58.9861751152074	41.0138248847926
26	Rioja (La)	146	26146	Soto en Cameros	165	90	75	54.5454545454545	45.4545454545455
26	Rioja (La)	147	26147	Terroba	32	17	15	53.125	46.875
26	Rioja (La)	148	26148	Tirgo	267	136	131	50.936329588015	49.063670411985
26	Rioja (La)	149	26149	Tobía	40	21	19	52.5	47.5
26	Rioja (La)	150	26150	Tormantos	213	114	99	53.5211267605634	46.4788732394366
26	Rioja (La)	151	26151	Torrecilla en Cameros	555	297	258	53.5135135135135	46.4864864864865
26	Rioja (La)	152	26152	Torrecilla sobre Alesanco	78	39	39	50	50
26	Rioja (La)	153	26153	Torre en Cameros	14	11	3	78.5714285714286	21.4285714285714
26	Rioja (La)	154	26154	Torremontalbo	16	10	6	62.5	37.5
26	Rioja (La)	155	26155	Treviana	251	132	119	52.5896414342629	47.4103585657371
26	Rioja (La)	157	26157	Tricio	338	161	177	47.6331360946746	52.3668639053255
26	Rioja (La)	158	26158	Tudelilla	422	211	211	50	50
26	Rioja (La)	160	26160	Uruñuela	738	380	358	51.4905149051491	48.509485094851
26	Rioja (La)	161	26161	Valdemadera	13	9	4	69.2307692307692	30.7692307692308
26	Rioja (La)	162	26162	Valgañón	157	85	72	54.140127388535	45.859872611465
26	Rioja (La)	163	26163	Ventosa	131	70	61	53.4351145038168	46.5648854961832
26	Rioja (La)	164	26164	Ventrosa	87	38	49	43.6781609195402	56.3218390804598
26	Rioja (La)	165	26165	Viguera	357	207	150	57.9831932773109	42.0168067226891
26	Rioja (La)	166	26166	Villalba de Rioja	148	87	61	58.7837837837838	41.2162162162162
26	Rioja (La)	167	26167	Villalobar de Rioja	123	74	49	60.1626016260163	39.8373983739837
26	Rioja (La)	168	26168	Villamediana de Iregua	2260	1181	1079	52.2566371681416	47.7433628318584
26	Rioja (La)	169	26169	Villanueva de Cameros	122	64	58	52.4590163934426	47.5409836065574
26	Rioja (La)	170	26170	Villar de Arnedo (El)	632	304	328	48.1012658227848	51.8987341772152
26	Rioja (La)	171	26171	Villar de Torre	306	160	146	52.2875816993464	47.7124183006536
26	Rioja (La)	172	26172	Villarejo	50	31	19	62	38
26	Rioja (La)	173	26173	Villarroya	9	4	5	44.4444444444444	55.5555555555556
26	Rioja (La)	174	26174	Villarta-Quintana	212	106	106	50	50
26	Rioja (La)	175	26175	Villavelayo	73	42	31	57.5342465753425	42.4657534246575
26	Rioja (La)	176	26176	Villaverde de Rioja	95	55	40	57.8947368421053	42.1052631578947
26	Rioja (La)	177	26177	Villoslada de Cameros	388	230	158	59.2783505154639	40.7216494845361
26	Rioja (La)	178	26178	Viniegra de Abajo	121	64	57	52.8925619834711	47.1074380165289
26	Rioja (La)	179	26179	Viniegra de Arriba	55	34	21	61.8181818181818	38.1818181818182
26	Rioja (La)	180	26180	Zarratón	258	133	125	51.5503875968992	48.4496124031008
26	Rioja (La)	181	26181	Zarzosa	12	9	3	75	25
26	Rioja (La)	183	26183	Zorraquín	42	27	15	64.2857142857143	35.7142857142857
27	Lugo	001	27001	Abadín	3516	1668	1848	47.4402730375427	52.5597269624573
27	Lugo	002	27002	Alfoz	2462	1191	1271	48.3753046303818	51.6246953696182
27	Lugo	003	27003	Antas de Ulla	2769	1327	1442	47.9234380642831	52.0765619357169
27	Lugo	004	27004	Baleira	1923	993	930	51.6380655226209	48.3619344773791
27	Lugo	005	27005	Barreiros	3446	1662	1784	48.2298316889147	51.7701683110853
27	Lugo	006	27006	Becerreá	3732	1883	1849	50.4555198285102	49.5444801714898
27	Lugo	007	27007	Begonte	3818	1896	1922	49.6595075955998	50.3404924044002
27	Lugo	008	27008	Bóveda	2048	985	1063	48.095703125	51.904296875
27	Lugo	009	27009	Carballedo	3238	1611	1627	49.7529339098209	50.2470660901791
27	Lugo	010	27010	Castro de Rei	5961	2972	2989	49.8574064754236	50.1425935245764
27	Lugo	011	27011	Castroverde	3532	1811	1721	51.2740656851642	48.7259343148358
27	Lugo	012	27012	Cervantes	2243	1222	1021	54.480606330807	45.5193936691931
27	Lugo	013	27013	Cervo	5082	2543	2539	50.0393545848091	49.9606454151909
27	Lugo	014	27014	Corgo (O)	4266	2151	2115	50.42194092827	49.57805907173
27	Lugo	015	27015	Cospeito	5931	2916	3015	49.165402124431	50.834597875569
27	Lugo	016	27016	Chantada	9823	4829	4994	49.1601343784994	50.8398656215006
27	Lugo	017	27017	Folgoso do Courel	1593	808	785	50.721908349027	49.278091650973
27	Lugo	018	27018	Fonsagrada (A)	5448	2858	2590	52.4596182085169	47.5403817914831
27	Lugo	019	27019	Foz	9558	4545	5013	47.5517890772128	52.4482109227872
27	Lugo	020	27020	Friol	4837	2405	2432	49.7209013851561	50.2790986148439
27	Lugo	021	27021	Xermade	2728	1329	1399	48.717008797654	51.282991202346
27	Lugo	022	27022	Guitiriz	6358	3137	3221	49.3394149103492	50.6605850896508
27	Lugo	023	27023	Guntín	3554	1776	1778	49.9718626899268	50.0281373100732
27	Lugo	024	27024	Incio (O)	2540	1240	1300	48.8188976377953	51.1811023622047
27	Lugo	025	27025	Xove	3629	1807	1822	49.79333149628	50.20666850372
27	Lugo	026	27026	Láncara	3331	1715	1616	51.4860402281597	48.5139597718403
27	Lugo	027	27027	Lourenzá	2849	1376	1473	48.2976482976483	51.7023517023517
27	Lugo	028	27028	Lugo	88235	41415	46820	46.9371564571882	53.0628435428118
27	Lugo	029	27029	Meira	1852	900	952	48.5961123110151	51.4038876889849
27	Lugo	030	27030	Mondoñedo	5135	2379	2756	46.3291139240506	53.6708860759494
27	Lugo	031	27031	Monforte de Lemos	19712	9390	10322	47.6359577922078	52.3640422077922
27	Lugo	032	27032	Monterroso	4267	2114	2153	49.5430044527771	50.4569955472229
27	Lugo	033	27033	Muras	1151	569	582	49.4352736750652	50.5647263249348
27	Lugo	034	27034	Navia de Suarna	1974	1053	921	53.3434650455927	46.6565349544073
27	Lugo	035	27035	Negueira de Muñiz	261	137	124	52.4904214559387	47.5095785440613
27	Lugo	037	27037	Nogais (As)	1596	816	780	51.1278195488722	48.8721804511278
27	Lugo	038	27038	Ourol	1577	770	807	48.8268864933418	51.1731135066582
27	Lugo	039	27039	Outeiro de Rei	4256	2147	2109	50.4464285714286	49.5535714285714
27	Lugo	040	27040	Palas de Rei	4330	2116	2214	48.8683602771363	51.1316397228637
27	Lugo	041	27041	Pantón	3540	1673	1867	47.2598870056497	52.7401129943503
27	Lugo	042	27042	Paradela	2655	1316	1339	49.5668549905838	50.4331450094162
27	Lugo	043	27043	Páramo (O)	1938	989	949	51.0319917440661	48.968008255934
27	Lugo	044	27044	Pastoriza (A)	4106	2046	2060	49.8295177788602	50.1704822211398
27	Lugo	045	27045	Pedrafita do Cebreiro	1630	872	758	53.4969325153374	46.5030674846626
27	Lugo	046	27046	Pol	2177	1066	1111	48.9664676159853	51.0335323840147
27	Lugo	047	27047	Pobra do Brollón (A)	2648	1285	1363	48.5271903323263	51.4728096676737
27	Lugo	048	27048	Pontenova (A)	3389	1658	1731	48.9229861316022	51.0770138683978
27	Lugo	049	27049	Portomarín	2099	1021	1078	48.642210576465	51.357789423535
27	Lugo	050	27050	Quiroga	4342	2094	2248	48.2266236757255	51.7733763242745
27	Lugo	051	27051	Ribadeo	9034	4231	4803	46.8341819791897	53.1658180208103
27	Lugo	052	27052	Ribas de Sil	1463	696	767	47.5734791524265	52.4265208475735
27	Lugo	053	27053	Ribeira de Piquín	886	434	452	48.9841986455982	51.0158013544018
27	Lugo	054	27054	Riotorto	1920	948	972	49.375	50.625
27	Lugo	055	27055	Samos	2157	1122	1035	52.0166898470097	47.9833101529903
27	Lugo	056	27056	Rábade	1607	801	806	49.8444306160548	50.1555693839452
27	Lugo	057	27057	Sarria	13018	6353	6665	48.8016592410509	51.1983407589491
27	Lugo	058	27058	Saviñao (O)	5104	2474	2630	48.4717868338558	51.5282131661442
27	Lugo	059	27059	Sober	3112	1503	1609	48.2969151670951	51.7030848329049
27	Lugo	060	27060	Taboada	4227	2038	2189	48.2138632599953	51.7861367400047
27	Lugo	061	27061	Trabada	1686	818	868	48.5172004744958	51.4827995255042
27	Lugo	062	27062	Triacastela	939	458	481	48.7752928647497	51.2247071352503
27	Lugo	063	27063	Valadouro (O)	2445	1219	1226	49.8568507157464	50.1431492842536
27	Lugo	064	27064	Vicedo (O)	2392	1178	1214	49.247491638796	50.752508361204
27	Lugo	065	27065	Vilalba	15699	7682	8017	48.9330530607045	51.0669469392955
27	Lugo	066	27066	Viveiro	15456	7468	7988	48.3178053830228	51.6821946169772
27	Lugo	901	27901	Baralla	3344	1717	1627	51.3456937799043	48.6543062200957
27	Lugo	902	27902	Burela	8045	3972	4073	49.372280919826	50.627719080174
28	Madrid	001	28001	Acebeda (La)	57	31	26	54.3859649122807	45.6140350877193
28	Madrid	002	28002	Ajalvir	2205	1154	1051	52.3356009070295	47.6643990929705
28	Madrid	003	28003	Alameda del Valle	198	111	87	56.0606060606061	43.9393939393939
28	Madrid	004	28004	Álamo (El)	4676	2656	2020	56.8006843455945	43.1993156544055
28	Madrid	005	28005	Alcalá de Henares	166397	82753	83644	49.7322668076949	50.2677331923052
28	Madrid	006	28006	Alcobendas	89612	44103	45509	49.2155068517609	50.7844931482391
28	Madrid	007	28007	Alcorcón	144636	71408	73228	49.3708343704195	50.6291656295805
28	Madrid	008	28008	Aldea del Fresno	1449	755	694	52.1048999309869	47.8951000690131
28	Madrid	009	28009	Algete	14731	7467	7264	50.6890231484624	49.3109768515376
28	Madrid	010	28010	Alpedrete	7286	3682	3604	50.5352731265441	49.4647268734559
28	Madrid	011	28011	Ambite	307	155	152	50.4885993485342	49.5114006514658
28	Madrid	012	28012	Anchuelo	579	317	262	54.7495682210708	45.2504317789292
28	Madrid	013	28013	Aranjuez	39652	19159	20493	48.3178654292343	51.6821345707657
28	Madrid	014	28014	Arganda del Rey	30662	15225	15437	49.6542952188377	50.3457047811624
28	Madrid	015	28015	Arroyomolinos	3824	1965	1859	51.3859832635983	48.6140167364017
28	Madrid	016	28016	Atazar (El)	87	47	40	54.0229885057471	45.9770114942529
28	Madrid	017	28017	Batres	844	435	409	51.5402843601896	48.4597156398104
28	Madrid	018	28018	Becerril de la Sierra	3246	1683	1563	51.8484288354898	48.1515711645102
28	Madrid	019	28019	Belmonte de Tajo	1158	589	569	50.8635578583765	49.1364421416235
28	Madrid	020	28020	Berzosa del Lozoya	118	59	59	50	50
28	Madrid	021	28021	Berrueco (El)	315	173	142	54.9206349206349	45.0793650793651
28	Madrid	022	28022	Boadilla del Monte	20686	10432	10254	50.4302426762061	49.5697573237939
28	Madrid	023	28023	Boalo (El)	3092	1588	1504	51.3583441138422	48.6416558861578
28	Madrid	024	28024	Braojos	160	90	70	56.25	43.75
28	Madrid	025	28025	Brea de Tajo	458	233	225	50.8733624454148	49.1266375545852
28	Madrid	026	28026	Brunete	5080	2506	2574	49.3307086614173	50.6692913385827
28	Madrid	027	28027	Buitrago del Lozoya	1471	723	748	49.1502379333787	50.8497620666214
28	Madrid	028	28028	Bustarviejo	1442	741	701	51.3869625520111	48.6130374479889
28	Madrid	029	28029	Cabanillas de la Sierra	453	240	213	52.9801324503311	47.0198675496689
28	Madrid	030	28030	Cabrera (La)	1689	843	846	49.911190053286	50.088809946714
28	Madrid	031	28031	Cadalso de los Vidrios	2248	1148	1100	51.067615658363	48.932384341637
28	Madrid	032	28032	Camarma de Esteruelas	2391	1212	1179	50.6900878293601	49.3099121706399
28	Madrid	033	28033	Campo Real	2735	1383	1352	50.5667276051188	49.4332723948812
28	Madrid	034	28034	Canencia	441	229	212	51.9274376417234	48.0725623582766
28	Madrid	035	28035	Carabaña	1118	556	562	49.7316636851521	50.2683363148479
28	Madrid	036	28036	Casarrubuelos	731	393	338	53.7619699042408	46.2380300957592
28	Madrid	037	28037	Cenicientos	1864	915	949	49.087982832618	50.912017167382
28	Madrid	038	28038	Cercedilla	5644	2818	2826	49.9291282778172	50.0708717221829
28	Madrid	039	28039	Cervera de Buitrago	85	51	34	60	40
28	Madrid	040	28040	Ciempozuelos	13564	6899	6665	50.8625774107933	49.1374225892067
28	Madrid	041	28041	Cobeña	2791	1417	1374	50.7703332139018	49.2296667860982
28	Madrid	042	28042	Colmenar del Arroyo	872	419	453	48.0504587155963	51.9495412844037
28	Madrid	043	28043	Colmenar de Oreja	5412	2647	2765	48.909830007391	51.090169992609
28	Madrid	044	28044	Colmenarejo	4395	2199	2196	50.0341296928328	49.9658703071672
28	Madrid	045	28045	Colmenar Viejo	32459	16111	16348	49.6349240580425	50.3650759419576
28	Madrid	046	28046	Collado Mediano	4529	2292	2237	50.6071980569662	49.3928019430338
28	Madrid	047	28047	Collado Villalba	42238	21075	21163	49.895828400966	50.104171599034
28	Madrid	048	28048	Corpa	354	179	175	50.5649717514124	49.4350282485876
28	Madrid	049	28049	Coslada	77057	38285	38772	49.6840001557289	50.3159998442711
28	Madrid	050	28050	Cubas de la Sagra	1689	825	864	48.8454706927176	51.1545293072824
28	Madrid	051	28051	Chapinería	1360	691	669	50.8088235294118	49.1911764705882
28	Madrid	052	28052	Chinchón	4168	2094	2074	50.2399232245681	49.7600767754319
28	Madrid	053	28053	Daganzo de Arriba	3830	1939	1891	50.6266318537859	49.3733681462141
28	Madrid	054	28054	Escorial (El)	10549	5245	5304	49.7203526400607	50.2796473599393
28	Madrid	055	28055	Estremera	1028	516	512	50.1945525291829	49.8054474708171
28	Madrid	056	28056	Fresnedillas de la Oliva	769	395	374	51.3654096228869	48.6345903771131
28	Madrid	057	28057	Fresno de Torote	643	365	278	56.7651632970451	43.2348367029549
28	Madrid	058	28058	Fuenlabrada	173788	87695	86093	50.4609063916956	49.5390936083044
28	Madrid	059	28059	Fuente el Saz de Jarama	4004	2080	1924	51.9480519480519	48.0519480519481
28	Madrid	060	28060	Fuentidueña de Tajo	1446	701	745	48.478561549101	51.521438450899
28	Madrid	061	28061	Galapagar	21807	11002	10805	50.4516898243683	49.5483101756317
28	Madrid	062	28062	Garganta de los Montes	325	173	152	53.2307692307692	46.7692307692308
28	Madrid	063	28063	Gargantilla del Lozoya	227	138	89	60.7929515418502	39.2070484581498
28	Madrid	064	28064	Gascones	107	55	52	51.4018691588785	48.5981308411215
28	Madrid	065	28065	Getafe	146310	72629	73681	49.6404893718816	50.3595106281184
28	Madrid	066	28066	Griñón	4488	2293	2195	51.0918003565062	48.9081996434938
28	Madrid	067	28067	Guadalix de la Sierra	3100	1605	1495	51.7741935483871	48.2258064516129
28	Madrid	068	28068	Guadarrama	9389	4627	4762	49.2810735967622	50.7189264032378
28	Madrid	069	28069	Hiruela (La)	74	35	39	47.2972972972973	52.7027027027027
28	Madrid	070	28070	Horcajo de la Sierra	144	77	67	53.4722222222222	46.5277777777778
28	Madrid	071	28071	Horcajuelo de la Sierra	103	45	58	43.6893203883495	56.3106796116505
28	Madrid	072	28072	Hoyo de Manzanares	5667	2894	2773	51.0675842597494	48.9324157402506
28	Madrid	073	28073	Humanes de Madrid	9424	4834	4590	51.2945670628183	48.7054329371817
28	Madrid	074	28074	Leganés	172049	85530	86519	49.7125818807433	50.2874181192567
28	Madrid	075	28075	Loeches	2985	1463	1522	49.0117252931323	50.9882747068677
28	Madrid	076	28076	Lozoya	434	222	212	51.1520737327189	48.8479262672811
28	Madrid	078	28078	Madarcos	21	11	10	52.3809523809524	47.6190476190476
28	Madrid	079	28079	Madrid	2882860	1345601	1537259	46.6759051774974	53.3240948225027
28	Madrid	080	28080	Majadahonda	45819	22178	23641	48.4035007311377	51.5964992688623
28	Madrid	082	28082	Manzanares el Real	3842	2015	1827	52.4466423737637	47.5533576262363
28	Madrid	083	28083	Meco	6328	3251	3077	51.3748419721871	48.6251580278129
28	Madrid	084	28084	Mejorada del Campo	15771	7914	7857	50.1807114323759	49.8192885676241
28	Madrid	085	28085	Miraflores de la Sierra	3678	1848	1830	50.2446982055465	49.7553017944535
28	Madrid	086	28086	Molar (El)	3695	1954	1741	52.8822733423545	47.1177266576455
28	Madrid	087	28087	Molinos (Los)	3322	1602	1720	48.2239614689946	51.7760385310054
28	Madrid	088	28088	Montejo de la Sierra	313	155	158	49.5207667731629	50.4792332268371
28	Madrid	089	28089	Moraleja de Enmedio	3056	1538	1518	50.3272251308901	49.67277486911
28	Madrid	090	28090	Moralzarzal	5379	2737	2642	50.8830637664993	49.1169362335007
28	Madrid	091	28091	Morata de Tajuña	5383	2659	2724	49.3962474456623	50.6037525543377
28	Madrid	092	28092	Móstoles	196289	97383	98906	49.6120516177677	50.3879483822323
28	Madrid	093	28093	Navacerrada	1880	944	936	50.2127659574468	49.7872340425532
28	Madrid	094	28094	Navalafuente	541	292	249	53.9741219963031	46.0258780036969
28	Madrid	095	28095	Navalagamella	1128	562	566	49.822695035461	50.177304964539
28	Madrid	096	28096	Navalcarnero	13522	6839	6683	50.5768377458956	49.4231622541044
28	Madrid	097	28097	Navarredonda y San Mamés	108	61	47	56.4814814814815	43.5185185185185
28	Madrid	099	28099	Navas del Rey	1655	871	784	52.6283987915408	47.3716012084592
28	Madrid	100	28100	Nuevo Baztán	3380	1744	1636	51.5976331360947	48.4023668639053
28	Madrid	101	28101	Olmeda de las Fuentes	152	81	71	53.2894736842105	46.7105263157895
28	Madrid	102	28102	Orusco de Tajuña	647	337	310	52.0865533230294	47.9134466769706
28	Madrid	104	28104	Paracuellos de Jarama	5889	3013	2876	51.1631856002717	48.8368143997283
28	Madrid	106	28106	Parla	74203	37208	36995	50.1435251943992	49.8564748056009
28	Madrid	107	28107	Patones	352	182	170	51.7045454545455	48.2954545454546
28	Madrid	108	28108	Pedrezuela	1425	753	672	52.8421052631579	47.1578947368421
28	Madrid	109	28109	Pelayos de la Presa	1328	653	675	49.171686746988	50.8283132530121
28	Madrid	110	28110	Perales de Tajuña	2072	1014	1058	48.9382239382239	51.0617760617761
28	Madrid	111	28111	Pezuela de las Torres	487	261	226	53.5934291581109	46.4065708418891
28	Madrid	112	28112	Pinilla del Valle	156	86	70	55.1282051282051	44.8717948717949
28	Madrid	113	28113	Pinto	28726	14404	14322	50.1427278423728	49.8572721576272
28	Madrid	114	28114	Piñuécar-Gandullas	145	68	77	46.8965517241379	53.1034482758621
28	Madrid	115	28115	Pozuelo de Alarcón	66298	32374	33924	48.8310356270174	51.1689643729826
28	Madrid	116	28116	Pozuelo del Rey	188	101	87	53.7234042553192	46.2765957446809
28	Madrid	117	28117	Prádena del Rincón	95	53	42	55.7894736842105	44.2105263157895
28	Madrid	118	28118	Puebla de la Sierra	71	40	31	56.3380281690141	43.6619718309859
28	Madrid	119	28119	Quijorna	1078	583	495	54.0816326530612	45.9183673469388
28	Madrid	120	28120	Rascafría	1615	849	766	52.5696594427245	47.4303405572755
28	Madrid	121	28121	Redueña	179	89	90	49.7206703910615	50.2793296089386
28	Madrid	122	28122	Ribatejada	381	207	174	54.3307086614173	45.6692913385827
28	Madrid	123	28123	Rivas-Vaciamadrid	29092	14582	14510	50.123745359549	49.876254640451
28	Madrid	124	28124	Robledillo de la Jara	91	41	50	45.0549450549451	54.9450549450549
28	Madrid	125	28125	Robledo de Chavela	2327	1162	1165	49.9355393210142	50.0644606789858
28	Madrid	126	28126	Robregordo	89	45	44	50.561797752809	49.438202247191
28	Madrid	127	28127	Rozas de Madrid (Las)	54676	26776	27900	48.9721267100739	51.0278732899261
28	Madrid	128	28128	Rozas de Puerto Real	283	151	132	53.356890459364	46.643109540636
28	Madrid	129	28129	San Agustín de Guadalix	5859	2936	2923	50.1109404335211	49.8890595664789
28	Madrid	130	28130	San Fernando de Henares	32364	16238	16126	50.173031763688	49.826968236312
28	Madrid	131	28131	San Lorenzo de El Escorial	11783	5701	6082	48.383264024442	51.616735975558
28	Madrid	132	28132	San Martín de la Vega	10630	5421	5209	50.997177798683	49.002822201317
28	Madrid	133	28133	San Martín de Valdeiglesias	6089	3007	3082	49.3841353259977	50.6158646740023
28	Madrid	134	28134	San Sebastián de los Reyes	58389	29121	29268	49.8741201253661	50.1258798746339
28	Madrid	135	28135	Santa María de la Alameda	710	384	326	54.0845070422535	45.9154929577465
28	Madrid	136	28136	Santorcaz	561	296	265	52.7629233511586	47.2370766488414
28	Madrid	137	28137	Santos de la Humosa (Los)	906	462	444	50.9933774834437	49.0066225165563
28	Madrid	138	28138	Serna del Monte (La)	114	57	57	50	50
28	Madrid	140	28140	Serranillos del Valle	923	485	438	52.546045503792	47.453954496208
28	Madrid	141	28141	Sevilla la Nueva	3632	1898	1734	52.2577092511013	47.7422907488987
28	Madrid	143	28143	Somosierra	93	52	41	55.9139784946237	44.0860215053763
28	Madrid	144	28144	Soto del Real	5347	2718	2629	50.8322423789041	49.1677576210959
28	Madrid	145	28145	Talamanca de Jarama	1444	711	733	49.2382271468144	50.7617728531856
28	Madrid	146	28146	Tielmes	1922	989	933	51.4568158168574	48.5431841831426
28	Madrid	147	28147	Titulcia	940	475	465	50.531914893617	49.468085106383
28	Madrid	148	28148	Torrejón de Ardoz	94161	44861	49300	47.6428670043861	52.3571329956139
28	Madrid	149	28149	Torrejón de la Calzada	4208	2106	2102	50.0475285171103	49.9524714828897
28	Madrid	150	28150	Torrejón de Velasco	1908	1008	900	52.8301886792453	47.1698113207547
28	Madrid	151	28151	Torrelaguna	2768	1353	1415	48.8800578034682	51.1199421965318
28	Madrid	152	28152	Torrelodones	13467	6616	6851	49.1274968441375	50.8725031558625
28	Madrid	153	28153	Torremocha de Jarama	342	182	160	53.2163742690059	46.7836257309942
28	Madrid	154	28154	Torres de la Alameda	4356	2203	2153	50.5739210284665	49.4260789715335
28	Madrid	155	28155	Valdaracete	617	300	317	48.6223662884927	51.3776337115073
28	Madrid	156	28156	Valdeavero	597	320	277	53.6013400335008	46.3986599664992
28	Madrid	157	28157	Valdelaguna	560	296	264	52.8571428571429	47.1428571428571
28	Madrid	158	28158	Valdemanco	533	283	250	53.0956848030019	46.9043151969981
28	Madrid	159	28159	Valdemaqueda	570	287	283	50.3508771929825	49.6491228070175
28	Madrid	160	28160	Valdemorillo	5824	3002	2822	51.5453296703297	48.4546703296703
28	Madrid	161	28161	Valdemoro	28243	14160	14083	50.1363169634954	49.8636830365046
28	Madrid	162	28162	Valdeolmos-Alalpardo	1775	934	841	52.6197183098592	47.3802816901408
28	Madrid	163	28163	Valdepiélagos	305	157	148	51.4754098360656	48.5245901639344
28	Madrid	164	28164	Valdetorres de Jarama	2001	1034	967	51.6741629185407	48.3258370814593
28	Madrid	165	28165	Valdilecha	1860	953	907	51.2365591397849	48.7634408602151
28	Madrid	166	28166	Valverde de Alcalá	302	153	149	50.6622516556291	49.3377483443709
28	Madrid	167	28167	Velilla de San Antonio	6767	3473	3294	51.3225949460618	48.6774050539382
28	Madrid	168	28168	Vellón (El)	1129	579	550	51.2843224092117	48.7156775907883
28	Madrid	169	28169	Venturada	819	432	387	52.7472527472528	47.2527472527472
28	Madrid	170	28170	Villaconejos	2870	1457	1413	50.7665505226481	49.2334494773519
28	Madrid	171	28171	Villa del Prado	3932	2009	1923	51.0935910478128	48.9064089521872
28	Madrid	172	28172	Villalbilla	4156	2188	1968	52.6467757459095	47.3532242540905
28	Madrid	173	28173	Villamanrique de Tajo	593	297	296	50.0843170320405	49.9156829679595
28	Madrid	174	28174	Villamanta	1571	808	763	51.4322087842139	48.5677912157861
28	Madrid	175	28175	Villamantilla	334	175	159	52.3952095808383	47.6047904191617
28	Madrid	176	28176	Villanueva de la Cañada	10706	5315	5391	49.6450588455072	50.3549411544928
28	Madrid	177	28177	Villanueva del Pardillo	4733	2396	2337	50.623283329812	49.376716670188
28	Madrid	178	28178	Villanueva de Perales	467	258	209	55.2462526766595	44.7537473233405
28	Madrid	179	28179	Villar del Olmo	1427	726	701	50.8759635599159	49.1240364400841
28	Madrid	180	28180	Villarejo de Salvanés	5650	2820	2830	49.9115044247788	50.0884955752212
28	Madrid	181	28181	Villaviciosa de Odón	19393	9616	9777	49.5849017686794	50.4150982313206
28	Madrid	182	28182	Villavieja del Lozoya	178	86	92	48.314606741573	51.685393258427
28	Madrid	183	28183	Zarzalejo	1046	533	513	50.9560229445507	49.0439770554493
28	Madrid	901	28901	Lozoyuela-Navas-Sieteiglesias	654	353	301	53.9755351681957	46.0244648318043
28	Madrid	902	28902	Puentes Viejas	414	227	187	54.8309178743961	45.1690821256039
28	Madrid	903	28903	Tres Cantos	35046	17387	17659	49.6119385949894	50.3880614050106
29	Málaga	001	29001	Alameda	5002	2484	2518	49.6601359456218	50.3398640543782
29	Málaga	002	29002	Alcaucín	1511	758	753	50.1654533421575	49.8345466578425
29	Málaga	003	29003	Alfarnate	1443	741	702	51.3513513513514	48.6486486486487
29	Málaga	004	29004	Alfarnatejo	399	213	186	53.3834586466165	46.6165413533835
29	Málaga	005	29005	Algarrobo	4852	2402	2450	49.5053586150041	50.4946413849959
29	Málaga	006	29006	Algatocín	949	478	471	50.3688092729189	49.6311907270811
29	Málaga	007	29007	Alhaurín de la Torre	21649	10796	10853	49.8683541964987	50.1316458035013
29	Málaga	008	29008	Alhaurín el Grande	17021	8509	8512	49.9911873567945	50.0088126432055
29	Málaga	009	29009	Almáchar	1904	970	934	50.9453781512605	49.0546218487395
29	Málaga	010	29010	Almargen	2104	1012	1092	48.0988593155894	51.9011406844107
29	Málaga	011	29011	Almogía	4072	2057	2015	50.5157170923379	49.4842829076621
29	Málaga	012	29012	Álora	12509	6263	6246	50.0679510752258	49.9320489247742
29	Málaga	013	29013	Alozaina	2145	1119	1026	52.1678321678322	47.8321678321678
29	Málaga	014	29014	Alpandeire	316	160	156	50.6329113924051	49.3670886075949
29	Málaga	015	29015	Antequera	40598	19867	20731	48.9359081728164	51.0640918271836
29	Málaga	016	29016	Árchez	352	176	176	50	50
29	Málaga	017	29017	Archidona	8171	4046	4125	49.5165830375719	50.4834169624281
29	Málaga	018	29018	Ardales	2903	1425	1478	49.0871512228729	50.9128487771271
29	Málaga	019	29019	Arenas	1191	643	548	53.9882451721243	46.0117548278757
29	Málaga	020	29020	Arriate	3420	1651	1769	48.2748538011696	51.7251461988304
29	Málaga	021	29021	Atajate	164	88	76	53.6585365853659	46.3414634146342
29	Málaga	022	29022	Benadalid	262	137	125	52.2900763358779	47.7099236641221
29	Málaga	023	29023	Benahavís	2079	1040	1039	50.02405002405	49.97594997595
29	Málaga	024	29024	Benalauría	499	258	241	51.7034068136273	48.2965931863727
29	Málaga	025	29025	Benalmádena	31964	15709	16255	49.1459141534226	50.8540858465774
29	Málaga	026	29026	Benamargosa	1551	785	766	50.6125080593166	49.3874919406834
29	Málaga	027	29027	Benamocarra	2811	1405	1406	49.9822127356813	50.0177872643187
29	Málaga	028	29028	Benaoján	1648	819	829	49.6966019417476	50.3033980582524
29	Málaga	029	29029	Benarrabá	630	333	297	52.8571428571429	47.1428571428571
29	Málaga	030	29030	Borge (El)	1021	520	501	50.9304603330069	49.0695396669931
29	Málaga	031	29031	Burgo (El)	1982	1009	973	50.9081735620585	49.0918264379415
29	Málaga	032	29032	Campillos	7657	3836	3821	50.0979495886117	49.9020504113883
29	Málaga	033	29033	Canillas de Aceituno	2213	1112	1101	50.2485314053321	49.7514685946679
29	Málaga	034	29034	Canillas de Albaida	701	372	329	53.0670470756063	46.9329529243937
29	Málaga	035	29035	Cañete la Real	2200	1131	1069	51.4090909090909	48.5909090909091
29	Málaga	036	29036	Carratraca	838	413	425	49.2840095465394	50.7159904534606
29	Málaga	037	29037	Cartajima	214	112	102	52.3364485981308	47.6635514018692
29	Málaga	038	29038	Cártama	13188	6650	6538	50.4246284501062	49.5753715498938
29	Málaga	039	29039	Casabermeja	3003	1570	1433	52.2810522810523	47.7189477189477
29	Málaga	040	29040	Casarabonela	2553	1291	1262	50.5679592636114	49.4320407363886
29	Málaga	041	29041	Casares	3309	1728	1581	52.2212148685403	47.7787851314597
29	Málaga	042	29042	Coín	17868	8893	8975	49.7705395119767	50.2294604880233
29	Málaga	043	29043	Colmenar	3124	1523	1601	48.7516005121639	51.2483994878361
29	Málaga	044	29044	Comares	1399	721	678	51.5368120085776	48.4631879914224
29	Málaga	045	29045	Cómpeta	2793	1408	1385	50.4117436448264	49.5882563551737
29	Málaga	046	29046	Cortes de la Frontera	3513	1760	1753	50.0996299459152	49.9003700540848
29	Málaga	047	29047	Cuevas Bajas	1473	710	763	48.2009504412763	51.7990495587237
29	Málaga	048	29048	Cuevas del Becerro	1960	984	976	50.2040816326531	49.7959183673469
29	Málaga	049	29049	Cuevas de San Marcos	4008	1975	2033	49.2764471057884	50.7235528942116
29	Málaga	050	29050	Cútar	603	304	299	50.4145936981758	49.5854063018242
29	Málaga	051	29051	Estepona	42157	20898	21259	49.5718386033162	50.4281613966838
29	Málaga	052	29052	Faraján	288	131	157	45.4861111111111	54.5138888888889
29	Málaga	053	29053	Frigiliana	2169	1067	1102	49.1931765790687	50.8068234209313
29	Málaga	054	29054	Fuengirola	47914	23444	24470	48.9293317193305	51.0706682806695
29	Málaga	055	29055	Fuente de Piedra	1913	923	990	48.2488238369054	51.7511761630946
29	Málaga	056	29056	Gaucín	1705	888	817	52.0821114369502	47.9178885630499
29	Málaga	057	29057	Genalguacil	575	297	278	51.6521739130435	48.3478260869565
29	Málaga	058	29058	Guaro	1877	948	929	50.506126798082	49.493873201918
29	Málaga	059	29059	Humilladero	2469	1253	1216	50.7492912110166	49.2507087889834
29	Málaga	060	29060	Igualeja	922	462	460	50.1084598698482	49.8915401301518
29	Málaga	061	29061	Istán	1348	674	674	50	50
29	Málaga	062	29062	Iznate	757	385	372	50.8586525759577	49.1413474240423
29	Málaga	063	29063	Jimera de Líbar	401	193	208	48.1296758104738	51.8703241895262
29	Málaga	064	29064	Jubrique	843	418	425	49.5848161328588	50.4151838671412
29	Málaga	065	29065	Júzcar	242	134	108	55.3719008264463	44.6280991735537
29	Málaga	066	29066	Macharaviaya	353	191	162	54.1076487252125	45.8923512747875
29	Málaga	067	29067	Málaga	531565	252570	278995	47.5144149821753	52.4855850178247
29	Málaga	068	29068	Manilva	5768	2936	2832	50.9015256588072	49.0984743411928
29	Málaga	069	29069	Marbella	105910	52263	53647	49.3466150505146	50.6533849494854
29	Málaga	070	29070	Mijas	41912	20973	20939	50.0405611757969	49.9594388242031
29	Málaga	071	29071	Moclinejo	1116	567	549	50.8064516129032	49.1935483870968
29	Málaga	072	29072	Mollina	3416	1663	1753	48.6826697892272	51.3173302107728
29	Málaga	073	29073	Monda	1685	838	847	49.7329376854599	50.2670623145401
29	Málaga	074	29074	Montejaque	1008	487	521	48.3134920634921	51.6865079365079
29	Málaga	075	29075	Nerja	16112	7936	8176	49.2552135054618	50.7447864945382
29	Málaga	076	29076	Ojén	2048	1078	970	52.63671875	47.36328125
29	Málaga	077	29077	Parauta	225	117	108	52	48
29	Málaga	079	29079	Periana	3387	1752	1635	51.7271922054916	48.2728077945084
29	Málaga	080	29080	Pizarra	6608	3215	3393	48.6531476997579	51.3468523002421
29	Málaga	081	29081	Pujerra	304	170	134	55.921052631579	44.078947368421
29	Málaga	082	29082	Rincón de la Victoria	23029	11568	11461	50.232315775761	49.767684224239
29	Málaga	083	29083	Riogordo	2692	1366	1326	50.7429420505201	49.2570579494799
29	Málaga	084	29084	Ronda	34021	16673	17348	49.0079656682637	50.9920343317363
29	Málaga	085	29085	Salares	208	102	106	49.0384615384615	50.9615384615385
29	Málaga	086	29086	Sayalonga	1177	609	568	51.7417162276975	48.2582837723025
29	Málaga	087	29087	Sedella	490	262	228	53.469387755102	46.530612244898
29	Málaga	088	29088	Sierra de Yeguas	3221	1590	1631	49.3635516920211	50.6364483079789
29	Málaga	089	29089	Teba	4383	2239	2144	51.0837326032398	48.9162673967602
29	Málaga	090	29090	Tolox	2390	1235	1155	51.673640167364	48.326359832636
29	Málaga	091	29091	Torrox	12094	5991	6103	49.5369604762692	50.4630395237308
29	Málaga	092	29092	Totalán	616	311	305	50.487012987013	49.512987012987
29	Málaga	093	29093	Valle de Abdalajís	3007	1471	1536	48.9191885600266	51.0808114399734
29	Málaga	094	29094	Vélez-Málaga	55156	27340	27816	49.5684966277468	50.4315033722533
29	Málaga	095	29095	Villanueva de Algaidas	4183	2068	2115	49.438202247191	50.561797752809
29	Málaga	096	29096	Villanueva del Rosario	3318	1626	1692	49.005424954792	50.994575045208
29	Málaga	097	29097	Villanueva del Trabuco	4760	2413	2347	50.6932773109244	49.3067226890756
29	Málaga	098	29098	Villanueva de Tapia	1621	833	788	51.3880320789636	48.6119679210364
29	Málaga	099	29099	Viñuela	1200	597	603	49.75	50.25
29	Málaga	100	29100	Yunquera	3268	1700	1568	52.0195838433293	47.9804161566708
29	Málaga	901	29901	Torremolinos	41281	20376	20905	49.3592693975437	50.6407306024564
30	Murcia	001	30001	Abanilla	6106	3050	3056	49.9508679986898	50.0491320013102
30	Murcia	002	30002	Abarán	12241	6111	6130	49.9223919614411	50.0776080385589
30	Murcia	003	30003	Águilas	27559	13719	13840	49.7804709895134	50.2195290104866
30	Murcia	004	30004	Albudeite	1369	690	679	50.4017531044558	49.5982468955442
30	Murcia	005	30005	Alcantarilla	33453	16464	16989	49.2153170119272	50.7846829880728
30	Murcia	006	30006	Aledo	997	505	492	50.6519558676028	49.3480441323972
30	Murcia	007	30007	Alguazas	7052	3513	3539	49.8156551332955	50.1843448667045
30	Murcia	008	30008	Alhama de Murcia	15856	7925	7931	49.9810797174571	50.0189202825429
30	Murcia	009	30009	Archena	14516	7211	7305	49.6762193441719	50.3237806558281
30	Murcia	010	30010	Beniel	8116	4063	4053	50.0616067028093	49.9383932971907
30	Murcia	011	30011	Blanca	5749	2871	2878	49.9391198469299	50.0608801530701
30	Murcia	012	30012	Bullas	10753	5389	5364	50.1162466288478	49.8837533711522
30	Murcia	013	30013	Calasparra	8888	4440	4448	49.95499549955	50.04500450045
30	Murcia	014	30014	Campos del Río	2035	994	1041	48.8452088452088	51.1547911547912
30	Murcia	015	30015	Caravaca de la Cruz	22250	11034	11216	49.5910112359551	50.408988764045
30	Murcia	016	30016	Cartagena	179939	89098	90841	49.5156691990063	50.4843308009937
30	Murcia	017	30017	Cehegín	14171	7089	7082	50.0246983275704	49.9753016724296
30	Murcia	018	30018	Ceutí	7305	3703	3602	50.6913073237509	49.3086926762491
30	Murcia	019	30019	Cieza	32126	15752	16374	49.0319367490506	50.9680632509494
30	Murcia	020	30020	Fortuna	6814	3475	3339	50.997945406516	49.002054593484
30	Murcia	021	30021	Fuente Álamo de Murcia	10140	5201	4939	51.2919132149901	48.7080867850099
30	Murcia	022	30022	Jumilla	20854	10426	10428	49.9952047568812	50.0047952431188
30	Murcia	023	30023	Librilla	3908	1924	1984	49.2323439099284	50.7676560900716
30	Murcia	024	30024	Lorca	72000	35821	36179	49.7513888888889	50.2486111111111
30	Murcia	025	30025	Lorquí	5562	2772	2790	49.8381877022654	50.1618122977346
30	Murcia	026	30026	Mazarrón	18847	9840	9007	52.209900779965	47.790099220035
30	Murcia	027	30027	Molina de Segura	44389	22104	22285	49.796120660524	50.203879339476
30	Murcia	028	30028	Moratalla	8460	4275	4185	50.531914893617	49.468085106383
30	Murcia	029	30029	Mula	13738	6819	6919	49.6360460037851	50.3639539962149
30	Murcia	030	30030	Murcia	357166	174017	183149	48.721602840136	51.278397159864
30	Murcia	031	30031	Ojós	593	300	293	50.5902192242833	49.4097807757167
30	Murcia	032	30032	Pliego	3409	1746	1663	51.2173657964212	48.7826342035788
30	Murcia	033	30033	Puerto Lumbreras	10859	5338	5521	49.157380974307	50.842619025693
30	Murcia	034	30034	Ricote	1582	771	811	48.7357774968394	51.2642225031606
30	Murcia	035	30035	San Javier	18925	9550	9375	50.4623513870542	49.5376486129458
30	Murcia	036	30036	San Pedro del Pinatar	15583	7685	7898	49.316562921132	50.683437078868
30	Murcia	037	30037	Torre-Pacheco	22719	12499	10220	55.0156256877503	44.9843743122497
30	Murcia	038	30038	Torres de Cotillas (Las)	16003	8076	7927	50.4655377116791	49.5344622883209
30	Murcia	039	30039	Totana	22359	11314	11045	50.6015474752896	49.3984525247104
30	Murcia	040	30040	Ulea	959	483	476	50.3649635036496	49.6350364963504
30	Murcia	041	30041	Unión (La)	14606	7298	7308	49.9657674928112	50.0342325071888
30	Murcia	042	30042	Villanueva del Río Segura	1568	755	813	48.1505102040816	51.8494897959184
30	Murcia	043	30043	Yecla	29319	14742	14577	50.2813874961629	49.7186125038371
30	Murcia	901	30901	Santomera	10972	5490	5482	50.0364564345607	49.9635435654393
30	Murcia	902	30902	Alcázares (Los)	7513	3783	3730	50.3527219486224	49.6472780513776
31	Navarra	001	31001	Abáigar	97	53	44	54.639175257732	45.360824742268
31	Navarra	002	31002	Abárzuza	514	258	256	50.1945525291829	49.8054474708171
31	Navarra	003	31003	Abaurregaina/Abaurrea Alta	167	100	67	59.8802395209581	40.1197604790419
31	Navarra	004	31004	Abaurrepea/Abaurrea Baja	47	33	14	70.2127659574468	29.7872340425532
31	Navarra	005	31005	Aberin	362	191	171	52.7624309392265	47.2375690607735
31	Navarra	006	31006	Ablitas	2330	1197	1133	51.3733905579399	48.6266094420601
31	Navarra	007	31007	Adiós	143	73	70	51.0489510489511	48.951048951049
31	Navarra	008	31008	Aguilar de Codés	105	60	45	57.1428571428571	42.8571428571429
31	Navarra	009	31009	Aibar/Oibar	918	479	439	52.1786492374728	47.8213507625272
31	Navarra	010	31010	Altsasu/Alsasua	7124	3614	3510	50.7299270072993	49.2700729927007
31	Navarra	011	31011	Allín	824	429	395	52.0631067961165	47.9368932038835
31	Navarra	012	31012	Allo	1039	526	513	50.6256015399423	49.3743984600578
31	Navarra	013	31013	Améscoa Baja	796	415	381	52.1356783919598	47.8643216080402
31	Navarra	014	31014	Ancín	301	160	141	53.156146179402	46.843853820598
31	Navarra	015	31015	Andosilla	2423	1208	1215	49.8555509698721	50.1444490301279
31	Navarra	016	31016	Ansoáin	7133	3614	3519	50.6659189681761	49.3340810318239
31	Navarra	017	31017	Anue	419	245	174	58.472553699284	41.527446300716
31	Navarra	018	31018	Añorbe	445	239	206	53.7078651685393	46.2921348314607
31	Navarra	019	31019	Aoiz/Agoitz	1842	916	926	49.728555917481	50.271444082519
31	Navarra	020	31020	Araitz	611	357	254	58.4288052373159	41.5711947626841
31	Navarra	021	31021	Aranarache	95	47	48	49.4736842105263	50.5263157894737
31	Navarra	022	31022	Arantza	655	367	288	56.030534351145	43.969465648855
31	Navarra	023	31023	Aranguren	3746	1948	1798	52.0021356113187	47.9978643886813
31	Navarra	024	31024	Arano	151	82	69	54.3046357615894	45.6953642384106
31	Navarra	025	31025	Arakil	888	475	413	53.490990990991	46.509009009009
31	Navarra	026	31026	Aras	229	124	105	54.1484716157205	45.8515283842795
31	Navarra	027	31027	Arbizu	932	490	442	52.5751072961373	47.4248927038627
31	Navarra	028	31028	Arce/Artzi	305	172	133	56.3934426229508	43.6065573770492
31	Navarra	029	31029	Arcos (Los)	1315	654	661	49.7338403041825	50.2661596958175
31	Navarra	030	31030	Arellano	196	105	91	53.5714285714286	46.4285714285714
31	Navarra	031	31031	Areso	293	151	142	51.5358361774744	48.4641638225256
31	Navarra	032	31032	Arguedas	2265	1145	1120	50.551876379691	49.4481236203091
31	Navarra	033	31033	Aria	68	41	27	60.2941176470588	39.7058823529412
31	Navarra	034	31034	Aribe	60	31	29	51.6666666666667	48.3333333333333
31	Navarra	035	31035	Armañanzas	91	48	43	52.7472527472528	47.2527472527472
31	Navarra	036	31036	Arróniz	1172	620	552	52.901023890785	47.098976109215
31	Navarra	037	31037	Arruazu	100	53	47	53	47
31	Navarra	038	31038	Artajona	1679	891	788	53.0673019654556	46.9326980345444
31	Navarra	039	31039	Artazu	79	44	35	55.6962025316456	44.3037974683544
31	Navarra	040	31040	Atez	207	124	83	59.9033816425121	40.0966183574879
31	Navarra	041	31041	Ayegui	1002	520	482	51.8962075848303	48.1037924151697
31	Navarra	042	31042	Azagra	3530	1768	1762	50.0849858356941	49.915014164306
31	Navarra	043	31043	Azuelo	55	25	30	45.4545454545455	54.5454545454545
31	Navarra	044	31044	Bakaiku	360	201	159	55.8333333333333	44.1666666666667
31	Navarra	045	31045	Barásoain	443	224	219	50.5643340857788	49.4356659142212
31	Navarra	046	31046	Barbarin	98	44	54	44.8979591836735	55.1020408163265
31	Navarra	047	31047	Bargota	381	186	195	48.8188976377953	51.1811023622047
31	Navarra	048	31048	Barillas	199	99	100	49.748743718593	50.251256281407
31	Navarra	049	31049	Basaburua	676	387	289	57.2485207100592	42.7514792899408
31	Navarra	050	31050	Baztan	7598	3874	3724	50.9871018689129	49.0128981310871
31	Navarra	051	31051	Beire	307	152	155	49.5114006514658	50.4885993485342
31	Navarra	052	31052	Belascoáin	103	50	53	48.5436893203884	51.4563106796116
31	Navarra	053	31053	Berbinzana	720	357	363	49.5833333333333	50.4166666666667
31	Navarra	054	31054	Bertizarana	657	337	320	51.2937595129376	48.7062404870624
31	Navarra	055	31055	Betelu	348	186	162	53.448275862069	46.551724137931
31	Navarra	056	31056	Biurrun-Olcoz	180	95	85	52.7777777777778	47.2222222222222
31	Navarra	057	31057	Buñuel	2420	1194	1226	49.3388429752066	50.6611570247934
31	Navarra	058	31058	Auritz/Burguete	336	145	191	43.1547619047619	56.8452380952381
31	Navarra	059	31059	Burgui	236	133	103	56.3559322033898	43.6440677966102
31	Navarra	060	31060	Burlada/Burlata	16887	8337	8550	49.3693373600995	50.6306626399005
31	Navarra	061	31061	Busto (El)	102	55	47	53.921568627451	46.078431372549
31	Navarra	062	31062	Cabanillas	1503	783	720	52.0958083832335	47.9041916167665
31	Navarra	063	31063	Cabredo	127	68	59	53.5433070866142	46.4566929133858
31	Navarra	064	31064	Cadreita	1855	918	937	49.4878706199461	50.5121293800539
31	Navarra	065	31065	Caparroso	2324	1136	1188	48.881239242685	51.118760757315
31	Navarra	066	31066	Cárcar	1244	607	637	48.7942122186495	51.2057877813505
31	Navarra	067	31067	Carcastillo	2620	1306	1314	49.8473282442748	50.1526717557252
31	Navarra	068	31068	Cascante	3665	1825	1840	49.7953615279673	50.2046384720328
31	Navarra	069	31069	Cáseda	1060	518	542	48.8679245283019	51.1320754716981
31	Navarra	070	31070	Castejón	3143	1570	1573	49.9522748965956	50.0477251034044
31	Navarra	071	31071	Castillonuevo	22	14	8	63.6363636363636	36.3636363636364
31	Navarra	072	31072	Cintruénigo	5694	2841	2853	49.8946259220232	50.1053740779768
31	Navarra	073	31073	Ziordia	368	165	203	44.8369565217391	55.1630434782609
31	Navarra	074	31074	Cirauqui	454	254	200	55.9471365638767	44.0528634361233
31	Navarra	075	31075	Ciriza	64	26	38	40.625	59.375
31	Navarra	076	31076	Cizur	1308	662	646	50.611620795107	49.388379204893
31	Navarra	077	31077	Corella	6820	3410	3410	50	50
31	Navarra	078	31078	Cortes	3290	1698	1592	51.6109422492401	48.3890577507599
31	Navarra	079	31079	Desojo	144	79	65	54.8611111111111	45.1388888888889
31	Navarra	080	31080	Dicastillo	684	357	327	52.1929824561404	47.8070175438597
31	Navarra	081	31081	Donamaria	387	192	195	49.6124031007752	50.3875968992248
31	Navarra	082	31082	Etxalar	789	412	377	52.2179974651458	47.7820025348542
31	Navarra	083	31083	Echarri	51	29	22	56.8627450980392	43.1372549019608
31	Navarra	084	31084	Etxarri-Aranatz	2234	1144	1090	51.2085944494181	48.7914055505819
31	Navarra	085	31085	Etxauri	414	215	199	51.9323671497584	48.0676328502416
31	Navarra	086	31086	Egüés	2348	1200	1148	51.1073253833049	48.8926746166951
31	Navarra	087	31087	Elgorriaga	206	101	105	49.0291262135922	50.9708737864078
31	Navarra	088	31088	Noáin (Valle de Elorz)/Noain (Elortzibar)	3921	1972	1949	50.2932925274165	49.7067074725835
31	Navarra	089	31089	Enériz	192	99	93	51.5625	48.4375
31	Navarra	090	31090	Eratsun	180	112	68	62.2222222222222	37.7777777777778
31	Navarra	091	31091	Ergoiena	466	260	206	55.793991416309	44.206008583691
31	Navarra	092	31092	Erro	787	436	351	55.4002541296061	44.5997458703939
31	Navarra	093	31093	Ezcároz	362	191	171	52.7624309392265	47.2375690607735
31	Navarra	094	31094	Eslava	172	84	88	48.8372093023256	51.1627906976744
31	Navarra	095	31095	Esparza de Salazar	115	60	55	52.1739130434783	47.8260869565217
31	Navarra	096	31096	Espronceda	171	98	73	57.3099415204678	42.6900584795322
31	Navarra	097	31097	Estella/Lizarra	12683	6132	6551	48.3481826066388	51.6518173933612
31	Navarra	098	31098	Esteribar	1519	805	714	52.9953917050691	47.0046082949309
31	Navarra	099	31099	Etayo	96	48	48	50	50
31	Navarra	100	31100	Eulate	373	197	176	52.8150134048257	47.1849865951743
31	Navarra	101	31101	Ezcabarte	1202	647	555	53.8269550748752	46.1730449251248
31	Navarra	102	31102	Ezkurra	232	147	85	63.3620689655172	36.6379310344828
31	Navarra	103	31103	Ezprogui	63	31	32	49.2063492063492	50.7936507936508
31	Navarra	104	31104	Falces	2591	1267	1324	48.900038595137	51.099961404863
31	Navarra	105	31105	Fitero	1960	980	980	50	50
31	Navarra	106	31106	Fontellas	736	374	362	50.8152173913043	49.1847826086957
31	Navarra	107	31107	Funes	2188	1138	1050	52.0109689213894	47.9890310786106
31	Navarra	108	31108	Fustiñana	2304	1164	1140	50.5208333333333	49.4791666666667
31	Navarra	109	31109	Galar	1154	608	546	52.686308492201	47.313691507799
31	Navarra	110	31110	Gallipienzo	160	85	75	53.125	46.875
31	Navarra	111	31111	Gallués	122	78	44	63.9344262295082	36.0655737704918
31	Navarra	112	31112	Garaioa	130	70	60	53.8461538461539	46.1538461538462
31	Navarra	113	31113	Garde	199	109	90	54.7738693467337	45.2261306532663
31	Navarra	114	31114	Garínoain	356	190	166	53.3707865168539	46.6292134831461
31	Navarra	115	31115	Garralda	209	105	104	50.2392344497608	49.7607655502392
31	Navarra	116	31116	Genevilla	116	63	53	54.3103448275862	45.6896551724138
31	Navarra	117	31117	Goizueta	903	479	424	53.0454042081949	46.9545957918051
31	Navarra	118	31118	Goñi	188	111	77	59.0425531914894	40.9574468085106
31	Navarra	119	31119	Güesa	74	41	33	55.4054054054054	44.5945945945946
31	Navarra	120	31120	Guesálaz	480	280	200	58.3333333333333	41.6666666666667
31	Navarra	121	31121	Guirguillano	72	40	32	55.5555555555556	44.4444444444444
31	Navarra	122	31122	Huarte/Uharte	2862	1443	1419	50.41928721174	49.58071278826
31	Navarra	123	31123	Uharte-Arakil	770	416	354	54.025974025974	45.974025974026
31	Navarra	124	31124	Ibargoiti	237	135	102	56.9620253164557	43.0379746835443
31	Navarra	125	31125	Igúzquiza	363	182	181	50.137741046832	49.8622589531681
31	Navarra	126	31126	Imotz	408	229	179	56.1274509803922	43.8725490196079
31	Navarra	127	31127	Irañeta	160	84	76	52.5	47.5
31	Navarra	128	31128	Isaba/Izaba	525	257	268	48.952380952381	51.0476190476191
31	Navarra	129	31129	Ituren	470	236	234	50.2127659574468	49.7872340425532
31	Navarra	130	31130	Iturmendi	380	193	187	50.7894736842105	49.2105263157895
31	Navarra	131	31131	Iza	728	382	346	52.4725274725275	47.5274725274725
31	Navarra	132	31132	Izagaondoa	172	103	69	59.8837209302326	40.1162790697674
31	Navarra	133	31133	Izalzu	48	29	19	60.4166666666667	39.5833333333333
31	Navarra	134	31134	Jaurrieta	254	134	120	52.755905511811	47.244094488189
31	Navarra	135	31135	Javier	119	51	68	42.8571428571429	57.1428571428571
31	Navarra	136	31136	Juslapeña	469	263	206	56.0767590618337	43.9232409381663
31	Navarra	137	31137	Beintza-Labaien	290	160	130	55.1724137931034	44.8275862068966
31	Navarra	138	31138	Lakuntza	977	505	472	51.6888433981576	48.3111566018424
31	Navarra	139	31139	Lana	215	123	92	57.2093023255814	42.7906976744186
31	Navarra	140	31140	Lantz	123	77	46	62.6016260162602	37.3983739837398
31	Navarra	141	31141	Lapoblación	195	108	87	55.3846153846154	44.6153846153846
31	Navarra	142	31142	Larraga	1892	1014	878	53.5940803382664	46.4059196617336
31	Navarra	143	31143	Larraona	156	81	75	51.9230769230769	48.0769230769231
31	Navarra	144	31144	Larraun	1106	626	480	56.6003616636528	43.3996383363472
31	Navarra	145	31145	Lazagurría	227	122	105	53.7444933920705	46.2555066079295
31	Navarra	146	31146	Leache	49	30	19	61.2244897959184	38.7755102040816
31	Navarra	147	31147	Legarda	80	46	34	57.5	42.5
31	Navarra	148	31148	Legaria	120	61	59	50.8333333333333	49.1666666666667
31	Navarra	149	31149	Leitza	2939	1538	1401	52.3307247363049	47.6692752636951
31	Navarra	150	31150	Leoz	258	161	97	62.4031007751938	37.5968992248062
31	Navarra	151	31151	Lerga	84	44	40	52.3809523809524	47.6190476190476
31	Navarra	152	31152	Lerín	1916	960	956	50.1043841336117	49.8956158663883
31	Navarra	153	31153	Lesaka	2681	1412	1269	52.6669153301007	47.3330846698993
31	Navarra	154	31154	Lezáun	278	161	117	57.9136690647482	42.0863309352518
31	Navarra	155	31155	Liédena	331	153	178	46.2235649546828	53.7764350453172
31	Navarra	156	31156	Lizoáin	236	141	95	59.7457627118644	40.2542372881356
31	Navarra	157	31157	Lodosa	4598	2337	2261	50.8264462809917	49.1735537190083
31	Navarra	158	31158	Lónguida	296	156	140	52.7027027027027	47.2972972972973
31	Navarra	159	31159	Lumbier	1434	764	670	53.2775453277545	46.7224546722455
31	Navarra	160	31160	Luquin	127	69	58	54.3307086614173	45.6692913385827
31	Navarra	161	31161	Mañeru	362	188	174	51.9337016574586	48.0662983425414
31	Navarra	162	31162	Marañón	72	39	33	54.1666666666667	45.8333333333333
31	Navarra	163	31163	Marcilla	2574	1339	1235	52.020202020202	47.979797979798
31	Navarra	164	31164	Mélida	814	428	386	52.5798525798526	47.4201474201474
31	Navarra	165	31165	Mendavia	3580	1781	1799	49.7486033519553	50.2513966480447
31	Navarra	166	31166	Mendaza	367	177	190	48.2288828337875	51.7711171662125
31	Navarra	167	31167	Mendigorría	899	462	437	51.3904338153504	48.6095661846496
31	Navarra	168	31168	Metauten	300	161	139	53.6666666666667	46.3333333333333
31	Navarra	169	31169	Milagro	2599	1276	1323	49.0958060792613	50.9041939207387
31	Navarra	170	31170	Mirafuentes	52	28	24	53.8461538461539	46.1538461538462
31	Navarra	171	31171	Miranda de Arga	997	510	487	51.1534603811434	48.8465396188566
31	Navarra	172	31172	Monreal	289	155	134	53.6332179930796	46.3667820069204
31	Navarra	173	31173	Monteagudo	1175	590	585	50.2127659574468	49.7872340425532
31	Navarra	174	31174	Morentin	128	63	65	49.21875	50.78125
31	Navarra	175	31175	Mues	104	56	48	53.8461538461539	46.1538461538462
31	Navarra	176	31176	Murchante	3070	1514	1556	49.3159609120521	50.6840390879479
31	Navarra	177	31177	Murieta	273	149	124	54.5787545787546	45.4212454212454
31	Navarra	178	31178	Murillo el Cuende	649	350	299	53.9291217257319	46.0708782742681
31	Navarra	179	31179	Murillo el Fruto	750	374	376	49.8666666666667	50.1333333333333
31	Navarra	180	31180	Muruzábal	249	127	122	51.004016064257	48.995983935743
31	Navarra	181	31181	Navascués	213	133	80	62.4413145539906	37.5586854460094
31	Navarra	182	31182	Nazar	56	32	24	57.1428571428571	42.8571428571429
31	Navarra	183	31183	Obanos	772	372	400	48.1865284974093	51.8134715025907
31	Navarra	184	31184	Oco	85	50	35	58.8235294117647	41.1764705882353
31	Navarra	185	31185	Ochagavía	681	351	330	51.5418502202643	48.4581497797357
31	Navarra	186	31186	Odieta	318	175	143	55.0314465408805	44.9685534591195
31	Navarra	187	31187	Oitz	144	88	56	61.1111111111111	38.8888888888889
31	Navarra	188	31188	Olaibar	170	91	79	53.5294117647059	46.4705882352941
31	Navarra	189	31189	Olazti/Olazagutía	1654	856	798	51.7533252720677	48.2466747279323
31	Navarra	190	31190	Olejua	54	26	28	48.1481481481482	51.8518518518519
31	Navarra	191	31191	Olite	3130	1566	1564	50.0319488817891	49.9680511182109
31	Navarra	192	31192	Olóriz	175	100	75	57.1428571428571	42.8571428571429
31	Navarra	193	31193	Olza	1371	711	660	51.8599562363239	48.1400437636762
31	Navarra	194	31194	Ollo	318	181	137	56.9182389937107	43.0817610062893
31	Navarra	195	31195	Orbaitzeta	236	131	105	55.5084745762712	44.4915254237288
31	Navarra	196	31196	Orbara	58	29	29	50	50
31	Navarra	197	31197	Orísoain	99	57	42	57.5757575757576	42.4242424242424
31	Navarra	198	31198	Oronz	57	31	26	54.3859649122807	45.6140350877193
31	Navarra	199	31199	Oroz-Betelu	221	119	102	53.8461538461539	46.1538461538462
31	Navarra	200	31200	Oteiza	897	466	431	51.9509476031215	48.0490523968785
31	Navarra	201	31201	Pamplona/Iruña	182666	87268	95398	47.7746269146968	52.2253730853032
31	Navarra	202	31202	Peralta	5082	2574	2508	50.6493506493506	49.3506493506493
31	Navarra	203	31203	Petilla de Aragón	43	22	21	51.1627906976744	48.8372093023256
31	Navarra	204	31204	Piedramillera	67	39	28	58.2089552238806	41.7910447761194
31	Navarra	205	31205	Pitillas	572	291	281	50.8741258741259	49.1258741258741
31	Navarra	206	31206	Puente la Reina/Gares	2276	1131	1145	49.6924428822496	50.3075571177504
31	Navarra	207	31207	Pueyo	310	163	147	52.5806451612903	47.4193548387097
31	Navarra	208	31208	Ribaforada	3188	1632	1556	51.1919698870765	48.8080301129235
31	Navarra	209	31209	Romanzado	168	99	69	58.9285714285714	41.0714285714286
31	Navarra	210	31210	Roncal	354	172	182	48.5875706214689	51.4124293785311
31	Navarra	211	31211	Orreaga/Roncesvalles	31	16	15	51.6129032258065	48.3870967741936
31	Navarra	212	31212	Sada	239	127	112	53.1380753138075	46.8619246861925
31	Navarra	213	31213	Saldías	151	83	68	54.9668874172185	45.0331125827815
31	Navarra	214	31214	Salinas de Oro	114	63	51	55.2631578947369	44.7368421052632
31	Navarra	215	31215	San Adrián	5330	2592	2738	48.6303939962477	51.3696060037523
31	Navarra	216	31216	Sangüesa/Zangoza	4673	2406	2267	51.4872672801199	48.5127327198802
31	Navarra	217	31217	San Martín de Unx	471	252	219	53.5031847133758	46.4968152866242
31	Navarra	219	31219	Sansol	123	60	63	48.7804878048781	51.219512195122
31	Navarra	220	31220	Santacara	1050	536	514	51.0476190476191	48.952380952381
31	Navarra	221	31221	Doneztebe/Santesteban	1359	670	689	49.3009565857248	50.6990434142752
31	Navarra	222	31222	Sarriés	77	46	31	59.7402597402597	40.2597402597403
31	Navarra	223	31223	Sartaguda	1357	692	665	50.9948415622697	49.0051584377303
31	Navarra	224	31224	Sesma	1364	655	709	48.0205278592375	51.9794721407625
31	Navarra	225	31225	Sorlada	52	27	25	51.9230769230769	48.0769230769231
31	Navarra	226	31226	Sunbilla	688	358	330	52.0348837209302	47.9651162790698
31	Navarra	227	31227	Tafalla	10288	5071	5217	49.2904354587869	50.7095645412131
31	Navarra	228	31228	Tiebas-Muruarte de Reta	574	308	266	53.6585365853659	46.3414634146342
31	Navarra	229	31229	Tirapu	64	35	29	54.6875	45.3125
31	Navarra	230	31230	Torralba del Río	155	84	71	54.1935483870968	45.8064516129032
31	Navarra	231	31231	Torres del Río	182	85	97	46.7032967032967	53.2967032967033
31	Navarra	232	31232	Tudela	27819	13549	14270	48.7041230813473	51.2958769186527
31	Navarra	233	31233	Tulebras	108	36	72	33.3333333333333	66.6666666666667
31	Navarra	234	31234	Ucar	116	67	49	57.7586206896552	42.2413793103448
31	Navarra	235	31235	Ujué	238	124	114	52.1008403361345	47.8991596638655
31	Navarra	236	31236	Ultzama	1614	816	798	50.5576208178439	49.4423791821561
31	Navarra	237	31237	Unciti	228	141	87	61.8421052631579	38.1578947368421
31	Navarra	238	31238	Unzué	138	82	56	59.4202898550725	40.5797101449275
31	Navarra	239	31239	Urdazubi/Urdax	392	188	204	47.9591836734694	52.0408163265306
31	Navarra	240	31240	Urdiain	639	327	312	51.1737089201878	48.8262910798122
31	Navarra	241	31241	Urraul Alto	170	97	73	57.0588235294118	42.9411764705882
31	Navarra	242	31242	Urraul Bajo	279	134	145	48.0286738351254	51.9713261648746
31	Navarra	243	31243	Urroz	361	190	171	52.6315789473684	47.3684210526316
31	Navarra	244	31244	Urrotz	208	119	89	57.2115384615385	42.7884615384615
31	Navarra	245	31245	Urzainqui	109	57	52	52.2935779816514	47.7064220183486
31	Navarra	246	31246	Uterga	138	67	71	48.5507246376812	51.4492753623188
31	Navarra	247	31247	Uztárroz/Uztarroze	266	133	133	50	50
31	Navarra	248	31248	Luzaide/Valcarlos	470	232	238	49.3617021276596	50.6382978723404
31	Navarra	249	31249	Valtierra	2430	1177	1253	48.4362139917696	51.5637860082305
31	Navarra	250	31250	Bera/Vera de Bidasoa	3490	1767	1723	50.6303724928367	49.3696275071633
31	Navarra	251	31251	Viana	3493	1815	1678	51.9610649871171	48.0389350128829
31	Navarra	252	31252	Vidángoz	115	61	54	53.0434782608696	46.9565217391304
31	Navarra	253	31253	Bidaurreta	96	59	37	61.4583333333333	38.5416666666667
31	Navarra	254	31254	Villafranca	2510	1239	1271	49.3625498007968	50.6374501992032
31	Navarra	255	31255	Villamayor de Monjardín	127	68	59	53.5433070866142	46.4566929133858
31	Navarra	256	31256	Hiriberri/Villanueva de Aezkoa	152	86	66	56.578947368421	43.421052631579
31	Navarra	257	31257	Villatuerta	778	402	376	51.6709511568123	48.3290488431877
31	Navarra	258	31258	Villava/Atarrabia	9333	4618	4715	49.4803385835208	50.5196614164792
31	Navarra	259	31259	Igantzi	588	304	284	51.7006802721089	48.2993197278912
31	Navarra	260	31260	Yerri	1436	762	674	53.0640668523677	46.9359331476323
31	Navarra	261	31261	Yesa	239	136	103	56.9037656903766	43.0962343096234
31	Navarra	262	31262	Zabalza	156	75	81	48.0769230769231	51.9230769230769
31	Navarra	263	31263	Zubieta	307	177	130	57.6547231270358	42.3452768729642
31	Navarra	264	31264	Zugarramurdi	234	120	114	51.2820512820513	48.7179487179487
31	Navarra	265	31265	Zúñiga	114	68	46	59.6491228070175	40.3508771929825
31	Navarra	901	31901	Barañain	20871	10242	10629	49.0728762397585	50.9271237602415
31	Navarra	902	31902	Berrioplano	1213	614	599	50.6183017312449	49.3816982687552
31	Navarra	903	31903	Berriozar	5557	2868	2689	51.6105812488753	48.3894187511247
31	Navarra	904	31904	Irurtzun	2112	1092	1020	51.7045454545455	48.2954545454546
31	Navarra	905	31905	Beriáin	2584	1280	1304	49.5356037151703	50.4643962848297
31	Navarra	906	31906	Orcoyen	1267	655	612	51.6969218626677	48.3030781373323
31	Navarra	907	31907	Zizur Mayor/Zizur Nagusia	10686	5306	5380	49.6537525734606	50.3462474265394
31	Navarra	908	31908	Lekunberri	825	422	403	51.1515151515152	48.8484848484849
32	Ourense	001	32001	Allariz	5158	2481	2677	48.1000387747189	51.8999612252811
32	Ourense	002	32002	Amoeiro	2293	1110	1183	48.4081988661143	51.5918011338857
32	Ourense	003	32003	Arnoia (A)	1211	562	649	46.4079273327828	53.5920726672172
32	Ourense	004	32004	Avión	2984	1304	1680	43.6997319034853	56.3002680965148
32	Ourense	005	32005	Baltar	1282	636	646	49.609984399376	50.390015600624
32	Ourense	006	32006	Bande	2602	1235	1367	47.4634896233666	52.5365103766334
32	Ourense	007	32007	Baños de Molgas	2222	1096	1126	49.3249324932493	50.6750675067507
32	Ourense	008	32008	Barbadás	6286	3053	3233	48.5682468978683	51.4317531021317
32	Ourense	009	32009	Barco de Valdeorras (O)	12767	6388	6379	50.0352471214851	49.9647528785149
32	Ourense	010	32010	Beade	614	302	312	49.185667752443	50.814332247557
32	Ourense	011	32011	Beariz	1704	793	911	46.537558685446	53.462441314554
32	Ourense	012	32012	Blancos (Os)	1322	657	665	49.6974281391831	50.302571860817
32	Ourense	013	32013	Boborás	3462	1576	1886	45.5228191796649	54.4771808203351
32	Ourense	014	32014	Bola (A)	1566	727	839	46.4240102171137	53.5759897828863
32	Ourense	015	32015	Bolo (O)	1432	700	732	48.8826815642458	51.1173184357542
32	Ourense	016	32016	Calvos de Randín	1256	633	623	50.3980891719745	49.6019108280255
32	Ourense	017	32017	Carballeda de Valdeorras	2313	1161	1152	50.1945525291829	49.8054474708171
32	Ourense	018	32018	Carballeda de Avia	1685	803	882	47.6557863501484	52.3442136498516
32	Ourense	019	32019	Carballiño (O)	12434	5878	6556	47.2736046324594	52.7263953675406
32	Ourense	020	32020	Cartelle	3927	1879	2048	47.8482302011714	52.1517697988286
32	Ourense	021	32021	Castrelo do Val	1336	654	682	48.9520958083832	51.0479041916168
32	Ourense	022	32022	Castrelo de Miño	2153	1029	1124	47.7937761263353	52.2062238736647
32	Ourense	023	32023	Castro Caldelas	1919	972	947	50.6513809275664	49.3486190724336
32	Ourense	024	32024	Celanova	5960	2804	3156	47.0469798657718	52.9530201342282
32	Ourense	025	32025	Cenlle	1673	784	889	46.8619246861925	53.1380753138075
32	Ourense	026	32026	Coles	3162	1579	1583	49.9367488931056	50.0632511068944
32	Ourense	027	32027	Cortegada	1441	697	744	48.3691880638446	51.6308119361555
32	Ourense	028	32028	Cualedro	2457	1239	1218	50.4273504273504	49.5726495726496
32	Ourense	029	32029	Chandrexa de Queixa	897	494	403	55.072463768116	44.9275362318841
32	Ourense	030	32030	Entrimo	1474	664	810	45.0474898236092	54.9525101763908
32	Ourense	031	32031	Esgos	1339	652	687	48.6930545182972	51.3069454817028
32	Ourense	032	32032	Xinzo de Limia	9599	4740	4859	49.3801437649755	50.6198562350245
32	Ourense	033	32033	Gomesende	1205	554	651	45.9751037344398	54.0248962655602
32	Ourense	034	32034	Gudiña (A)	1724	855	869	49.5939675174014	50.4060324825986
32	Ourense	035	32035	Irixo (O)	2185	1010	1175	46.2242562929062	53.7757437070938
32	Ourense	036	32036	Xunqueira de Ambía	2097	1018	1079	48.5455412494039	51.4544587505961
32	Ourense	037	32037	Xunqueira de Espadanedo	1097	523	574	47.6754785779398	52.3245214220602
32	Ourense	038	32038	Larouco	617	292	325	47.3257698541329	52.6742301458671
32	Ourense	039	32039	Laza	2027	1014	1013	50.0246669955599	49.9753330044401
32	Ourense	040	32040	Leiro	2046	961	1085	46.969696969697	53.030303030303
32	Ourense	041	32041	Lobeira	1286	612	674	47.5894245723173	52.4105754276827
32	Ourense	042	32042	Lobios	2691	1289	1402	47.900408769974	52.099591230026
32	Ourense	043	32043	Maceda	3387	1650	1737	48.7156775907883	51.2843224092117
32	Ourense	044	32044	Manzaneda	1264	648	616	51.2658227848101	48.7341772151899
32	Ourense	045	32045	Maside	3297	1551	1746	47.0427661510464	52.9572338489536
32	Ourense	046	32046	Melón	1601	715	886	44.6595877576515	55.3404122423485
32	Ourense	047	32047	Merca (A)	2426	1157	1269	47.6916735366859	52.3083264633141
32	Ourense	048	32048	Mezquita (A)	1549	783	766	50.5487411233054	49.4512588766946
32	Ourense	049	32049	Montederramo	1285	663	622	51.5953307392996	48.4046692607004
32	Ourense	050	32050	Monterrei	3425	1702	1723	49.6934306569343	50.3065693430657
32	Ourense	051	32051	Muíños	2042	983	1059	48.1390793339863	51.8609206660137
32	Ourense	052	32052	Nogueira de Ramuín	2667	1256	1411	47.0941132358455	52.9058867641545
32	Ourense	053	32053	Oímbra	2021	1022	999	50.5690252350322	49.4309747649678
32	Ourense	054	32054	Ourense	108647	50818	57829	46.7734958167276	53.2265041832724
32	Ourense	055	32055	Paderne de Allariz	1714	818	896	47.7246207701284	52.2753792298717
32	Ourense	056	32056	Padrenda	2836	1342	1494	47.3201692524683	52.6798307475317
32	Ourense	057	32057	Parada de Sil	909	429	480	47.1947194719472	52.8052805280528
32	Ourense	058	32058	Pereiro de Aguiar (O)	4892	2405	2487	49.1618969746525	50.8381030253475
32	Ourense	059	32059	Peroxa (A)	2590	1214	1376	46.8725868725869	53.1274131274131
32	Ourense	060	32060	Petín	1139	551	588	48.3757682177349	51.6242317822651
32	Ourense	061	32061	Piñor	1620	797	823	49.1975308641975	50.8024691358025
32	Ourense	062	32062	Porqueira	1192	563	629	47.2315436241611	52.7684563758389
32	Ourense	063	32063	Pobra de Trives (A)	2911	1438	1473	49.3988320164892	50.6011679835108
32	Ourense	064	32064	Pontedeva	708	323	385	45.6214689265537	54.3785310734463
32	Ourense	065	32065	Punxín	978	455	523	46.5235173824131	53.4764826175869
32	Ourense	066	32066	Quintela de Leirado	950	440	510	46.3157894736842	53.6842105263158
32	Ourense	067	32067	Rairiz de Veiga	1895	933	962	49.2348284960422	50.7651715039578
32	Ourense	068	32068	Ramirás	2077	963	1114	46.3649494463168	53.6350505536832
32	Ourense	069	32069	Ribadavia	5509	2654	2855	48.1757124705028	51.8242875294972
32	Ourense	070	32070	San Xoán de Río	1030	488	542	47.378640776699	52.621359223301
32	Ourense	071	32071	Riós	2265	1126	1139	49.7130242825607	50.2869757174393
32	Ourense	072	32072	Rúa (A)	5008	2443	2565	48.7819488817891	51.2180511182109
32	Ourense	073	32073	Rubiá	1828	900	928	49.2341356673961	50.7658643326039
32	Ourense	074	32074	San Amaro	1534	741	793	48.3050847457627	51.6949152542373
32	Ourense	075	32075	San Cibrao das Viñas	3614	1747	1867	48.3397897066962	51.6602102933038
32	Ourense	076	32076	San Cristovo de Cea	3232	1551	1681	47.9888613861386	52.0111386138614
32	Ourense	077	32077	Sandiás	1712	787	925	45.9696261682243	54.0303738317757
32	Ourense	078	32078	Sarreaus	1917	944	973	49.2436098069901	50.7563901930099
32	Ourense	079	32079	Taboadela	1755	881	874	50.1994301994302	49.8005698005698
32	Ourense	080	32080	Teixeira (A)	597	276	321	46.2311557788945	53.7688442211055
32	Ourense	081	32081	Toén	2623	1325	1298	50.5146778497903	49.4853221502097
32	Ourense	082	32082	Trasmiras	1940	948	992	48.8659793814433	51.1340206185567
32	Ourense	083	32083	Veiga (A)	1446	717	729	49.5850622406639	50.4149377593361
32	Ourense	084	32084	Verea	1516	732	784	48.2849604221636	51.7150395778364
32	Ourense	085	32085	Verín	13033	6353	6680	48.745492212077	51.254507787923
32	Ourense	086	32086	Viana do Bolo	4089	2027	2062	49.5720224993886	50.4279775006114
32	Ourense	087	32087	Vilamarín	2262	1113	1149	49.2042440318302	50.7957559681698
32	Ourense	088	32088	Vilamartín de Valdeorras	2502	1213	1289	48.4812150279776	51.5187849720224
32	Ourense	089	32089	Vilar de Barrio	2084	1040	1044	49.9040307101727	50.0959692898273
32	Ourense	090	32090	Vilar de Santos	1033	505	528	48.8867376573088	51.1132623426912
32	Ourense	091	32091	Vilardevós	2931	1465	1466	49.9829409757762	50.0170590242238
32	Ourense	092	32092	Vilariño de Conso	854	467	387	54.6838407494145	45.3161592505855
33	Asturias	001	33001	Allande	2501	1287	1214	51.4594162335066	48.5405837664934
33	Asturias	002	33002	Aller	15398	7566	7832	49.1362514612287	50.8637485387713
33	Asturias	003	33003	Amieva	905	477	428	52.707182320442	47.292817679558
33	Asturias	004	33004	Avilés	83930	40344	43586	48.0686286190873	51.9313713809127
33	Asturias	005	33005	Belmonte de Miranda	2304	1180	1124	51.2152777777778	48.7847222222222
33	Asturias	006	33006	Bimenes	2174	1039	1135	47.7920883164673	52.2079116835327
33	Asturias	007	33007	Boal	2529	1253	1276	49.5452748121787	50.4547251878213
33	Asturias	008	33008	Cabrales	2371	1194	1177	50.3584985238296	49.6415014761704
33	Asturias	009	33009	Cabranes	1269	628	641	49.4877856579984	50.5122143420016
33	Asturias	010	33010	Candamo	2601	1248	1353	47.9815455594002	52.0184544405998
33	Asturias	011	33011	Cangas del Narcea	17161	8677	8484	50.5623215430336	49.4376784569664
33	Asturias	012	33012	Cangas de Onís	6343	3095	3248	48.7939460822954	51.2060539177046
33	Asturias	013	33013	Caravia	591	301	290	50.9306260575296	49.0693739424704
33	Asturias	014	33014	Carreño	10557	5125	5432	48.5459884436867	51.4540115563134
33	Asturias	015	33015	Caso	1990	1063	927	53.4170854271357	46.5829145728643
33	Asturias	016	33016	Castrillón	22593	10966	11627	48.5371575266676	51.4628424733325
33	Asturias	017	33017	Castropol	4357	2052	2305	47.0966261188891	52.9033738811109
33	Asturias	018	33018	Coaña	3692	1794	1898	48.5915492957747	51.4084507042254
33	Asturias	019	33019	Colunga	4387	2147	2240	48.940050148165	51.059949851835
33	Asturias	020	33020	Corvera de Asturias	16118	7865	8253	48.7963767216776	51.2036232783224
33	Asturias	021	33021	Cudillero	6127	2986	3141	48.7351069038681	51.2648930961319
33	Asturias	022	33022	Degaña	1528	802	726	52.4869109947644	47.5130890052356
33	Asturias	023	33023	Franco (El)	4154	2029	2125	48.8444872412133	51.1555127587867
33	Asturias	024	33024	Gijón	267426	126994	140432	47.4875292604309	52.5124707395691
33	Asturias	025	33025	Gozón	11194	5440	5754	48.5974629265678	51.4025370734322
33	Asturias	026	33026	Grado	11666	5603	6063	48.0284587690725	51.9715412309275
33	Asturias	027	33027	Grandas de Salime	1343	681	662	50.7073715562174	49.2926284437826
33	Asturias	028	33028	Ibias	2190	1164	1026	53.1506849315069	46.8493150684932
33	Asturias	029	33029	Illano	639	329	310	51.4866979655712	48.5133020344288
33	Asturias	030	33030	Illas	1126	588	538	52.2202486678508	47.7797513321492
33	Asturias	031	33031	Langreo	48886	23369	25517	47.8030519985272	52.1969480014728
33	Asturias	032	33032	Laviana	14804	7177	7627	48.4801405025669	51.5198594974331
33	Asturias	033	33033	Lena	13901	6750	7151	48.557657722466	51.442342277534
33	Asturias	034	33034	Valdés	15297	7459	7838	48.7611950055566	51.2388049944434
33	Asturias	035	33035	Llanera	11991	5885	6106	49.0784755233092	50.9215244766908
33	Asturias	036	33036	Llanes	13144	6327	6817	48.1360316494218	51.8639683505782
33	Asturias	037	33037	Mieres	49506	23692	25814	47.8568254353008	52.1431745646992
33	Asturias	038	33038	Morcín	3066	1496	1570	48.7932159165036	51.2067840834964
33	Asturias	039	33039	Muros de Nalón	2291	1075	1216	46.922741161065	53.077258838935
33	Asturias	040	33040	Nava	5656	2798	2858	49.4695898161245	50.5304101838755
33	Asturias	041	33041	Navia	9079	4362	4717	48.0449388699196	51.9550611300804
33	Asturias	042	33042	Noreña	4320	2067	2253	47.8472222222222	52.1527777777778
33	Asturias	043	33043	Onís	893	447	446	50.0559910414334	49.9440089585666
33	Asturias	044	33044	Oviedo	200411	93518	106893	46.6631073144688	53.3368926855312
33	Asturias	045	33045	Parres	5563	2715	2848	48.8046018335431	51.195398166457
33	Asturias	046	33046	Peñamellera Alta	740	366	374	49.4594594594595	50.5405405405405
33	Asturias	047	33047	Peñamellera Baja	1621	803	818	49.5373226403455	50.4626773596545
33	Asturias	048	33048	Pesoz	265	135	130	50.9433962264151	49.0566037735849
33	Asturias	049	33049	Piloña	8892	4317	4575	48.5492577597841	51.4507422402159
33	Asturias	050	33050	Ponga	760	451	309	59.3421052631579	40.6578947368421
33	Asturias	051	33051	Pravia	9419	4550	4869	48.3066142902644	51.6933857097356
33	Asturias	052	33052	Proaza	919	480	439	52.2306855277476	47.7693144722524
33	Asturias	053	33053	Quirós	1664	874	790	52.5240384615385	47.4759615384615
33	Asturias	054	33054	Regueras (Las)	2174	1075	1099	49.4480220791168	50.5519779208832
33	Asturias	055	33055	Ribadedeva	1891	924	967	48.8630354309889	51.1369645690111
33	Asturias	056	33056	Ribadesella	6245	2968	3277	47.5260208166533	52.4739791833467
33	Asturias	057	33057	Ribera de Arriba	1998	986	1012	49.3493493493494	50.6506506506507
33	Asturias	058	33058	Riosa	2578	1326	1252	51.4352211016292	48.5647788983708
33	Asturias	059	33059	Salas	6938	3382	3556	48.7460363217065	51.2539636782935
33	Asturias	060	33060	San Martín del Rey Aurelio	20794	9976	10818	47.9753775127441	52.0246224872559
33	Asturias	061	33061	San Martín de Oscos	524	264	260	50.381679389313	49.618320610687
33	Asturias	062	33062	Santa Eulalia de Oscos	591	296	295	50.0846023688663	49.9153976311337
33	Asturias	063	33063	San Tirso de Abres	643	307	336	47.7449455676516	52.2550544323484
33	Asturias	064	33064	Santo Adriano	335	169	166	50.4477611940299	49.5522388059702
33	Asturias	065	33065	Sariego	1393	689	704	49.4615936826992	50.5384063173008
33	Asturias	066	33066	Siero	47360	22869	24491	48.2875844594595	51.7124155405405
33	Asturias	067	33067	Sobrescobio	818	430	388	52.5672371638142	47.4327628361858
33	Asturias	068	33068	Somiedo	1621	862	759	53.1770512029611	46.8229487970389
33	Asturias	069	33069	Soto del Barco	4310	2057	2253	47.7262180974478	52.2737819025522
33	Asturias	070	33070	Tapia de Casariego	4368	2072	2296	47.4358974358974	52.5641025641026
33	Asturias	071	33071	Taramundi	906	435	471	48.0132450331126	51.9867549668874
33	Asturias	072	33072	Teverga	2264	1180	1084	52.1201413427562	47.8798586572438
33	Asturias	073	33073	Tineo	12931	6521	6410	50.4292011445364	49.5707988554636
33	Asturias	074	33074	Vegadeo	4759	2260	2499	47.4889682706451	52.5110317293549
33	Asturias	075	33075	Villanueva de Oscos	410	211	199	51.4634146341463	48.5365853658537
33	Asturias	076	33076	Villaviciosa	14275	6990	7285	48.9667250437828	51.0332749562172
33	Asturias	077	33077	Villayón	1966	1009	957	51.322482197355	48.677517802645
33	Asturias	078	33078	Yernes y Tameza	223	110	113	49.3273542600897	50.6726457399103
34	Palencia	001	34001	Abarca de Campos	50	26	24	52	48
34	Palencia	003	34003	Abia de las Torres	204	103	101	50.4901960784314	49.5098039215686
34	Palencia	004	34004	Aguilar de Campoo	7643	3730	3913	48.8028261153997	51.1971738846003
34	Palencia	005	34005	Alar del Rey	1303	615	688	47.1987720644666	52.8012279355334
34	Palencia	006	34006	Alba de Cerrato	101	49	52	48.5148514851485	51.4851485148515
34	Palencia	009	34009	Amayuelas de Arriba	43	26	17	60.4651162790698	39.5348837209302
34	Palencia	010	34010	Ampudia	698	363	335	52.0057306590258	47.9942693409742
34	Palencia	011	34011	Amusco	559	309	250	55.2772808586762	44.7227191413238
34	Palencia	012	34012	Antigüedad	427	228	199	53.3957845433255	46.6042154566745
34	Palencia	015	34015	Arconada	67	35	32	52.2388059701493	47.7611940298507
34	Palencia	017	34017	Astudillo	1287	663	624	51.5151515151515	48.4848484848485
34	Palencia	018	34018	Autilla del Pino	249	131	118	52.6104417670683	47.3895582329317
34	Palencia	019	34019	Autillo de Campos	191	87	104	45.5497382198953	54.4502617801047
34	Palencia	020	34020	Ayuela	78	47	31	60.2564102564103	39.7435897435897
34	Palencia	022	34022	Baltanás	1561	808	753	51.7616912235746	48.2383087764254
34	Palencia	023	34023	Venta de Baños	6188	2994	3194	48.3839689722043	51.6160310277957
34	Palencia	024	34024	Baquerín de Campos	38	23	15	60.5263157894737	39.4736842105263
34	Palencia	025	34025	Bárcena de Campos	63	26	37	41.2698412698413	58.7301587301587
34	Palencia	027	34027	Barruelo de Santullán	1834	857	977	46.7284623773173	53.2715376226827
34	Palencia	028	34028	Báscones de Ojeda	212	107	105	50.4716981132076	49.5283018867925
34	Palencia	029	34029	Becerril de Campos	1095	536	559	48.9497716894977	51.0502283105023
34	Palencia	031	34031	Belmonte de Campos	46	22	24	47.8260869565217	52.1739130434783
34	Palencia	032	34032	Berzosilla	73	33	40	45.2054794520548	54.7945205479452
34	Palencia	033	34033	Boada de Campos	24	13	11	54.1666666666667	45.8333333333333
34	Palencia	034	34034	Boadilla del Camino	190	101	89	53.1578947368421	46.8421052631579
34	Palencia	035	34035	Boadilla de Rioseco	188	90	98	47.8723404255319	52.1276595744681
34	Palencia	036	34036	Brañosera	290	151	139	52.0689655172414	47.9310344827586
34	Palencia	037	34037	Buenavista de Valdavia	440	221	219	50.2272727272727	49.7727272727273
34	Palencia	038	34038	Bustillo de la Vega	383	201	182	52.4804177545692	47.5195822454308
34	Palencia	039	34039	Bustillo del Páramo de Carrión	93	52	41	55.9139784946237	44.0860215053763
34	Palencia	041	34041	Calahorra de Boedo	137	69	68	50.3649635036496	49.6350364963504
34	Palencia	042	34042	Calzada de los Molinos	386	208	178	53.8860103626943	46.1139896373057
34	Palencia	045	34045	Capillas	116	57	59	49.1379310344828	50.8620689655172
34	Palencia	046	34046	Cardeñosa de Volpejera	56	30	26	53.5714285714286	46.4285714285714
34	Palencia	047	34047	Carrión de los Condes	2425	1130	1295	46.5979381443299	53.4020618556701
34	Palencia	048	34048	Castil de Vela	112	53	59	47.3214285714286	52.6785714285714
34	Palencia	049	34049	Castrejón de la Peña	622	325	297	52.2508038585209	47.7491961414791
34	Palencia	050	34050	Castrillo de Don Juan	337	185	152	54.8961424332344	45.1038575667656
34	Palencia	051	34051	Castrillo de Onielo	179	85	94	47.4860335195531	52.5139664804469
34	Palencia	052	34052	Castrillo de Villavega	285	144	141	50.5263157894737	49.4736842105263
34	Palencia	053	34053	Castromocho	257	133	124	51.7509727626459	48.2490272373541
34	Palencia	055	34055	Cervatos de la Cueza	397	206	191	51.8891687657431	48.1108312342569
34	Palencia	056	34056	Cervera de Pisuerga	2706	1358	1348	50.1847745750185	49.8152254249815
34	Palencia	057	34057	Cevico de la Torre	705	344	361	48.7943262411348	51.2056737588653
34	Palencia	058	34058	Cevico Navero	275	142	133	51.6363636363636	48.3636363636364
34	Palencia	059	34059	Cisneros	600	284	316	47.3333333333333	52.6666666666667
34	Palencia	060	34060	Cobos de Cerrato	244	119	125	48.7704918032787	51.2295081967213
34	Palencia	061	34061	Collazos de Boedo	157	87	70	55.4140127388535	44.5859872611465
34	Palencia	062	34062	Congosto de Valdavia	284	165	119	58.0985915492958	41.9014084507042
34	Palencia	063	34063	Cordovilla la Real	126	72	54	57.1428571428571	42.8571428571429
34	Palencia	066	34066	Cubillas de Cerrato	87	44	43	50.5747126436782	49.4252873563218
34	Palencia	067	34067	Dehesa de Montejo	218	121	97	55.5045871559633	44.4954128440367
34	Palencia	068	34068	Dehesa de Romanos	44	27	17	61.3636363636364	38.6363636363636
34	Palencia	069	34069	Dueñas	2949	1510	1439	51.2037978975924	48.7962021024076
34	Palencia	070	34070	Espinosa de Cerrato	274	145	129	52.9197080291971	47.0802919708029
34	Palencia	071	34071	Espinosa de Villagonzalo	272	137	135	50.3676470588235	49.6323529411765
34	Palencia	072	34072	Frechilla	272	130	142	47.7941176470588	52.2058823529412
34	Palencia	073	34073	Fresno del Río	200	100	100	50	50
34	Palencia	074	34074	Frómista	980	487	493	49.6938775510204	50.3061224489796
34	Palencia	076	34076	Fuentes de Nava	815	407	408	49.9386503067485	50.0613496932515
34	Palencia	077	34077	Fuentes de Valdepero	242	136	106	56.198347107438	43.801652892562
34	Palencia	079	34079	Grijota	819	416	403	50.7936507936508	49.2063492063492
34	Palencia	080	34080	Guardo	8645	4361	4284	50.4453441295547	49.5546558704453
34	Palencia	081	34081	Guaza de Campos	78	38	40	48.7179487179487	51.2820512820513
34	Palencia	082	34082	Hérmedes de Cerrato	133	66	67	49.6240601503759	50.3759398496241
34	Palencia	083	34083	Herrera de Pisuerga	2627	1308	1319	49.7906357061287	50.2093642938713
34	Palencia	084	34084	Herrera de Valdecañas	203	101	102	49.7536945812808	50.2463054187192
34	Palencia	086	34086	Hontoria de Cerrato	123	64	59	52.0325203252033	47.9674796747968
34	Palencia	087	34087	Hornillos de Cerrato	130	68	62	52.3076923076923	47.6923076923077
34	Palencia	088	34088	Husillos	223	122	101	54.7085201793722	45.2914798206278
34	Palencia	089	34089	Itero de la Vega	243	124	119	51.0288065843622	48.9711934156379
34	Palencia	091	34091	Lagartos	169	88	81	52.0710059171598	47.9289940828402
34	Palencia	092	34092	Lantadilla	518	247	271	47.6833976833977	52.3166023166023
34	Palencia	093	34093	Vid de Ojeda (La)	136	80	56	58.8235294117647	41.1764705882353
34	Palencia	094	34094	Ledigos	105	54	51	51.4285714285714	48.5714285714286
34	Palencia	096	34096	Lomas	62	27	35	43.5483870967742	56.4516129032258
34	Palencia	098	34098	Magaz de Pisuerga	726	369	357	50.8264462809917	49.1735537190083
34	Palencia	099	34099	Manquillos	71	37	34	52.112676056338	47.887323943662
34	Palencia	100	34100	Mantinos	201	101	100	50.2487562189055	49.7512437810945
34	Palencia	101	34101	Marcilla de Campos	74	33	41	44.5945945945946	55.4054054054054
34	Palencia	102	34102	Mazariegos	291	158	133	54.2955326460481	45.7044673539519
34	Palencia	103	34103	Mazuecos de Valdeginate	138	69	69	50	50
34	Palencia	104	34104	Melgar de Yuso	389	214	175	55.012853470437	44.987146529563
34	Palencia	106	34106	Meneses de Campos	156	80	76	51.2820512820513	48.7179487179487
34	Palencia	107	34107	Micieces de Ojeda	113	62	51	54.8672566371681	45.1327433628319
34	Palencia	108	34108	Monzón de Campos	758	399	359	52.6385224274406	47.3614775725594
34	Palencia	109	34109	Moratinos	89	47	42	52.8089887640449	47.1910112359551
34	Palencia	110	34110	Mudá	129	66	63	51.1627906976744	48.8372093023256
34	Palencia	112	34112	Nogal de las Huertas	69	40	29	57.9710144927536	42.0289855072464
34	Palencia	113	34113	Olea de Boedo	45	21	24	46.6666666666667	53.3333333333333
34	Palencia	114	34114	Olmos de Ojeda	341	186	155	54.5454545454545	45.4545454545455
34	Palencia	116	34116	Osornillo	100	55	45	55	45
34	Palencia	120	34120	Palencia	80613	38398	42215	47.6325158473199	52.3674841526801
34	Palencia	121	34121	Palenzuela	318	169	149	53.1446540880503	46.8553459119497
34	Palencia	122	34122	Páramo de Boedo	111	56	55	50.4504504504505	49.5495495495496
34	Palencia	123	34123	Paredes de Nava	2428	1197	1231	49.2998352553542	50.7001647446458
34	Palencia	124	34124	Payo de Ojeda	97	59	38	60.8247422680412	39.1752577319588
34	Palencia	125	34125	Pedraza de Campos	131	68	63	51.9083969465649	48.0916030534351
34	Palencia	126	34126	Pedrosa de la Vega	393	207	186	52.6717557251908	47.3282442748092
34	Palencia	127	34127	Perales	116	60	56	51.7241379310345	48.2758620689655
34	Palencia	129	34129	Pino del Río	283	164	119	57.9505300353357	42.0494699646643
34	Palencia	130	34130	Piña de Campos	294	156	138	53.0612244897959	46.9387755102041
34	Palencia	131	34131	Población de Arroyo	92	50	42	54.3478260869565	45.6521739130435
34	Palencia	132	34132	Población de Campos	200	111	89	55.5	44.5
34	Palencia	133	34133	Población de Cerrato	127	66	61	51.9685039370079	48.0314960629921
34	Palencia	134	34134	Polentinos	91	48	43	52.7472527472528	47.2527472527472
34	Palencia	135	34135	Pomar de Valdivia	536	278	258	51.865671641791	48.134328358209
34	Palencia	136	34136	Poza de la Vega	274	148	126	54.014598540146	45.985401459854
34	Palencia	137	34137	Pozo de Urama	43	22	21	51.1627906976744	48.8372093023256
34	Palencia	139	34139	Prádanos de Ojeda	252	132	120	52.3809523809524	47.6190476190476
34	Palencia	140	34140	Puebla de Valdavia (La)	157	76	81	48.4076433121019	51.5923566878981
34	Palencia	141	34141	Quintana del Puente	256	130	126	50.78125	49.21875
34	Palencia	143	34143	Quintanilla de Onsoña	239	134	105	56.0669456066946	43.9330543933054
34	Palencia	146	34146	Reinoso de Cerrato	83	49	34	59.0361445783133	40.9638554216867
34	Palencia	147	34147	Renedo de la Vega	270	155	115	57.4074074074074	42.5925925925926
34	Palencia	149	34149	Requena de Campos	58	30	28	51.7241379310345	48.2758620689655
34	Palencia	151	34151	Respenda de la Peña	274	144	130	52.5547445255475	47.4452554744526
34	Palencia	152	34152	Revenga de Campos	189	95	94	50.2645502645503	49.7354497354497
34	Palencia	154	34154	Revilla de Collazos	86	47	39	54.6511627906977	45.3488372093023
34	Palencia	155	34155	Ribas de Campos	197	105	92	53.2994923857868	46.7005076142132
34	Palencia	156	34156	Riberos de la Cueza	89	51	38	57.3033707865169	42.6966292134831
34	Palencia	157	34157	Saldaña	3187	1603	1584	50.2980859742705	49.7019140257295
34	Palencia	158	34158	Salinas de Pisuerga	281	150	131	53.3807829181495	46.6192170818505
34	Palencia	159	34159	San Cebrián de Campos	541	312	229	57.6709796672828	42.3290203327172
34	Palencia	160	34160	San Cebrián de Mudá	210	103	107	49.047619047619	50.952380952381
34	Palencia	161	34161	San Cristóbal de Boedo	48	28	20	58.3333333333333	41.6666666666667
34	Palencia	163	34163	San Mamés de Campos	112	49	63	43.75	56.25
34	Palencia	165	34165	San Román de la Cuba	119	59	60	49.5798319327731	50.4201680672269
34	Palencia	167	34167	Santa Cecilia del Alcor	165	90	75	54.5454545454545	45.4545454545455
34	Palencia	168	34168	Santa Cruz de Boedo	65	34	31	52.3076923076923	47.6923076923077
34	Palencia	169	34169	Santervás de la Vega	550	300	250	54.5454545454545	45.4545454545455
34	Palencia	170	34170	Santibáñez de Ecla	102	45	57	44.1176470588235	55.8823529411765
34	Palencia	171	34171	Santibáñez de la Peña	1514	757	757	50	50
34	Palencia	174	34174	Santoyo	286	138	148	48.2517482517483	51.7482517482518
34	Palencia	175	34175	Serna (La)	124	74	50	59.6774193548387	40.3225806451613
34	Palencia	176	34176	Sotobañado y Priorato	182	98	84	53.8461538461539	46.1538461538462
34	Palencia	177	34177	Soto de Cerrato	228	115	113	50.4385964912281	49.5614035087719
34	Palencia	178	34178	Tabanera de Cerrato	180	94	86	52.2222222222222	47.7777777777778
34	Palencia	179	34179	Tabanera de Valdavia	56	23	33	41.0714285714286	58.9285714285714
34	Palencia	180	34180	Támara de Campos	98	52	46	53.0612244897959	46.9387755102041
34	Palencia	181	34181	Tariego de Cerrato	561	292	269	52.0499108734403	47.9500891265597
34	Palencia	182	34182	Torquemada	1176	601	575	51.1054421768708	48.8945578231293
34	Palencia	184	34184	Torremormojón	92	48	44	52.1739130434783	47.8260869565217
34	Palencia	185	34185	Triollo	98	52	46	53.0612244897959	46.9387755102041
34	Palencia	186	34186	Valbuena de Pisuerga	80	46	34	57.5	42.5
34	Palencia	189	34189	Valdeolmillos	88	46	42	52.2727272727273	47.7272727272727
34	Palencia	190	34190	Valderrábano	82	49	33	59.7560975609756	40.2439024390244
34	Palencia	192	34192	Valde-Ucieza	124	70	54	56.4516129032258	43.5483870967742
34	Palencia	196	34196	Valle de Cerrato	130	75	55	57.6923076923077	42.3076923076923
34	Palencia	199	34199	Velilla del Río Carrión	1818	926	892	50.9350935093509	49.0649064906491
34	Palencia	201	34201	Vertavillo	228	126	102	55.2631578947369	44.7368421052632
34	Palencia	202	34202	Villabasta de Valdavia	40	18	22	45	55
34	Palencia	204	34204	Villacidaler	78	38	40	48.7179487179487	51.2820512820513
34	Palencia	205	34205	Villaconancio	89	52	37	58.4269662921348	41.5730337078652
34	Palencia	206	34206	Villada	1290	638	652	49.4573643410853	50.5426356589147
34	Palencia	208	34208	Villaeles de Valdavia	87	47	40	54.0229885057471	45.9770114942529
34	Palencia	210	34210	Villahán	140	76	64	54.2857142857143	45.7142857142857
34	Palencia	211	34211	Villaherreros	273	130	143	47.6190476190476	52.3809523809524
34	Palencia	213	34213	Villalaco	81	34	47	41.9753086419753	58.0246913580247
34	Palencia	214	34214	Villalba de Guardo	248	133	115	53.6290322580645	46.3709677419355
34	Palencia	215	34215	Villalcázar de Sirga	237	111	126	46.8354430379747	53.1645569620253
34	Palencia	216	34216	Villalcón	89	42	47	47.1910112359551	52.8089887640449
34	Palencia	217	34217	Villalobón	358	188	170	52.5139664804469	47.4860335195531
34	Palencia	218	34218	Villaluenga de la Vega	667	374	293	56.071964017991	43.928035982009
34	Palencia	220	34220	Villamartín de Campos	169	90	79	53.2544378698225	46.7455621301775
34	Palencia	221	34221	Villamediana	236	123	113	52.1186440677966	47.8813559322034
34	Palencia	222	34222	Villameriel	158	87	71	55.0632911392405	44.9367088607595
34	Palencia	223	34223	Villamoronta	331	175	156	52.8700906344411	47.1299093655589
34	Palencia	224	34224	Villamuera de la Cueza	63	36	27	57.1428571428571	42.8571428571429
34	Palencia	225	34225	Villamuriel de Cerrato	4734	2437	2297	51.4786649767638	48.5213350232362
34	Palencia	227	34227	Villanueva del Rebollar	101	51	50	50.4950495049505	49.5049504950495
34	Palencia	228	34228	Villanuño de Valdavia	130	71	59	54.6153846153846	45.3846153846154
34	Palencia	229	34229	Villaprovedo	105	63	42	60	40
34	Palencia	230	34230	Villarmentero de Campos	14	10	4	71.4285714285714	28.5714285714286
34	Palencia	231	34231	Villarrabé	287	139	148	48.4320557491289	51.5679442508711
34	Palencia	232	34232	Villarramiel	1096	562	534	51.2773722627737	48.7226277372263
34	Palencia	233	34233	Villasarracino	271	142	129	52.3985239852399	47.6014760147602
34	Palencia	234	34234	Villasila de Valdavia	107	59	48	55.1401869158878	44.8598130841121
34	Palencia	236	34236	Villaturde	253	123	130	48.6166007905138	51.3833992094862
34	Palencia	237	34237	Villaumbrales	886	460	426	51.9187358916479	48.0812641083521
34	Palencia	238	34238	Villaviudas	473	224	249	47.3572938689218	52.6427061310782
34	Palencia	240	34240	Villerías de Campos	131	72	59	54.9618320610687	45.0381679389313
34	Palencia	241	34241	Villodre	46	27	19	58.695652173913	41.304347826087
34	Palencia	242	34242	Villodrigo	129	65	64	50.3875968992248	49.6124031007752
34	Palencia	243	34243	Villoldo	496	264	232	53.2258064516129	46.7741935483871
34	Palencia	245	34245	Villota del Páramo	458	265	193	57.8602620087336	42.1397379912664
34	Palencia	246	34246	Villovieco	124	64	60	51.6129032258065	48.3870967741936
34	Palencia	901	34901	Osorno la Mayor	1712	925	787	54.0303738317757	45.9696261682243
34	Palencia	902	34902	Valle del Retortillo	219	105	114	47.9452054794521	52.0547945205479
34	Palencia	903	34903	Loma de Ucieza	328	174	154	53.0487804878049	46.9512195121951
34	Palencia	904	34904	Pernía (La)	479	263	216	54.9060542797495	45.0939457202505
35	Palmas (Las)	001	35001	Agaete	5665	2882	2783	50.873786407767	49.126213592233
35	Palmas (Las)	002	35002	Agüimes	20692	10558	10134	51.0245505509376	48.9754494490624
35	Palmas (Las)	003	35003	Antigua	4821	2670	2151	55.3827006845053	44.6172993154947
35	Palmas (Las)	004	35004	Arrecife	43711	22217	21494	50.8270229461692	49.1729770538308
35	Palmas (Las)	005	35005	Artenara	1572	803	769	51.0814249363868	48.9185750636132
35	Palmas (Las)	006	35006	Arucas	31973	16014	15959	50.0860100709974	49.9139899290026
35	Palmas (Las)	007	35007	Betancuria	677	348	329	51.4032496307238	48.5967503692762
35	Palmas (Las)	008	35008	Firgas	6814	3454	3360	50.6897563839155	49.3102436160845
35	Palmas (Las)	009	35009	Gáldar	22291	11174	11117	50.1278542909695	49.8721457090306
35	Palmas (Las)	010	35010	Haría	4201	2163	2038	51.4877410140443	48.5122589859557
35	Palmas (Las)	011	35011	Ingenio	24616	12463	12153	50.6296717582061	49.370328241794
35	Palmas (Las)	012	35012	Mogán	13136	6873	6263	52.3218635809988	47.6781364190012
35	Palmas (Las)	013	35013	Moya	8664	4391	4273	50.6809787626962	49.3190212373038
35	Palmas (Las)	014	35014	Oliva (La)	10578	5713	4865	54.008319152959	45.991680847041
35	Palmas (Las)	015	35015	Pájara	12923	7390	5533	57.1848641956202	42.8151358043798
35	Palmas (Las)	016	35016	Palmas de Gran Canaria (Las)	358518	175221	183297	48.8736967181564	51.1263032818436
35	Palmas (Las)	017	35017	Puerto del Rosario	21274	11169	10105	52.5007050860205	47.4992949139795
35	Palmas (Las)	018	35018	San Bartolomé	13129	6829	6300	52.0146241145556	47.9853758854444
35	Palmas (Las)	019	35019	San Bartolomé de Tirajana	39939	20681	19258	51.7814667367736	48.2185332632264
35	Palmas (Las)	020	35020	San Nicolás de Tolentino	8070	4084	3986	50.6071871127633	49.3928128872367
35	Palmas (Las)	021	35021	Santa Brígida	18153	9067	9086	49.9476670522779	50.0523329477221
35	Palmas (Las)	022	35022	Santa Lucía de Tirajana	44974	22875	22099	50.8627206830613	49.1372793169387
35	Palmas (Las)	023	35023	Santa María de Guía de Gran Canaria	14032	6999	7033	49.8788483466363	50.1211516533637
35	Palmas (Las)	024	35024	Teguise	12184	6265	5919	51.4198949441891	48.5801050558109
35	Palmas (Las)	025	35025	Tejeda	2565	1307	1258	50.9551656920078	49.0448343079922
35	Palmas (Las)	026	35026	Telde	88110	44269	43841	50.2428782204063	49.7571217795937
35	Palmas (Las)	027	35027	Teror	11898	5999	5899	50.4202386955791	49.5797613044209
35	Palmas (Las)	028	35028	Tías	13537	7024	6513	51.8874196646229	48.1125803353771
35	Palmas (Las)	029	35029	Tinajo	4373	2279	2094	52.1152526869426	47.8847473130574
35	Palmas (Las)	030	35030	Tuineje	9851	5248	4603	53.273779311745	46.726220688255
35	Palmas (Las)	031	35031	Valsequillo de Gran Canaria	8049	4139	3910	51.4225369611132	48.5774630388868
35	Palmas (Las)	032	35032	Valleseco	4006	2059	1947	51.3979031452821	48.6020968547179
35	Palmas (Las)	033	35033	Vega de San Mateo	7424	3847	3577	51.8184267241379	48.1815732758621
35	Palmas (Las)	034	35034	Yaiza	5175	2896	2279	55.9613526570048	44.0386473429952
36	Pontevedra	001	36001	Arbo	4318	2105	2213	48.7494210282538	51.2505789717462
36	Pontevedra	002	36002	Barro	3538	1673	1865	47.2866026003392	52.7133973996608
36	Pontevedra	003	36003	Baiona	10741	5271	5470	49.0736430499953	50.9263569500047
36	Pontevedra	004	36004	Bueu	12526	6109	6417	48.7705572409389	51.2294427590612
36	Pontevedra	005	36005	Caldas de Reis	9441	4540	4901	48.0881262578117	51.9118737421883
36	Pontevedra	006	36006	Cambados	13240	6427	6813	48.5422960725076	51.4577039274924
36	Pontevedra	007	36007	Campo Lameiro	2307	1099	1208	47.6376246207196	52.3623753792804
36	Pontevedra	008	36008	Cangas	23442	11569	11873	49.3515911611637	50.6484088388363
36	Pontevedra	009	36009	Cañiza (A)	6986	3313	3673	47.4234182651016	52.5765817348984
36	Pontevedra	010	36010	Catoira	3507	1720	1787	49.0447676076419	50.9552323923581
36	Pontevedra	011	36011	Cerdedo	2566	1122	1444	43.7256430241621	56.2743569758379
36	Pontevedra	012	36012	Cotobade	4786	2187	2599	45.6957793564563	54.3042206435437
36	Pontevedra	013	36013	Covelo	4046	1884	2162	46.5645081562037	53.4354918437963
36	Pontevedra	014	36014	Crecente	2984	1370	1614	45.911528150134	54.0884718498659
36	Pontevedra	015	36015	Cuntis	5660	2610	3050	46.113074204947	53.886925795053
36	Pontevedra	016	36016	Dozón	2174	1037	1137	47.7000919963202	52.2999080036799
36	Pontevedra	017	36017	Estrada (A)	22317	10456	11861	46.8521754716136	53.1478245283864
36	Pontevedra	018	36018	Forcarei	4889	2303	2586	47.1057475966455	52.8942524033545
36	Pontevedra	019	36019	Fornelos de Montes	2271	1035	1236	45.5746367239102	54.4253632760898
36	Pontevedra	020	36020	Agolada	4391	2158	2233	49.1459804144842	50.8540195855158
36	Pontevedra	021	36021	Gondomar	11463	5615	5848	48.983686643985	51.016313356015
36	Pontevedra	022	36022	Grove (O)	11036	5467	5569	49.5378760420442	50.4621239579558
36	Pontevedra	023	36023	Guarda (A)	10000	4872	5128	48.72	51.28
36	Pontevedra	024	36024	Lalín	20169	9707	10462	48.1283157320641	51.8716842679359
36	Pontevedra	025	36025	Lama (A)	3047	1392	1655	45.6842796192977	54.3157203807023
36	Pontevedra	026	36026	Marín	25482	12572	12910	49.3367867514324	50.6632132485676
36	Pontevedra	027	36027	Meaño	5403	2580	2823	47.7512493059411	52.2487506940589
36	Pontevedra	028	36028	Meis	4973	2301	2672	46.2698572290368	53.7301427709632
36	Pontevedra	029	36029	Moaña	17907	8689	9218	48.5229239962026	51.4770760037974
36	Pontevedra	030	36030	Mondariz	5571	2594	2977	46.5625560940585	53.4374439059415
36	Pontevedra	031	36031	Mondariz-Balneario	651	310	341	47.6190476190476	52.3809523809524
36	Pontevedra	032	36032	Moraña	4327	2064	2263	47.7004853247053	52.2995146752947
36	Pontevedra	033	36033	Mos	13793	6733	7060	48.8146161096208	51.1853838903792
36	Pontevedra	034	36034	Neves (As)	4750	2260	2490	47.5789473684211	52.4210526315789
36	Pontevedra	035	36035	Nigrán	15905	7769	8136	48.8462747563659	51.1537252436341
36	Pontevedra	036	36036	Oia	2925	1454	1471	49.7094017094017	50.2905982905983
36	Pontevedra	037	36037	Pazos de Borbén	3111	1437	1674	46.1909353905497	53.8090646094503
36	Pontevedra	038	36038	Pontevedra	75212	35585	39627	47.3129287879594	52.6870712120406
36	Pontevedra	039	36039	Porriño (O)	16011	7716	8295	48.1918680906877	51.8081319093124
36	Pontevedra	040	36040	Portas	3260	1540	1720	47.239263803681	52.760736196319
36	Pontevedra	041	36041	Poio	14037	6807	7230	48.4932677922633	51.5067322077367
36	Pontevedra	042	36042	Ponteareas	18322	8814	9508	48.1061019539352	51.8938980460648
36	Pontevedra	043	36043	Ponte Caldelas	6501	3073	3428	47.2696508229503	52.7303491770497
36	Pontevedra	044	36044	Pontecesures	2984	1477	1507	49.4973190348526	50.5026809651474
36	Pontevedra	045	36045	Redondela	29108	14130	14978	48.5433557784801	51.4566442215199
36	Pontevedra	046	36046	Ribadumia	4221	2051	2170	48.5903814262023	51.4096185737977
36	Pontevedra	047	36047	Rodeiro	4355	2232	2123	51.2514351320321	48.7485648679679
36	Pontevedra	048	36048	Rosal (O)	5846	2811	3035	48.0841601094766	51.9158398905234
36	Pontevedra	049	36049	Salceda de Caselas	6144	3007	3137	48.9420572916667	51.0579427083333
36	Pontevedra	050	36050	Salvaterra de Miño	8501	4067	4434	47.8414304199506	52.1585695800494
36	Pontevedra	051	36051	Sanxenxo	16183	7940	8243	49.0638324167336	50.9361675832664
36	Pontevedra	052	36052	Silleda	9214	4416	4798	47.9270675059692	52.0729324940308
36	Pontevedra	053	36053	Soutomaior	5369	2588	2781	48.2026448128143	51.7973551871857
36	Pontevedra	054	36054	Tomiño	10901	5326	5575	48.857902944684	51.142097055316
36	Pontevedra	055	36055	Tui	15939	7612	8327	47.7570738440304	52.2429261559696
36	Pontevedra	056	36056	Valga	6310	3089	3221	48.9540412044374	51.0459587955626
36	Pontevedra	057	36057	Vigo	285526	135413	150113	47.4258036045754	52.5741963954246
36	Pontevedra	058	36058	Vilaboa	5780	2843	2937	49.1868512110727	50.8131487889273
36	Pontevedra	059	36059	Vila de Cruces	7171	3502	3669	48.8355877841305	51.1644122158695
36	Pontevedra	060	36060	Vilagarcía de Arousa	33832	16310	17522	48.2087964057697	51.7912035942303
36	Pontevedra	061	36061	Vilanova de Arousa	10303	4971	5332	48.2480830825973	51.7519169174027
36	Pontevedra	901	36901	Illa de Arousa (A)	4948	2457	2491	49.6564268391269	50.3435731608731
37	Salamanca	001	37001	Abusejo	256	126	130	49.21875	50.78125
37	Salamanca	002	37002	Agallas	191	98	93	51.3089005235602	48.6910994764398
37	Salamanca	003	37003	Ahigal de los Aceiteros	206	105	101	50.9708737864078	49.0291262135922
37	Salamanca	004	37004	Ahigal de Villarino	44	21	23	47.7272727272727	52.2727272727273
37	Salamanca	005	37005	Alameda de Gardón (La)	157	72	85	45.859872611465	54.140127388535
37	Salamanca	006	37006	Alamedilla (La)	219	112	107	51.1415525114155	48.8584474885845
37	Salamanca	007	37007	Alaraz	670	342	328	51.044776119403	48.955223880597
37	Salamanca	008	37008	Alba de Tormes	4654	2290	2364	49.2049849591749	50.7950150408251
37	Salamanca	009	37009	Alba de Yeltes	284	138	146	48.5915492957747	51.4084507042254
37	Salamanca	010	37010	Alberca (La)	1122	584	538	52.0499108734403	47.9500891265597
37	Salamanca	011	37011	Alberguería de Argañán (La)	200	103	97	51.5	48.5
37	Salamanca	012	37012	Alconada	226	112	114	49.5575221238938	50.4424778761062
37	Salamanca	013	37013	Aldeacipreste	225	122	103	54.2222222222222	45.7777777777778
37	Salamanca	014	37014	Aldeadávila de la Ribera	1702	856	846	50.2937720329025	49.7062279670975
37	Salamanca	015	37015	Aldea del Obispo	396	207	189	52.2727272727273	47.7272727272727
37	Salamanca	016	37016	Aldealengua	574	301	273	52.4390243902439	47.5609756097561
37	Salamanca	017	37017	Aldeanueva de Figueroa	343	176	167	51.3119533527697	48.6880466472303
37	Salamanca	018	37018	Aldeanueva de la Sierra	107	50	57	46.7289719626168	53.2710280373832
37	Salamanca	019	37019	Aldearrodrigo	214	108	106	50.4672897196262	49.5327102803738
37	Salamanca	020	37020	Aldearrubia	548	297	251	54.1970802919708	45.8029197080292
37	Salamanca	021	37021	Aldeaseca de Alba	130	63	67	48.4615384615385	51.5384615384615
37	Salamanca	022	37022	Aldeaseca de la Frontera	362	180	182	49.7237569060774	50.2762430939227
37	Salamanca	023	37023	Aldeatejada	634	307	327	48.4227129337539	51.5772870662461
37	Salamanca	024	37024	Aldeavieja de Tormes	140	71	69	50.7142857142857	49.2857142857143
37	Salamanca	025	37025	Aldehuela de la Bóveda	385	189	196	49.0909090909091	50.9090909090909
37	Salamanca	026	37026	Aldehuela de Yeltes	313	160	153	51.1182108626198	48.8817891373802
37	Salamanca	027	37027	Almenara de Tormes	254	127	127	50	50
37	Salamanca	028	37028	Almendra	196	99	97	50.5102040816327	49.4897959183674
37	Salamanca	029	37029	Anaya de Alba	322	176	146	54.6583850931677	45.3416149068323
37	Salamanca	030	37030	Añover de Tormes	108	58	50	53.7037037037037	46.2962962962963
37	Salamanca	031	37031	Arabayona de Mógica	519	276	243	53.1791907514451	46.8208092485549
37	Salamanca	032	37032	Arapiles	514	261	253	50.7782101167315	49.2217898832685
37	Salamanca	033	37033	Arcediano	118	60	58	50.8474576271186	49.1525423728814
37	Salamanca	034	37034	Arco (El)	102	57	45	55.8823529411765	44.1176470588235
37	Salamanca	035	37035	Armenteros	324	156	168	48.1481481481482	51.8518518518519
37	Salamanca	036	37036	San Miguel del Robledo	105	49	56	46.6666666666667	53.3333333333333
37	Salamanca	037	37037	Atalaya (La)	158	85	73	53.7974683544304	46.2025316455696
37	Salamanca	038	37038	Babilafuente	986	515	471	52.2312373225152	47.7687626774848
37	Salamanca	039	37039	Bañobárez	429	220	209	51.2820512820513	48.7179487179487
37	Salamanca	040	37040	Barbadillo	565	271	294	47.9646017699115	52.0353982300885
37	Salamanca	041	37041	Barbalos	108	55	53	50.9259259259259	49.0740740740741
37	Salamanca	042	37042	Barceo	70	38	32	54.2857142857143	45.7142857142857
37	Salamanca	044	37044	Barruecopardo	587	295	292	50.2555366269165	49.7444633730835
37	Salamanca	045	37045	Bastida (La)	39	21	18	53.8461538461539	46.1538461538462
37	Salamanca	046	37046	Béjar	15690	7435	8255	47.3868706182282	52.6131293817718
37	Salamanca	047	37047	Beleña	148	75	73	50.6756756756757	49.3243243243243
37	Salamanca	049	37049	Bermellar	222	109	113	49.0990990990991	50.9009009009009
37	Salamanca	050	37050	Berrocal de Huebra	122	60	62	49.1803278688525	50.8196721311475
37	Salamanca	051	37051	Berrocal de Salvatierra	135	68	67	50.3703703703704	49.6296296296296
37	Salamanca	052	37052	Boada	426	216	210	50.7042253521127	49.2957746478873
37	Salamanca	054	37054	Bodón (El)	339	174	165	51.3274336283186	48.6725663716814
37	Salamanca	055	37055	Bogajo	211	111	100	52.60663507109	47.39336492891
37	Salamanca	056	37056	Bouza (La)	70	33	37	47.1428571428571	52.8571428571429
37	Salamanca	057	37057	Bóveda del Río Almar	315	168	147	53.3333333333333	46.6666666666667
37	Salamanca	058	37058	Brincones	108	55	53	50.9259259259259	49.0740740740741
37	Salamanca	059	37059	Buenamadre	180	94	86	52.2222222222222	47.7777777777778
37	Salamanca	060	37060	Buenavista	94	50	44	53.1914893617021	46.8085106382979
37	Salamanca	061	37061	Cabaco (El)	285	144	141	50.5263157894737	49.4736842105263
37	Salamanca	062	37062	Cabezabellosa de la Calzada	135	73	62	54.0740740740741	45.9259259259259
37	Salamanca	063	37063	Cabeza de Béjar (La)	110	56	54	50.9090909090909	49.0909090909091
37	Salamanca	065	37065	Cabeza del Caballo	482	251	231	52.0746887966805	47.9253112033195
37	Salamanca	067	37067	Cabrerizos	2015	995	1020	49.3796526054591	50.6203473945409
37	Salamanca	068	37068	Cabrillas	538	255	283	47.3977695167286	52.6022304832714
37	Salamanca	069	37069	Calvarrasa de Abajo	988	496	492	50.2024291497976	49.7975708502024
37	Salamanca	070	37070	Calvarrasa de Arriba	680	349	331	51.3235294117647	48.6764705882353
37	Salamanca	071	37071	Calzada de Béjar (La)	106	58	48	54.7169811320755	45.2830188679245
37	Salamanca	072	37072	Calzada de Don Diego	260	134	126	51.5384615384615	48.4615384615385
37	Salamanca	073	37073	Calzada de Valdunciel	659	322	337	48.8619119878604	51.1380880121396
37	Salamanca	074	37074	Campillo de Azaba	265	132	133	49.811320754717	50.188679245283
37	Salamanca	077	37077	Campo de Peñaranda (El)	394	200	194	50.761421319797	49.238578680203
37	Salamanca	078	37078	Candelario	1109	539	570	48.6023444544635	51.3976555455365
37	Salamanca	079	37079	Canillas de Abajo	110	63	47	57.2727272727273	42.7272727272727
37	Salamanca	080	37080	Cantagallo	288	140	148	48.6111111111111	51.3888888888889
37	Salamanca	081	37081	Cantalapiedra	1323	655	668	49.5086923658352	50.4913076341648
37	Salamanca	082	37082	Cantalpino	1174	632	542	53.8330494037479	46.1669505962521
37	Salamanca	083	37083	Cantaracillo	281	144	137	51.2455516014235	48.7544483985765
37	Salamanca	085	37085	Carbajosa de la Sagrada	1674	840	834	50.179211469534	49.820788530466
37	Salamanca	086	37086	Carpio de Azaba	110	57	53	51.8181818181818	48.1818181818182
37	Salamanca	087	37087	Carrascal de Barregas	495	256	239	51.7171717171717	48.2828282828283
37	Salamanca	088	37088	Carrascal del Obispo	255	124	131	48.6274509803922	51.3725490196078
37	Salamanca	089	37089	Casafranca	86	40	46	46.5116279069767	53.4883720930233
37	Salamanca	090	37090	Casas del Conde (Las)	88	40	48	45.4545454545455	54.5454545454545
37	Salamanca	091	37091	Casillas de Flores	264	123	141	46.5909090909091	53.4090909090909
37	Salamanca	092	37092	Castellanos de Moriscos	373	174	199	46.6487935656837	53.3512064343164
37	Salamanca	096	37096	Castillejo de Martín Viejo	337	176	161	52.2255192878338	47.7744807121662
37	Salamanca	097	37097	Castraz	61	36	25	59.0163934426229	40.9836065573771
37	Salamanca	098	37098	Cepeda	530	256	274	48.3018867924528	51.6981132075472
37	Salamanca	099	37099	Cereceda de la Sierra	104	52	52	50	50
37	Salamanca	100	37100	Cerezal de Peñahorcada	127	71	56	55.9055118110236	44.0944881889764
37	Salamanca	101	37101	Cerralbo	256	132	124	51.5625	48.4375
37	Salamanca	102	37102	Cerro (El)	555	295	260	53.1531531531532	46.8468468468469
37	Salamanca	103	37103	Cespedosa de Tormes	650	339	311	52.1538461538462	47.8461538461538
37	Salamanca	104	37104	Cilleros de la Bastida	41	21	20	51.219512195122	48.7804878048781
37	Salamanca	106	37106	Cipérez	439	221	218	50.3416856492027	49.6583143507973
37	Salamanca	107	37107	Ciudad Rodrigo	14556	6972	7584	47.8977741137675	52.1022258862325
37	Salamanca	108	37108	Coca de Alba	158	71	87	44.9367088607595	55.0632911392405
37	Salamanca	109	37109	Colmenar de Montemayor	273	153	120	56.043956043956	43.956043956044
37	Salamanca	110	37110	Cordovilla	145	83	62	57.2413793103448	42.7586206896552
37	Salamanca	112	37112	Cristóbal	254	130	124	51.1811023622047	48.8188976377953
37	Salamanca	113	37113	Cubo de Don Sancho (El)	592	310	282	52.3648648648649	47.6351351351351
37	Salamanca	114	37114	Chagarcía Medianero	146	79	67	54.1095890410959	45.8904109589041
37	Salamanca	115	37115	Dios le Guarde	166	92	74	55.421686746988	44.5783132530121
37	Salamanca	116	37116	Doñinos de Ledesma	108	58	50	53.7037037037037	46.2962962962963
37	Salamanca	117	37117	Doñinos de Salamanca	726	376	350	51.7906336088154	48.2093663911846
37	Salamanca	118	37118	Ejeme	199	107	92	53.7688442211055	46.2311557788945
37	Salamanca	119	37119	Encina (La)	205	111	94	54.1463414634146	45.8536585365854
37	Salamanca	120	37120	Encina de San Silvestre	125	62	63	49.6	50.4
37	Salamanca	121	37121	Encinas de Abajo	671	349	322	52.0119225037258	47.9880774962742
37	Salamanca	122	37122	Encinas de Arriba	288	138	150	47.9166666666667	52.0833333333333
37	Salamanca	123	37123	Encinasola de los Comendadores	297	151	146	50.8417508417509	49.1582491582492
37	Salamanca	124	37124	Endrinal	301	167	134	55.4817275747508	44.5182724252492
37	Salamanca	125	37125	Escurial de la Sierra	299	152	147	50.8361204013378	49.1638795986622
37	Salamanca	126	37126	Espadaña	50	27	23	54	46
37	Salamanca	127	37127	Espeja	298	157	141	52.6845637583893	47.3154362416107
37	Salamanca	128	37128	Espino de la Orbada	362	183	179	50.5524861878453	49.4475138121547
37	Salamanca	129	37129	Florida de Liébana	252	135	117	53.5714285714286	46.4285714285714
37	Salamanca	130	37130	Forfoleda	251	124	127	49.402390438247	50.597609561753
37	Salamanca	131	37131	Frades de la Sierra	286	150	136	52.4475524475525	47.5524475524476
37	Salamanca	132	37132	Fregeneda (La)	554	271	283	48.9169675090253	51.0830324909747
37	Salamanca	133	37133	Fresnedoso	128	58	70	45.3125	54.6875
37	Salamanca	134	37134	Fresno Alhándiga	314	166	148	52.8662420382166	47.1337579617834
37	Salamanca	135	37135	Fuente de San Esteban (La)	1544	784	760	50.7772020725389	49.2227979274611
37	Salamanca	136	37136	Fuenteguinaldo	938	474	464	50.5330490405117	49.4669509594883
37	Salamanca	137	37137	Fuenteliante	142	68	74	47.887323943662	52.112676056338
37	Salamanca	138	37138	Fuenterroble de Salvatierra	270	137	133	50.7407407407407	49.2592592592593
37	Salamanca	139	37139	Fuentes de Béjar	282	121	161	42.9078014184397	57.0921985815603
37	Salamanca	140	37140	Fuentes de Oñoro	1396	672	724	48.1375358166189	51.8624641833811
37	Salamanca	141	37141	Gajates	246	122	124	49.5934959349593	50.4065040650407
37	Salamanca	142	37142	Galindo y Perahuy	362	199	163	54.9723756906077	45.0276243093923
37	Salamanca	143	37143	Galinduste	584	286	298	48.972602739726	51.027397260274
37	Salamanca	144	37144	Galisancho	566	316	250	55.8303886925795	44.1696113074205
37	Salamanca	145	37145	Gallegos de Argañán	415	218	197	52.5301204819277	47.4698795180723
37	Salamanca	146	37146	Gallegos de Solmirón	199	94	105	47.2361809045226	52.7638190954774
37	Salamanca	147	37147	Garcibuey	294	164	130	55.7823129251701	44.2176870748299
37	Salamanca	148	37148	Garcihernández	606	320	286	52.8052805280528	47.1947194719472
37	Salamanca	149	37149	Garcirrey	111	55	56	49.5495495495496	50.4504504504505
37	Salamanca	150	37150	Gejuelo del Barro	53	29	24	54.7169811320755	45.2830188679245
37	Salamanca	151	37151	Golpejas	201	99	102	49.2537313432836	50.7462686567164
37	Salamanca	152	37152	Gomecello	525	270	255	51.4285714285714	48.5714285714286
37	Salamanca	154	37154	Guadramiro	223	130	93	58.2959641255605	41.7040358744395
37	Salamanca	155	37155	Guijo de Ávila	115	64	51	55.6521739130435	44.3478260869565
37	Salamanca	156	37156	Guijuelo	5082	2527	2555	49.7245179063361	50.2754820936639
37	Salamanca	157	37157	Herguijuela de Ciudad Rodrigo	143	77	66	53.8461538461539	46.1538461538462
37	Salamanca	158	37158	Herguijuela de la Sierra	326	162	164	49.6932515337423	50.3067484662577
37	Salamanca	159	37159	Herguijuela del Campo	124	57	67	45.9677419354839	54.0322580645161
37	Salamanca	160	37160	Hinojosa de Duero	840	417	423	49.6428571428571	50.3571428571429
37	Salamanca	161	37161	Horcajo de Montemayor	207	105	102	50.7246376811594	49.2753623188406
37	Salamanca	162	37162	Horcajo Medianero	368	178	190	48.3695652173913	51.6304347826087
37	Salamanca	163	37163	Hoya (La)	23	18	5	78.2608695652174	21.7391304347826
37	Salamanca	164	37164	Huerta	275	145	130	52.7272727272727	47.2727272727273
37	Salamanca	165	37165	Iruelos	65	27	38	41.5384615384615	58.4615384615385
37	Salamanca	166	37166	Ituero de Azaba	271	145	126	53.5055350553506	46.4944649446495
37	Salamanca	167	37167	Juzbado	197	103	94	52.2842639593909	47.7157360406091
37	Salamanca	168	37168	Lagunilla	640	341	299	53.28125	46.71875
37	Salamanca	169	37169	Larrodrigo	305	159	146	52.1311475409836	47.8688524590164
37	Salamanca	170	37170	Ledesma	1954	960	994	49.1299897645855	50.8700102354145
37	Salamanca	171	37171	Ledrada	606	308	298	50.8250825082508	49.1749174917492
37	Salamanca	172	37172	Linares de Riofrío	1053	530	523	50.332383665717	49.667616334283
37	Salamanca	173	37173	Lumbrales	2210	1100	1110	49.7737556561086	50.2262443438914
37	Salamanca	174	37174	Macotera	1695	861	834	50.7964601769912	49.2035398230089
37	Salamanca	175	37175	Machacón	543	276	267	50.828729281768	49.171270718232
37	Salamanca	176	37176	Madroñal	182	98	84	53.8461538461539	46.1538461538462
37	Salamanca	177	37177	Maíllo (El)	443	226	217	51.0158013544018	48.9841986455982
37	Salamanca	178	37178	Malpartida	159	88	71	55.3459119496855	44.6540880503145
37	Salamanca	179	37179	Mancera de Abajo	363	185	178	50.9641873278237	49.0358126721763
37	Salamanca	180	37180	Manzano (El)	96	50	46	52.0833333333333	47.9166666666667
37	Salamanca	181	37181	Martiago	380	201	179	52.8947368421053	47.1052631578947
37	Salamanca	182	37182	Martinamor	82	43	39	52.4390243902439	47.5609756097561
37	Salamanca	183	37183	Martín de Yeltes	560	287	273	51.25	48.75
37	Salamanca	184	37184	Masueco	473	237	236	50.1057082452431	49.8942917547569
37	Salamanca	185	37185	Castellanos de Villiquera	587	305	282	51.9591141396934	48.0408858603066
37	Salamanca	186	37186	Mata de Ledesma (La)	146	70	76	47.9452054794521	52.0547945205479
37	Salamanca	187	37187	Matilla de los Caños del Río	711	363	348	51.0548523206751	48.9451476793249
37	Salamanca	188	37188	Maya (La)	262	141	121	53.8167938931298	46.1832061068702
37	Salamanca	189	37189	Membribe de la Sierra	87	46	41	52.8735632183908	47.1264367816092
37	Salamanca	190	37190	Mieza	354	175	179	49.4350282485876	50.5649717514124
37	Salamanca	191	37191	Milano (El)	178	95	83	53.3707865168539	46.6292134831461
37	Salamanca	192	37192	Miranda de Azán	323	155	168	47.9876160990712	52.0123839009288
37	Salamanca	193	37193	Miranda del Castañar	654	347	307	53.0581039755352	46.9418960244648
37	Salamanca	194	37194	Mogarraz	365	172	193	47.1232876712329	52.8767123287671
37	Salamanca	195	37195	Molinillo	82	38	44	46.3414634146342	53.6585365853659
37	Salamanca	196	37196	Monforte de la Sierra	113	66	47	58.4070796460177	41.5929203539823
37	Salamanca	197	37197	Monleón	135	76	59	56.2962962962963	43.7037037037037
37	Salamanca	198	37198	Monleras	262	135	127	51.5267175572519	48.4732824427481
37	Salamanca	199	37199	Monsagro	237	136	101	57.3839662447257	42.6160337552743
37	Salamanca	200	37200	Montejo	239	132	107	55.2301255230126	44.7698744769875
37	Salamanca	201	37201	Montemayor del Río	377	204	173	54.1114058355438	45.8885941644562
37	Salamanca	202	37202	Monterrubio de Armuña	545	286	259	52.4770642201835	47.5229357798165
37	Salamanca	203	37203	Monterrubio de la Sierra	177	95	82	53.6723163841808	46.3276836158192
37	Salamanca	204	37204	Morasverdes	447	227	220	50.7829977628635	49.2170022371365
37	Salamanca	205	37205	Morille	186	100	86	53.7634408602151	46.2365591397849
37	Salamanca	206	37206	Moríñigo	137	70	67	51.0948905109489	48.9051094890511
37	Salamanca	207	37207	Moriscos	143	72	71	50.3496503496504	49.6503496503497
37	Salamanca	208	37208	Moronta	127	68	59	53.5433070866142	46.4566929133858
37	Salamanca	209	37209	Mozárbez	414	213	201	51.4492753623188	48.5507246376812
37	Salamanca	211	37211	Narros de Matalayegua	302	161	141	53.3112582781457	46.6887417218543
37	Salamanca	212	37212	Navacarros	132	72	60	54.5454545454545	45.4545454545455
37	Salamanca	213	37213	Nava de Béjar	122	61	61	50	50
37	Salamanca	214	37214	Nava de Francia	150	78	72	52	48
37	Salamanca	215	37215	Nava de Sotrobal	217	113	104	52.073732718894	47.926267281106
37	Salamanca	216	37216	Navales	392	226	166	57.6530612244898	42.3469387755102
37	Salamanca	217	37217	Navalmoral de Béjar	75	37	38	49.3333333333333	50.6666666666667
37	Salamanca	218	37218	Navamorales	172	93	79	54.0697674418605	45.9302325581395
37	Salamanca	219	37219	Navarredonda de la Rinconada	278	141	137	50.7194244604317	49.2805755395684
37	Salamanca	221	37221	Navasfrías	711	350	361	49.2264416315049	50.7735583684951
37	Salamanca	222	37222	Negrilla de Palencia	127	58	69	45.6692913385827	54.3307086614173
37	Salamanca	223	37223	Olmedo de Camaces	172	83	89	48.2558139534884	51.7441860465116
37	Salamanca	224	37224	Orbada (La)	284	149	135	52.4647887323944	47.5352112676056
37	Salamanca	225	37225	Pajares de la Laguna	144	72	72	50	50
37	Salamanca	226	37226	Palacios del Arzobispo	238	123	115	51.6806722689076	48.3193277310924
37	Salamanca	228	37228	Palaciosrubios	547	292	255	53.382084095064	46.617915904936
37	Salamanca	229	37229	Palencia de Negrilla	196	100	96	51.0204081632653	48.9795918367347
37	Salamanca	230	37230	Parada de Arriba	247	139	108	56.2753036437247	43.7246963562753
37	Salamanca	231	37231	Parada de Rubiales	345	182	163	52.7536231884058	47.2463768115942
37	Salamanca	232	37232	Paradinas de San Juan	652	352	300	53.9877300613497	46.0122699386503
37	Salamanca	233	37233	Pastores	56	29	27	51.7857142857143	48.2142857142857
37	Salamanca	234	37234	Payo (El)	496	242	254	48.7903225806452	51.2096774193548
37	Salamanca	235	37235	Pedraza de Alba	289	150	139	51.9031141868512	48.0968858131488
37	Salamanca	236	37236	Pedrosillo de Alba	258	126	132	48.8372093023256	51.1627906976744
37	Salamanca	237	37237	Pedrosillo de los Aires	457	252	205	55.1422319474836	44.8577680525164
37	Salamanca	238	37238	Pedrosillo el Ralo	153	73	80	47.7124183006536	52.2875816993464
37	Salamanca	239	37239	Pedroso de la Armuña (El)	319	157	162	49.2163009404389	50.7836990595611
37	Salamanca	240	37240	Pelabravo	799	411	388	51.4392991239049	48.5607008760951
37	Salamanca	241	37241	Pelarrodríguez	207	116	91	56.0386473429952	43.9613526570048
37	Salamanca	242	37242	Pelayos	77	39	38	50.6493506493506	49.3506493506493
37	Salamanca	243	37243	Peña (La)	156	72	84	46.1538461538462	53.8461538461539
37	Salamanca	244	37244	Peñacaballera	218	100	118	45.8715596330275	54.1284403669725
37	Salamanca	245	37245	Peñaparda	479	243	236	50.7306889352818	49.2693110647182
37	Salamanca	246	37246	Peñaranda de Bracamonte	6235	3048	3187	48.8853247794707	51.1146752205293
37	Salamanca	247	37247	Peñarandilla	279	135	144	48.3870967741936	51.6129032258065
37	Salamanca	248	37248	Peralejos de Abajo	197	94	103	47.7157360406091	52.2842639593909
37	Salamanca	249	37249	Peralejos de Arriba	70	39	31	55.7142857142857	44.2857142857143
37	Salamanca	250	37250	Pereña de la Ribera	557	281	276	50.4488330341113	49.5511669658887
37	Salamanca	251	37251	Peromingo	163	76	87	46.6257668711656	53.3742331288344
37	Salamanca	252	37252	Pinedas	188	97	91	51.5957446808511	48.4042553191489
37	Salamanca	253	37253	Pino de Tormes (El)	189	95	94	50.2645502645503	49.7354497354497
37	Salamanca	254	37254	Pitiegua	266	136	130	51.1278195488722	48.8721804511278
37	Salamanca	255	37255	Pizarral	100	48	52	48	52
37	Salamanca	256	37256	Poveda de las Cintas	342	186	156	54.3859649122807	45.6140350877193
37	Salamanca	257	37257	Pozos de Hinojo	83	42	41	50.6024096385542	49.3975903614458
37	Salamanca	258	37258	Puebla de Azaba	286	149	137	52.0979020979021	47.9020979020979
37	Salamanca	259	37259	Puebla de San Medel	67	36	31	53.7313432835821	46.2686567164179
37	Salamanca	260	37260	Puebla de Yeltes	252	133	119	52.7777777777778	47.2222222222222
37	Salamanca	261	37261	Puente del Congosto	341	168	173	49.266862170088	50.733137829912
37	Salamanca	262	37262	Puertas	108	59	49	54.6296296296296	45.3703703703704
37	Salamanca	263	37263	Puerto de Béjar	494	230	264	46.5587044534413	53.4412955465587
37	Salamanca	264	37264	Puerto Seguro	107	55	52	51.4018691588785	48.5981308411215
37	Salamanca	265	37265	Rágama	310	163	147	52.5806451612903	47.4193548387097
37	Salamanca	266	37266	Redonda (La)	114	55	59	48.2456140350877	51.7543859649123
37	Salamanca	267	37267	Retortillo	241	116	125	48.1327800829876	51.8672199170125
37	Salamanca	268	37268	Rinconada de la Sierra (La)	182	95	87	52.1978021978022	47.8021978021978
37	Salamanca	269	37269	Robleda	574	302	272	52.6132404181185	47.3867595818815
37	Salamanca	270	37270	Robliza de Cojos	209	105	104	50.2392344497608	49.7607655502392
37	Salamanca	271	37271	Rollán	597	304	293	50.9212730318258	49.0787269681742
37	Salamanca	272	37272	Saelices el Chico	176	92	84	52.2727272727273	47.7272727272727
37	Salamanca	273	37273	Sagrada (La)	184	95	89	51.6304347826087	48.3695652173913
37	Salamanca	274	37274	Salamanca	158556	74303	84253	46.8623073235955	53.1376926764045
37	Salamanca	275	37275	Saldeana	182	98	84	53.8461538461539	46.1538461538462
37	Salamanca	276	37276	Salmoral	327	164	163	50.1529051987768	49.8470948012232
37	Salamanca	277	37277	Salvatierra de Tormes	62	29	33	46.7741935483871	53.2258064516129
37	Salamanca	278	37278	San Cristóbal de la Cuesta	393	207	186	52.6717557251908	47.3282442748092
37	Salamanca	279	37279	Sancti-Spíritus	1172	610	562	52.0477815699659	47.9522184300341
37	Salamanca	280	37280	Sanchón de la Ribera	120	63	57	52.5	47.5
37	Salamanca	281	37281	Sanchón de la Sagrada	55	30	25	54.5454545454545	45.4545454545455
37	Salamanca	282	37282	Sanchotello	317	163	154	51.4195583596215	48.5804416403786
37	Salamanca	283	37283	Sando	176	94	82	53.4090909090909	46.5909090909091
37	Salamanca	284	37284	San Esteban de la Sierra	425	213	212	50.1176470588235	49.8823529411765
37	Salamanca	285	37285	San Felices de los Gallegos	645	321	324	49.7674418604651	50.2325581395349
37	Salamanca	286	37286	San Martín del Castañar	291	153	138	52.5773195876289	47.4226804123711
37	Salamanca	287	37287	San Miguel de Valero	431	228	203	52.9002320185615	47.0997679814385
37	Salamanca	288	37288	San Morales	231	128	103	55.4112554112554	44.5887445887446
37	Salamanca	289	37289	San Muñoz	364	183	181	50.2747252747253	49.7252747252747
37	Salamanca	290	37290	San Pedro del Valle	134	65	69	48.5074626865672	51.4925373134328
37	Salamanca	291	37291	San Pedro de Rozados	343	169	174	49.2711370262391	50.7288629737609
37	Salamanca	292	37292	San Pelayo de Guareña	106	54	52	50.9433962264151	49.0566037735849
37	Salamanca	293	37293	Santa María de Sando	183	96	87	52.4590163934426	47.5409836065574
37	Salamanca	294	37294	Santa Marta de Tormes	10546	5278	5268	50.0474113407927	49.9525886592073
37	Salamanca	296	37296	Santiago de la Puebla	545	281	264	51.5596330275229	48.4403669724771
37	Salamanca	297	37297	Santibáñez de Béjar	667	337	330	50.5247376311844	49.4752623688156
37	Salamanca	298	37298	Santibáñez de la Sierra	251	136	115	54.1832669322709	45.8167330677291
37	Salamanca	299	37299	Santiz	294	147	147	50	50
37	Salamanca	300	37300	Santos (Los)	716	364	352	50.8379888268156	49.1620111731844
37	Salamanca	301	37301	Sardón de los Frailes	102	54	48	52.9411764705882	47.0588235294118
37	Salamanca	302	37302	Saucelle	439	212	227	48.2915717539863	51.7084282460137
37	Salamanca	303	37303	Sahugo (El)	276	147	129	53.2608695652174	46.7391304347826
37	Salamanca	304	37304	Sepulcro-Hilario	294	152	142	51.7006802721089	48.2993197278912
37	Salamanca	305	37305	Sequeros	267	121	146	45.3183520599251	54.6816479400749
37	Salamanca	306	37306	Serradilla del Arroyo	448	230	218	51.3392857142857	48.6607142857143
37	Salamanca	307	37307	Serradilla del Llano	270	136	134	50.3703703703704	49.6296296296296
37	Salamanca	309	37309	Sierpe (La)	50	30	20	60	40
37	Salamanca	310	37310	Sieteiglesias de Tormes	184	91	93	49.4565217391304	50.5434782608696
37	Salamanca	311	37311	Sobradillo	376	179	197	47.6063829787234	52.3936170212766
37	Salamanca	312	37312	Sorihuela	366	178	188	48.6338797814208	51.3661202185792
37	Salamanca	313	37313	Sotoserrano	737	385	352	52.2388059701493	47.7611940298507
37	Salamanca	314	37314	Tabera de Abajo	111	59	52	53.1531531531532	46.8468468468469
37	Salamanca	315	37315	Tala (La)	141	74	67	52.4822695035461	47.5177304964539
37	Salamanca	316	37316	Tamames	995	509	486	51.1557788944724	48.8442211055276
37	Salamanca	317	37317	Tarazona de Guareña	434	233	201	53.6866359447005	46.3133640552995
37	Salamanca	318	37318	Tardáguila	262	140	122	53.4351145038168	46.5648854961832
37	Salamanca	319	37319	Tejado (El)	175	87	88	49.7142857142857	50.2857142857143
37	Salamanca	320	37320	Tejeda y Segoyuela	119	59	60	49.5798319327731	50.4201680672269
37	Salamanca	321	37321	Tenebrón	235	123	112	52.3404255319149	47.6595744680851
37	Salamanca	322	37322	Terradillos	3049	1577	1472	51.7218760249262	48.2781239750738
37	Salamanca	323	37323	Topas	717	365	352	50.9065550906555	49.0934449093445
37	Salamanca	324	37324	Tordillos	569	294	275	51.6695957820738	48.3304042179262
37	Salamanca	325	37325	Tornadizo (El)	147	77	70	52.3809523809524	47.6190476190476
37	Salamanca	327	37327	Torresmenudas	233	111	122	47.6394849785408	52.3605150214592
37	Salamanca	328	37328	Trabanca	245	128	117	52.2448979591837	47.7551020408163
37	Salamanca	329	37329	Tremedal de Tormes	43	22	21	51.1627906976744	48.8372093023256
37	Salamanca	330	37330	Valdecarros	454	232	222	51.1013215859031	48.8986784140969
37	Salamanca	331	37331	Valdefuentes de Sangusín	331	166	165	50.1510574018127	49.8489425981873
37	Salamanca	332	37332	Valdehijaderos	119	64	55	53.781512605042	46.218487394958
37	Salamanca	333	37333	Valdelacasa	344	190	154	55.2325581395349	44.7674418604651
37	Salamanca	334	37334	Valdelageve	127	67	60	52.755905511811	47.244094488189
37	Salamanca	335	37335	Valdelosa	489	230	259	47.0347648261759	52.9652351738241
37	Salamanca	336	37336	Valdemierque	70	35	35	50	50
37	Salamanca	337	37337	Valderrodrigo	191	90	101	47.1204188481675	52.8795811518325
37	Salamanca	338	37338	Valdunciel	118	57	61	48.3050847457627	51.6949152542373
37	Salamanca	339	37339	Valero	449	220	229	48.9977728285078	51.0022271714922
37	Salamanca	340	37340	Valsalabroso	232	124	108	53.448275862069	46.551724137931
37	Salamanca	341	37341	Valverde de Valdelacasa	74	37	37	50	50
37	Salamanca	342	37342	Valverdón	281	146	135	51.9572953736655	48.0427046263345
37	Salamanca	343	37343	Vallejera de Riofrío	56	30	26	53.5714285714286	46.4285714285714
37	Salamanca	344	37344	Vecinos	305	151	154	49.5081967213115	50.4918032786885
37	Salamanca	345	37345	Vega de Tirados	220	111	109	50.4545454545455	49.5454545454546
37	Salamanca	346	37346	Veguillas (Las)	303	150	153	49.5049504950495	50.4950495049505
37	Salamanca	347	37347	Vellés (La)	441	223	218	50.5668934240363	49.4331065759637
37	Salamanca	348	37348	Ventosa del Río Almar	147	68	79	46.2585034013605	53.7414965986395
37	Salamanca	349	37349	Vídola (La)	179	91	88	50.8379888268156	49.1620111731844
37	Salamanca	350	37350	Vilvestre	629	307	322	48.8076311605723	51.1923688394277
37	Salamanca	351	37351	Villaflores	454	228	226	50.2202643171806	49.7797356828194
37	Salamanca	352	37352	Villagonzalo de Tormes	237	118	119	49.789029535865	50.210970464135
37	Salamanca	353	37353	Villalba de los Llanos	195	107	88	54.8717948717949	45.1282051282051
37	Salamanca	354	37354	Villamayor	2901	1510	1391	52.0510168907273	47.9489831092727
37	Salamanca	355	37355	Villanueva del Conde	257	134	123	52.1400778210117	47.8599221789883
37	Salamanca	356	37356	Villar de Argañán	120	60	60	50	50
37	Salamanca	357	37357	Villar de Ciervo	400	207	193	51.75	48.25
37	Salamanca	358	37358	Villar de Gallimazo	213	104	109	48.8262910798122	51.1737089201878
37	Salamanca	359	37359	Villar de la Yegua	301	138	163	45.8471760797342	54.1528239202658
37	Salamanca	360	37360	Villar de Peralonso	344	159	185	46.2209302325581	53.7790697674419
37	Salamanca	361	37361	Villar de Samaniego	128	70	58	54.6875	45.3125
37	Salamanca	362	37362	Villares de la Reina	2901	1476	1425	50.8790072388832	49.1209927611169
37	Salamanca	363	37363	Villares de Yeltes	170	80	90	47.0588235294118	52.9411764705882
37	Salamanca	364	37364	Villarino de los Aires	1067	540	527	50.6091846298032	49.3908153701968
37	Salamanca	365	37365	Villarmayor	230	121	109	52.6086956521739	47.3913043478261
37	Salamanca	366	37366	Villarmuerto	61	35	26	57.3770491803279	42.6229508196721
37	Salamanca	367	37367	Villasbuenas	312	163	149	52.2435897435897	47.7564102564103
37	Salamanca	368	37368	Villasdardo	22	9	13	40.9090909090909	59.0909090909091
37	Salamanca	369	37369	Villaseco de los Gamitos	215	109	106	50.6976744186047	49.3023255813954
37	Salamanca	370	37370	Villaseco de los Reyes	436	224	212	51.3761467889908	48.6238532110092
37	Salamanca	371	37371	Villasrubias	355	193	162	54.3661971830986	45.6338028169014
37	Salamanca	372	37372	Villaverde de Guareña	193	94	99	48.7046632124352	51.2953367875648
37	Salamanca	373	37373	Villavieja de Yeltes	1119	558	561	49.8659517426273	50.1340482573727
37	Salamanca	374	37374	Villoria	1400	700	700	50	50
37	Salamanca	375	37375	Villoruela	1018	507	511	49.803536345776	50.196463654224
37	Salamanca	376	37376	Vitigudino	3128	1535	1593	49.0728900255755	50.9271099744246
37	Salamanca	377	37377	Yecla de Yeltes	357	176	181	49.2997198879552	50.7002801120448
37	Salamanca	378	37378	Zamarra	153	81	72	52.9411764705882	47.0588235294118
37	Salamanca	379	37379	Zamayón	208	118	90	56.7307692307692	43.2692307692308
37	Salamanca	380	37380	Zarapicos	67	38	29	56.7164179104478	43.2835820895522
37	Salamanca	381	37381	Zarza de Pumareda (La)	198	110	88	55.5555555555556	44.4444444444444
37	Salamanca	382	37382	Zorita de la Frontera	278	153	125	55.0359712230216	44.9640287769784
38	Santa Cruz de Tenerife	001	38001	Adeje	14007	7023	6984	50.1392161062326	49.8607838937674
38	Santa Cruz de Tenerife	002	38002	Agulo	1143	563	580	49.2563429571304	50.7436570428696
38	Santa Cruz de Tenerife	003	38003	Alajeró	1343	719	624	53.5368577810871	46.4631422189129
38	Santa Cruz de Tenerife	004	38004	Arafo	4802	2322	2480	48.3548521449396	51.6451478550604
38	Santa Cruz de Tenerife	005	38005	Arico	5644	2902	2742	51.417434443657	48.582565556343
38	Santa Cruz de Tenerife	006	38006	Arona	38416	19420	18996	50.551853394419	49.448146605581
38	Santa Cruz de Tenerife	007	38007	Barlovento	2398	1204	1194	50.208507089241	49.791492910759
38	Santa Cruz de Tenerife	008	38008	Breña Alta	5898	2906	2992	49.2709393014581	50.7290606985419
38	Santa Cruz de Tenerife	009	38009	Breña Baja	4051	2044	2007	50.4566773636139	49.5433226363861
38	Santa Cruz de Tenerife	010	38010	Buenavista del Norte	5140	2617	2523	50.9143968871595	49.0856031128405
38	Santa Cruz de Tenerife	011	38011	Candelaria	13294	6606	6688	49.6915901910636	50.3084098089364
38	Santa Cruz de Tenerife	012	38012	Fasnia	2554	1305	1249	51.0963194988254	48.9036805011746
38	Santa Cruz de Tenerife	013	38013	Frontera	4892	2480	2412	50.6950122649223	49.3049877350777
38	Santa Cruz de Tenerife	014	38014	Fuencaliente de la Palma	1800	918	882	51	49
38	Santa Cruz de Tenerife	015	38015	Garachico	5492	2710	2782	49.3445010924982	50.6554989075018
38	Santa Cruz de Tenerife	016	38016	Garafía	2007	1023	984	50.9715994020927	49.0284005979073
38	Santa Cruz de Tenerife	017	38017	Granadilla de Abona	20323	10264	10059	50.5043546720465	49.4956453279536
38	Santa Cruz de Tenerife	018	38018	Guancha (La)	5269	2613	2656	49.5919529322452	50.4080470677548
38	Santa Cruz de Tenerife	019	38019	Guía de Isora	14674	7286	7388	49.6524465040207	50.3475534959793
38	Santa Cruz de Tenerife	020	38020	Güímar	14646	7203	7443	49.1806636624334	50.8193363375666
38	Santa Cruz de Tenerife	021	38021	Hermigua	2131	1093	1038	51.2904739558893	48.7095260441108
38	Santa Cruz de Tenerife	022	38022	Icod de los Vinos	19977	9799	10178	49.0514091204886	50.9485908795114
38	Santa Cruz de Tenerife	023	38023	San Cristóbal de La Laguna	126543	62089	64454	49.0655350355215	50.9344649644785
38	Santa Cruz de Tenerife	024	38024	Llanos de Aridane (Los)	18190	8971	9219	49.3183067619571	50.6816932380429
38	Santa Cruz de Tenerife	025	38025	Matanza de Acentejo (La)	7000	3549	3451	50.7	49.3
38	Santa Cruz de Tenerife	026	38026	Orotava (La)	38348	19003	19345	49.5540836549494	50.4459163450506
38	Santa Cruz de Tenerife	027	38027	Paso (El)	7289	3702	3587	50.7888599259158	49.2111400740842
38	Santa Cruz de Tenerife	028	38028	Puerto de la Cruz	24988	12023	12965	48.115095245718	51.8849047542821
38	Santa Cruz de Tenerife	029	38029	Puntagorda	1785	883	902	49.4677871148459	50.5322128851541
38	Santa Cruz de Tenerife	030	38030	Puntallana	2204	1087	1117	49.3194192377495	50.6805807622505
38	Santa Cruz de Tenerife	031	38031	Realejos (Los)	34147	16880	17267	49.4333323571617	50.5666676428383
38	Santa Cruz de Tenerife	032	38032	Rosario (El)	12696	6409	6287	50.4804662885948	49.5195337114052
38	Santa Cruz de Tenerife	033	38033	San Andrés y Sauces	5229	2650	2579	50.6789061005929	49.3210938994072
38	Santa Cruz de Tenerife	034	38034	San Juan de la Rambla	4345	2150	2195	49.482163406214	50.517836593786
38	Santa Cruz de Tenerife	035	38035	San Miguel de Abona	7315	3708	3607	50.6903622693096	49.3096377306904
38	Santa Cruz de Tenerife	036	38036	San Sebastián de la Gomera	7001	3542	3459	50.592772461077	49.407227538923
38	Santa Cruz de Tenerife	037	38037	Santa Cruz de la Palma	18204	8866	9338	48.7035816304109	51.2964183695891
38	Santa Cruz de Tenerife	038	38038	Santa Cruz de Tenerife	215132	103642	111490	48.1760035699013	51.8239964300987
38	Santa Cruz de Tenerife	039	38039	Santa Úrsula	10529	5273	5256	50.0807294139994	49.9192705860006
38	Santa Cruz de Tenerife	040	38040	Santiago del Teide	8863	4507	4356	50.8518560306894	49.1481439693106
38	Santa Cruz de Tenerife	041	38041	Sauzal (El)	7443	3723	3720	50.0201531640468	49.9798468359533
38	Santa Cruz de Tenerife	042	38042	Silos (Los)	5066	2488	2578	49.1117252270036	50.8882747729964
38	Santa Cruz de Tenerife	043	38043	Tacoronte	20800	10464	10336	50.3076923076923	49.6923076923077
38	Santa Cruz de Tenerife	044	38044	Tanque (El)	3000	1523	1477	50.7666666666667	49.2333333333333
38	Santa Cruz de Tenerife	045	38045	Tazacorte	6147	3095	3052	50.3497641125752	49.6502358874248
38	Santa Cruz de Tenerife	046	38046	Tegueste	9226	4574	4652	49.577281595491	50.422718404509
38	Santa Cruz de Tenerife	047	38047	Tijarafe	2672	1353	1319	50.6362275449102	49.3637724550898
38	Santa Cruz de Tenerife	048	38048	Valverde	3641	1822	1819	50.0411974732216	49.9588025267784
38	Santa Cruz de Tenerife	049	38049	Valle Gran Rey	4002	2046	1956	51.1244377811094	48.8755622188906
38	Santa Cruz de Tenerife	050	38050	Vallehermoso	2680	1354	1326	50.5223880597015	49.4776119402985
38	Santa Cruz de Tenerife	051	38051	Victoria de Acentejo (La)	8052	3988	4064	49.5280675608545	50.4719324391455
38	Santa Cruz de Tenerife	052	38052	Vilaflor	1634	816	818	49.9388004895961	50.0611995104039
38	Santa Cruz de Tenerife	053	38053	Villa de Mazo	4609	2329	2280	50.5315686699935	49.4684313300065
39	Cantabria	001	39001	Alfoz de Lloredo	2614	1327	1287	50.7651109410865	49.2348890589136
39	Cantabria	002	39002	Ampuero	3491	1765	1726	50.5585792036666	49.4414207963334
39	Cantabria	003	39003	Anievas	381	193	188	50.6561679790026	49.3438320209974
39	Cantabria	004	39004	Arenas de Iguña	2041	1019	1022	49.9265066144047	50.0734933855953
39	Cantabria	005	39005	Argoños	868	448	420	51.6129032258065	48.3870967741936
39	Cantabria	006	39006	Arnuero	1783	900	883	50.4767246214246	49.5232753785754
39	Cantabria	007	39007	Arredondo	635	355	280	55.9055118110236	44.0944881889764
39	Cantabria	008	39008	Astillero (El)	13348	6437	6911	48.2244531015883	51.7755468984118
39	Cantabria	009	39009	Bárcena de Cicero	2334	1178	1156	50.471293916024	49.528706083976
39	Cantabria	010	39010	Bárcena de Pie de Concha	922	452	470	49.0238611713666	50.9761388286334
39	Cantabria	011	39011	Bareyo	1708	874	834	51.1709601873536	48.8290398126464
39	Cantabria	012	39012	Cabezón de la Sal	7182	3539	3643	49.2759676970203	50.7240323029797
39	Cantabria	013	39013	Cabezón de Liébana	679	370	309	54.4918998527246	45.5081001472754
39	Cantabria	014	39014	Cabuérniga	1083	551	532	50.8771929824562	49.1228070175439
39	Cantabria	015	39015	Camaleño	1101	574	527	52.1344232515895	47.8655767484105
39	Cantabria	016	39016	Camargo	22749	11122	11627	48.8900611015869	51.1099388984131
39	Cantabria	017	39017	Campoo de Yuso	739	368	371	49.7970230040595	50.2029769959405
39	Cantabria	018	39018	Cartes	3415	1728	1687	50.6002928257687	49.3997071742313
39	Cantabria	019	39019	Castañeda	1423	695	728	48.8404778636683	51.1595221363317
39	Cantabria	020	39020	Castro-Urdiales	18719	9351	9368	49.9545915914312	50.0454084085688
39	Cantabria	021	39021	Cieza	682	329	353	48.2404692082111	51.7595307917889
39	Cantabria	022	39022	Cillorigo de Liébana	1103	589	514	53.3998186763373	46.6001813236627
39	Cantabria	023	39023	Colindres	6577	3306	3271	50.2660787593128	49.7339212406872
39	Cantabria	024	39024	Comillas	2359	1121	1238	47.5201356506994	52.4798643493006
39	Cantabria	025	39025	Corrales de Buelna (Los)	10718	5361	5357	50.0186601977981	49.9813398022019
39	Cantabria	026	39026	Corvera de Toranzo	2046	1023	1023	50	50
39	Cantabria	027	39027	Campoo de Enmedio	3972	2016	1956	50.7552870090635	49.2447129909366
39	Cantabria	028	39028	Entrambasaguas	2473	1239	1234	50.1010917913465	49.8989082086535
39	Cantabria	029	39029	Escalante	754	393	361	52.1220159151194	47.8779840848806
39	Cantabria	030	39030	Guriezo	1730	906	824	52.3699421965318	47.6300578034682
39	Cantabria	031	39031	Hazas de Cesto	1260	646	614	51.2698412698413	48.7301587301587
39	Cantabria	032	39032	Hermandad de Campoo de Suso	1895	1026	869	54.1424802110818	45.8575197889182
39	Cantabria	033	39033	Herrerías	786	435	351	55.3435114503817	44.6564885496183
39	Cantabria	034	39034	Lamasón	393	221	172	56.234096692112	43.765903307888
39	Cantabria	035	39035	Laredo	12634	6117	6517	48.4169700807345	51.5830299192655
39	Cantabria	036	39036	Liendo	831	430	401	51.7448856799037	48.2551143200963
39	Cantabria	037	39037	Liérganes	2270	1118	1152	49.2511013215859	50.7488986784141
39	Cantabria	038	39038	Limpias	1344	679	665	50.5208333333333	49.4791666666667
39	Cantabria	039	39039	Luena	956	503	453	52.6150627615063	47.3849372384937
39	Cantabria	040	39040	Marina de Cudeyo	4765	2391	2374	50.1783840503673	49.8216159496327
39	Cantabria	041	39041	Mazcuerras	1869	996	873	53.2905296950241	46.7094703049759
39	Cantabria	042	39042	Medio Cudeyo	6087	2979	3108	48.9403647116806	51.0596352883194
39	Cantabria	043	39043	Meruelo	1121	564	557	50.3122212310437	49.6877787689563
39	Cantabria	044	39044	Miengo	3544	1763	1781	49.7460496613996	50.2539503386005
39	Cantabria	045	39045	Miera	532	265	267	49.812030075188	50.187969924812
39	Cantabria	046	39046	Molledo	1935	925	1010	47.8036175710594	52.1963824289406
39	Cantabria	047	39047	Noja	2019	1005	1014	49.777117384844	50.222882615156
39	Cantabria	048	39048	Penagos	1633	804	829	49.2345376607471	50.7654623392529
39	Cantabria	049	39049	Peñarrubia	284	142	142	50	50
39	Cantabria	050	39050	Pesaguero	402	216	186	53.7313432835821	46.2686567164179
39	Cantabria	051	39051	Pesquera	95	47	48	49.4736842105263	50.5263157894737
39	Cantabria	052	39052	Piélagos	11862	5880	5982	49.5700556398584	50.4299443601416
39	Cantabria	053	39053	Polaciones	294	179	115	60.8843537414966	39.1156462585034
39	Cantabria	054	39054	Polanco	3574	1722	1852	48.1813094571908	51.8186905428092
39	Cantabria	055	39055	Potes	1573	772	801	49.07819453274	50.92180546726
39	Cantabria	056	39056	Puente Viesgo	2358	1178	1180	49.9575911789652	50.0424088210348
39	Cantabria	057	39057	Ramales de la Victoria	2228	1154	1074	51.7953321364452	48.2046678635548
39	Cantabria	058	39058	Rasines	963	494	469	51.2980269989616	48.7019730010384
39	Cantabria	059	39059	Reinosa	11193	5398	5795	48.2265701777897	51.7734298222103
39	Cantabria	060	39060	Reocín	6900	3441	3459	49.8695652173913	50.1304347826087
39	Cantabria	061	39061	Ribamontán al Mar	3651	1876	1775	51.3831826896741	48.6168173103259
39	Cantabria	062	39062	Ribamontán al Monte	1991	1029	962	51.6825715720743	48.3174284279257
39	Cantabria	063	39063	Rionansa	1444	808	636	55.9556786703601	44.0443213296399
39	Cantabria	064	39064	Riotuerto	1509	725	784	48.0450629555997	51.9549370444003
39	Cantabria	065	39065	Rozas de Valdearroyo (Las)	325	182	143	56	44
39	Cantabria	066	39066	Ruente	955	513	442	53.717277486911	46.282722513089
39	Cantabria	067	39067	Ruesga	1224	632	592	51.6339869281046	48.3660130718954
39	Cantabria	068	39068	Ruiloba	721	365	356	50.624133148405	49.375866851595
39	Cantabria	069	39069	San Felices de Buelna	2168	1047	1121	48.2933579335793	51.7066420664207
39	Cantabria	070	39070	San Miguel de Aguayo	158	85	73	53.7974683544304	46.2025316455696
39	Cantabria	071	39071	San Pedro del Romeral	645	331	314	51.3178294573643	48.6821705426357
39	Cantabria	072	39072	San Roque de Riomiera	528	301	227	57.0075757575758	42.9924242424242
39	Cantabria	073	39073	Santa Cruz de Bezana	7890	3895	3995	49.3662864385298	50.6337135614702
39	Cantabria	074	39074	Santa María de Cayón	6354	3185	3169	50.125904941769	49.874095058231
39	Cantabria	075	39075	Santander	184264	86324	97940	46.8480006946555	53.1519993053445
39	Cantabria	076	39076	Santillana del Mar	3909	1916	1993	49.0150933742645	50.9849066257355
39	Cantabria	077	39077	Santiurde de Reinosa	321	174	147	54.2056074766355	45.7943925233645
39	Cantabria	078	39078	Santiurde de Toranzo	1627	819	808	50.3380454824831	49.6619545175169
39	Cantabria	079	39079	Santoña	11556	5833	5723	50.4759432329526	49.5240567670474
39	Cantabria	080	39080	San Vicente de la Barquera	4412	2244	2168	50.8612873980054	49.1387126019946
39	Cantabria	081	39081	Saro	527	265	262	50.2846299810247	49.7153700189753
39	Cantabria	082	39082	Selaya	2010	1024	986	50.9452736318408	49.0547263681592
39	Cantabria	083	39083	Soba	1677	876	801	52.2361359570662	47.7638640429338
39	Cantabria	084	39084	Solórzano	995	508	487	51.0552763819096	48.9447236180905
39	Cantabria	085	39085	Suances	6456	3184	3272	49.3184634448575	50.6815365551425
39	Cantabria	086	39086	Tojos (Los)	398	215	183	54.0201005025126	45.9798994974874
39	Cantabria	087	39087	Torrelavega	56189	26988	29201	48.0307533502999	51.9692466497001
39	Cantabria	088	39088	Tresviso	60	35	25	58.3333333333333	41.6666666666667
39	Cantabria	089	39089	Tudanca	269	165	104	61.3382899628253	38.6617100371747
39	Cantabria	090	39090	Udías	843	430	413	51.0083036773428	48.9916963226572
39	Cantabria	091	39091	Valdáliga	2541	1307	1234	51.4364423455333	48.5635576544667
39	Cantabria	092	39092	Valdeolea	1503	768	735	51.0978043912176	48.9021956087824
39	Cantabria	093	39093	Valdeprado del Río	312	164	148	52.5641025641026	47.4358974358974
39	Cantabria	094	39094	Valderredible	1261	662	599	52.4980174464711	47.5019825535289
39	Cantabria	095	39095	Val de San Vicente	2560	1314	1246	51.328125	48.671875
39	Cantabria	096	39096	Vega de Liébana	999	541	458	54.1541541541542	45.8458458458459
39	Cantabria	097	39097	Vega de Pas	1004	520	484	51.792828685259	48.207171314741
39	Cantabria	098	39098	Villacarriedo	1758	916	842	52.1046643913538	47.8953356086462
39	Cantabria	099	39099	Villaescusa	3177	1565	1612	49.2603084671073	50.7396915328927
39	Cantabria	100	39100	Villafufre	1145	599	546	52.3144104803494	47.6855895196507
39	Cantabria	101	39101	Villaverde de Trucíos	367	187	180	50.9536784741144	49.0463215258856
39	Cantabria	102	39102	Voto	2227	1146	1081	51.4593623709026	48.5406376290974
40	Segovia	001	40001	Abades	848	427	421	50.3537735849057	49.6462264150943
40	Segovia	002	40002	Adrada de Pirón	60	34	26	56.6666666666667	43.3333333333333
40	Segovia	003	40003	Adrados	212	108	104	50.9433962264151	49.0566037735849
40	Segovia	004	40004	Aguilafuente	802	391	411	48.7531172069826	51.2468827930175
40	Segovia	005	40005	Alconada de Maderuelo	55	32	23	58.1818181818182	41.8181818181818
40	Segovia	006	40006	Aldealcorvo	30	14	16	46.6666666666667	53.3333333333333
40	Segovia	007	40007	Aldealengua de Pedraza	92	50	42	54.3478260869565	45.6521739130435
40	Segovia	008	40008	Aldealengua de Santa María	90	46	44	51.1111111111111	48.8888888888889
40	Segovia	009	40009	Aldeanueva de la Serrezuela	49	29	20	59.1836734693878	40.8163265306122
40	Segovia	010	40010	Aldeanueva del Codonal	212	110	102	51.8867924528302	48.1132075471698
40	Segovia	012	40012	Aldea Real	390	207	183	53.0769230769231	46.9230769230769
40	Segovia	013	40013	Aldeasoña	106	50	56	47.1698113207547	52.8301886792453
40	Segovia	014	40014	Aldehorno	81	43	38	53.0864197530864	46.9135802469136
40	Segovia	015	40015	Aldehuela del Codonal	53	26	27	49.0566037735849	50.9433962264151
40	Segovia	016	40016	Aldeonte	91	45	46	49.4505494505495	50.5494505494506
40	Segovia	017	40017	Anaya	132	69	63	52.2727272727273	47.7272727272727
40	Segovia	018	40018	Añe	121	63	58	52.0661157024794	47.9338842975207
40	Segovia	019	40019	Arahuetes	45	24	21	53.3333333333333	46.6666666666667
40	Segovia	020	40020	Arcones	248	130	118	52.4193548387097	47.5806451612903
40	Segovia	021	40021	Arevalillo de Cega	44	20	24	45.4545454545455	54.5454545454545
40	Segovia	022	40022	Armuña	261	146	115	55.9386973180077	44.0613026819923
40	Segovia	024	40024	Ayllón	1216	606	610	49.8355263157895	50.1644736842105
40	Segovia	025	40025	Barbolla	221	118	103	53.393665158371	46.606334841629
40	Segovia	026	40026	Basardilla	100	49	51	49	51
40	Segovia	028	40028	Bercial	131	61	70	46.5648854961832	53.4351145038168
40	Segovia	029	40029	Bercimuel	88	40	48	45.4545454545455	54.5454545454545
40	Segovia	030	40030	Bernardos	712	362	350	50.8426966292135	49.1573033707865
40	Segovia	031	40031	Bernuy de Porreros	309	158	151	51.1326860841424	48.8673139158576
40	Segovia	032	40032	Boceguillas	553	278	275	50.2712477396022	49.7287522603978
40	Segovia	033	40033	Brieva	71	44	27	61.9718309859155	38.0281690140845
40	Segovia	034	40034	Caballar	96	47	49	48.9583333333333	51.0416666666667
40	Segovia	035	40035	Cabañas de Polendos	117	59	58	50.4273504273504	49.5726495726496
40	Segovia	036	40036	Cabezuela	721	381	340	52.8432732316228	47.1567267683773
40	Segovia	037	40037	Calabazas de Fuentidueña	76	37	39	48.6842105263158	51.3157894736842
40	Segovia	039	40039	Campo de San Pedro	385	221	164	57.4025974025974	42.5974025974026
40	Segovia	040	40040	Cantalejo	3463	1756	1707	50.707479064395	49.292520935605
40	Segovia	041	40041	Cantimpalos	1275	653	622	51.2156862745098	48.7843137254902
40	Segovia	043	40043	Carbonero el Mayor	2299	1161	1138	50.5002174858634	49.4997825141366
40	Segovia	044	40044	Carrascal del Río	210	112	98	53.3333333333333	46.6666666666667
40	Segovia	045	40045	Casla	155	82	73	52.9032258064516	47.0967741935484
40	Segovia	046	40046	Castillejo de Mesleón	120	60	60	50	50
40	Segovia	047	40047	Castro de Fuentidueña	91	50	41	54.9450549450549	45.0549450549451
40	Segovia	048	40048	Castrojimeno	45	26	19	57.7777777777778	42.2222222222222
40	Segovia	049	40049	Castroserna de Abajo	63	36	27	57.1428571428571	42.8571428571429
40	Segovia	051	40051	Castroserracín	67	38	29	56.7164179104478	43.2835820895522
40	Segovia	052	40052	Cedillo de la Torre	124	60	64	48.3870967741936	51.6129032258065
40	Segovia	053	40053	Cerezo de Abajo	170	83	87	48.8235294117647	51.1764705882353
40	Segovia	054	40054	Cerezo de Arriba	201	102	99	50.7462686567164	49.2537313432836
40	Segovia	055	40055	Cilleruelo de San Mamés	48	21	27	43.75	56.25
40	Segovia	056	40056	Cobos de Fuentidueña	68	29	39	42.6470588235294	57.3529411764706
40	Segovia	057	40057	Coca	1968	968	1000	49.1869918699187	50.8130081300813
40	Segovia	058	40058	Codorniz	471	227	244	48.1953290870488	51.8046709129512
40	Segovia	059	40059	Collado Hermoso	152	74	78	48.6842105263158	51.3157894736842
40	Segovia	060	40060	Condado de Castilnovo	124	67	57	54.0322580645161	45.9677419354839
40	Segovia	061	40061	Corral de Ayllón	109	57	52	52.2935779816514	47.7064220183486
40	Segovia	062	40062	Cubillo	55	32	23	58.1818181818182	41.8181818181818
40	Segovia	063	40063	Cuéllar	9044	4599	4445	50.8513931888545	49.1486068111455
40	Segovia	065	40065	Chañe	720	386	334	53.6111111111111	46.3888888888889
40	Segovia	068	40068	Domingo García	49	25	24	51.0204081632653	48.9795918367347
40	Segovia	069	40069	Donhierro	105	58	47	55.2380952380952	44.7619047619048
40	Segovia	070	40070	Duruelo	136	72	64	52.9411764705882	47.0588235294118
40	Segovia	071	40071	Encinas	72	34	38	47.2222222222222	52.7777777777778
40	Segovia	072	40072	Encinillas	75	41	34	54.6666666666667	45.3333333333333
40	Segovia	073	40073	Escalona del Prado	589	313	276	53.1409168081494	46.8590831918506
40	Segovia	074	40074	Escarabajosa de Cabezas	380	202	178	53.1578947368421	46.8421052631579
40	Segovia	075	40075	Escobar de Polendos	234	121	113	51.7094017094017	48.2905982905983
40	Segovia	076	40076	Espinar (El)	6225	3178	3047	51.0522088353414	48.9477911646586
40	Segovia	077	40077	Espirdo	215	119	96	55.3488372093023	44.6511627906977
40	Segovia	078	40078	Fresneda de Cuéllar	246	130	116	52.8455284552846	47.1544715447155
40	Segovia	079	40079	Fresno de Cantespino	249	133	116	53.4136546184739	46.5863453815261
40	Segovia	080	40080	Fresno de la Fuente	78	39	39	50	50
40	Segovia	081	40081	Frumales	201	104	97	51.7412935323383	48.2587064676617
40	Segovia	082	40082	Fuente de Santa Cruz	194	97	97	50	50
40	Segovia	083	40083	Fuente el Olmo de Fuentidueña	146	73	73	50	50
40	Segovia	084	40084	Fuente el Olmo de Íscar	106	57	49	53.7735849056604	46.2264150943396
40	Segovia	086	40086	Fuentepelayo	953	479	474	50.2623294858342	49.7376705141658
40	Segovia	087	40087	Fuentepiñel	181	91	90	50.2762430939227	49.7237569060774
40	Segovia	088	40088	Fuenterrebollo	447	223	224	49.8881431767338	50.1118568232662
40	Segovia	089	40089	Fuentesaúco de Fuentidueña	325	172	153	52.9230769230769	47.0769230769231
40	Segovia	091	40091	Fuentesoto	172	92	80	53.4883720930233	46.5116279069767
40	Segovia	092	40092	Fuentidueña	181	93	88	51.3812154696133	48.6187845303867
40	Segovia	093	40093	Gallegos	110	55	55	50	50
40	Segovia	094	40094	Garcillán	359	191	168	53.2033426183844	46.7966573816156
40	Segovia	095	40095	Gomezserracín	662	344	318	51.963746223565	48.036253776435
40	Segovia	097	40097	Grajera	97	52	45	53.6082474226804	46.3917525773196
40	Segovia	099	40099	Honrubia de la Cuesta	74	33	41	44.5945945945946	55.4054054054054
40	Segovia	100	40100	Hontalbilla	429	223	206	51.981351981352	48.018648018648
40	Segovia	101	40101	Hontanares de Eresma	165	92	73	55.7575757575758	44.2424242424242
40	Segovia	103	40103	Huertos (Los)	166	79	87	47.5903614457831	52.4096385542169
40	Segovia	104	40104	Ituero y Lama	82	47	35	57.3170731707317	42.6829268292683
40	Segovia	105	40105	Juarros de Riomoros	76	43	33	56.578947368421	43.421052631579
40	Segovia	106	40106	Juarros de Voltoya	309	160	149	51.7799352750809	48.2200647249191
40	Segovia	107	40107	Labajos	157	88	69	56.0509554140127	43.9490445859873
40	Segovia	108	40108	Laguna de Contreras	176	95	81	53.9772727272727	46.0227272727273
40	Segovia	109	40109	Languilla	125	73	52	58.4	41.6
40	Segovia	110	40110	Lastras de Cuéllar	555	298	257	53.6936936936937	46.3063063063063
40	Segovia	111	40111	Lastras del Pozo	83	43	40	51.8072289156626	48.1927710843374
40	Segovia	112	40112	Lastrilla (La)	1716	845	871	49.2424242424242	50.7575757575758
40	Segovia	113	40113	Losa (La)	366	192	174	52.4590163934426	47.5409836065574
40	Segovia	115	40115	Maderuelo	163	82	81	50.3067484662577	49.6932515337423
40	Segovia	118	40118	Marazuela	82	43	39	52.4390243902439	47.5609756097561
40	Segovia	119	40119	Martín Miguel	201	101	100	50.2487562189055	49.7512437810945
40	Segovia	120	40120	Martín Muñoz de la Dehesa	188	101	87	53.7234042553192	46.2765957446809
40	Segovia	121	40121	Martín Muñoz de las Posadas	493	240	253	48.6815415821501	51.3184584178499
40	Segovia	122	40122	Marugán	319	166	153	52.0376175548589	47.9623824451411
40	Segovia	123	40123	Matabuena	216	113	103	52.3148148148148	47.6851851851852
40	Segovia	124	40124	Mata de Cuéllar	327	180	147	55.045871559633	44.954128440367
40	Segovia	125	40125	Matilla (La)	116	60	56	51.7241379310345	48.2758620689655
40	Segovia	126	40126	Melque de Cercos	119	56	63	47.0588235294118	52.9411764705882
40	Segovia	127	40127	Membibre de la Hoz	75	39	36	52	48
40	Segovia	128	40128	Migueláñez	179	85	94	47.4860335195531	52.5139664804469
40	Segovia	129	40129	Montejo de Arévalo	294	157	137	53.4013605442177	46.5986394557823
40	Segovia	130	40130	Montejo de la Vega de la Serrezuela	178	96	82	53.9325842696629	46.0674157303371
40	Segovia	131	40131	Monterrubio	66	34	32	51.5151515151515	48.4848484848485
40	Segovia	132	40132	Moral de Hornuez	105	60	45	57.1428571428571	42.8571428571429
40	Segovia	134	40134	Mozoncillo	1019	529	490	51.9136408243376	48.0863591756624
40	Segovia	135	40135	Muñopedro	387	196	191	50.6459948320413	49.3540051679587
40	Segovia	136	40136	Muñoveros	194	105	89	54.1237113402062	45.8762886597938
40	Segovia	138	40138	Nava de la Asunción	2621	1329	1292	50.7058374666158	49.2941625333842
40	Segovia	139	40139	Navafría	368	195	173	52.9891304347826	47.0108695652174
40	Segovia	140	40140	Navalilla	150	73	77	48.6666666666667	51.3333333333333
40	Segovia	141	40141	Navalmanzano	1127	582	545	51.6415261756877	48.3584738243123
40	Segovia	142	40142	Navares de Ayuso	86	43	43	50	50
40	Segovia	143	40143	Navares de Enmedio	155	84	71	54.1935483870968	45.8064516129032
40	Segovia	144	40144	Navares de las Cuevas	22	12	10	54.5454545454545	45.4545454545455
40	Segovia	145	40145	Navas de Oro	1460	738	722	50.5479452054795	49.4520547945205
40	Segovia	146	40146	Navas de San Antonio	285	147	138	51.5789473684211	48.421052631579
40	Segovia	148	40148	Nieva	379	202	177	53.2981530343008	46.7018469656992
40	Segovia	149	40149	Olombrada	813	425	388	52.2755227552276	47.7244772447724
40	Segovia	150	40150	Orejana	115	64	51	55.6521739130435	44.3478260869565
40	Segovia	151	40151	Ortigosa de Pestaño	87	45	42	51.7241379310345	48.2758620689655
40	Segovia	152	40152	Otero de Herreros	862	418	444	48.491879350348	51.508120649652
40	Segovia	154	40154	Pajarejos	46	20	26	43.4782608695652	56.5217391304348
40	Segovia	155	40155	Palazuelos de Eresma	3123	1602	1521	51.2968299711816	48.7031700288184
40	Segovia	156	40156	Pedraza	467	248	219	53.1049250535332	46.8950749464668
40	Segovia	157	40157	Pelayos del Arroyo	45	23	22	51.1111111111111	48.8888888888889
40	Segovia	158	40158	Perosillo	32	20	12	62.5	37.5
40	Segovia	159	40159	Pinarejos	197	112	85	56.8527918781726	43.1472081218274
40	Segovia	160	40160	Pinarnegrillo	192	99	93	51.5625	48.4375
40	Segovia	161	40161	Pradales	73	38	35	52.0547945205479	47.9452054794521
40	Segovia	162	40162	Prádena	565	305	260	53.9823008849558	46.0176991150443
40	Segovia	163	40163	Puebla de Pedraza	90	46	44	51.1111111111111	48.8888888888889
40	Segovia	164	40164	Rapariegos	268	134	134	50	50
40	Segovia	165	40165	Rebollo	132	71	61	53.7878787878788	46.2121212121212
40	Segovia	166	40166	Remondo	368	172	196	46.7391304347826	53.2608695652174
40	Segovia	168	40168	Riaguas de San Bartolomé	95	50	45	52.6315789473684	47.3684210526316
40	Segovia	170	40170	Riaza	1680	903	777	53.75	46.25
40	Segovia	171	40171	Ribota	40	26	14	65	35
40	Segovia	172	40172	Riofrío de Riaza	50	26	24	52	48
40	Segovia	173	40173	Roda de Eresma	111	55	56	49.5495495495496	50.4504504504505
40	Segovia	174	40174	Sacramenia	560	288	272	51.4285714285714	48.5714285714286
40	Segovia	176	40176	Samboal	590	300	290	50.8474576271186	49.1525423728814
40	Segovia	177	40177	San Cristóbal de Cuéllar	222	110	112	49.5495495495496	50.4504504504505
40	Segovia	178	40178	San Cristóbal de la Vega	161	77	84	47.8260869565217	52.1739130434783
40	Segovia	179	40179	Sanchonuño	738	360	378	48.7804878048781	51.219512195122
40	Segovia	180	40180	Sangarcía	471	240	231	50.9554140127389	49.0445859872611
40	Segovia	181	40181	San Ildefonso	5144	2508	2636	48.755832037325	51.244167962675
40	Segovia	182	40182	San Martín y Mudrián	284	143	141	50.3521126760563	49.6478873239437
40	Segovia	183	40183	San Miguel de Bernuy	175	88	87	50.2857142857143	49.7142857142857
40	Segovia	184	40184	San Pedro de Gaíllos	344	171	173	49.7093023255814	50.2906976744186
40	Segovia	185	40185	Santa María la Real de Nieva	1439	735	704	51.0771369006254	48.9228630993746
40	Segovia	186	40186	Santa Marta del Cerro	51	28	23	54.9019607843137	45.0980392156863
40	Segovia	188	40188	Santiuste de Pedraza	102	55	47	53.921568627451	46.078431372549
40	Segovia	189	40189	Santiuste de San Juan Bautista	775	399	376	51.4838709677419	48.5161290322581
40	Segovia	190	40190	Santo Domingo de Pirón	65	32	33	49.2307692307692	50.7692307692308
40	Segovia	191	40191	Santo Tomé del Puerto	328	173	155	52.7439024390244	47.2560975609756
40	Segovia	192	40192	Sauquillo de Cabezas	245	137	108	55.9183673469388	44.0816326530612
40	Segovia	193	40193	Sebúlcor	279	150	129	53.7634408602151	46.2365591397849
40	Segovia	194	40194	Segovia	54034	25963	28071	48.0493763186142	51.9506236813858
40	Segovia	195	40195	Sepúlveda	1318	674	644	51.1380880121396	48.8619119878604
40	Segovia	196	40196	Sequera de Fresno	51	27	24	52.9411764705882	47.0588235294118
40	Segovia	198	40198	Sotillo	42	19	23	45.2380952380952	54.7619047619048
40	Segovia	199	40199	Sotosalbos	124	69	55	55.6451612903226	44.3548387096774
40	Segovia	200	40200	Tabanera la Luenga	67	34	33	50.7462686567164	49.2537313432836
40	Segovia	201	40201	Tolocirio	62	27	35	43.5483870967742	56.4516129032258
40	Segovia	202	40202	Torreadrada	135	66	69	48.8888888888889	51.1111111111111
40	Segovia	203	40203	Torrecaballeros	518	265	253	51.1583011583012	48.8416988416988
40	Segovia	204	40204	Torrecilla del Pinar	318	155	163	48.7421383647799	51.2578616352201
40	Segovia	205	40205	Torreiglesias	397	205	192	51.6372795969773	48.3627204030227
40	Segovia	206	40206	Torre Val de San Pedro	191	106	85	55.4973821989529	44.5026178010471
40	Segovia	207	40207	Trescasas	328	169	159	51.5243902439024	48.4756097560976
40	Segovia	208	40208	Turégano	1078	541	537	50.1855287569573	49.8144712430427
40	Segovia	210	40210	Urueñas	122	67	55	54.9180327868853	45.0819672131148
40	Segovia	211	40211	Valdeprados	63	30	33	47.6190476190476	52.3809523809524
40	Segovia	212	40212	Valdevacas de Montejo	33	19	14	57.5757575757576	42.4242424242424
40	Segovia	213	40213	Valdevacas y Guijar	147	77	70	52.3809523809524	47.6190476190476
40	Segovia	214	40214	Valseca	294	151	143	51.3605442176871	48.6394557823129
40	Segovia	215	40215	Valtiendas	194	110	84	56.701030927835	43.298969072165
40	Segovia	216	40216	Valverde del Majano	501	257	244	51.2974051896208	48.7025948103792
40	Segovia	218	40218	Valle de Tabladillo	161	81	80	50.3105590062112	49.6894409937888
40	Segovia	219	40219	Vallelado	839	426	413	50.7747318235995	49.2252681764005
40	Segovia	220	40220	Valleruela de Pedraza	75	42	33	56	44
40	Segovia	221	40221	Valleruela de Sepúlveda	75	36	39	48	52
40	Segovia	222	40222	Veganzones	286	143	143	50	50
40	Segovia	223	40223	Vegas de Matute	242	138	104	57.0247933884298	42.9752066115703
40	Segovia	224	40224	Ventosilla y Tejadilla	28	19	9	67.8571428571429	32.1428571428571
40	Segovia	225	40225	Villacastín	1506	765	741	50.796812749004	49.203187250996
40	Segovia	228	40228	Villaverde de Íscar	722	369	353	51.1080332409972	48.8919667590028
40	Segovia	229	40229	Villaverde de Montejo	67	35	32	52.2388059701493	47.7611940298507
40	Segovia	230	40230	Villeguillo	176	94	82	53.4090909090909	46.5909090909091
40	Segovia	231	40231	Yanguas de Eresma	190	92	98	48.421052631579	51.5789473684211
40	Segovia	233	40233	Zarzuela del Monte	531	267	264	50.2824858757062	49.7175141242938
40	Segovia	234	40234	Zarzuela del Pinar	602	316	286	52.4916943521595	47.5083056478405
40	Segovia	901	40901	Ortigosa del Monte	335	169	166	50.4477611940299	49.5522388059702
40	Segovia	902	40902	Cozuelos de Fuentidueña	193	99	94	51.2953367875648	48.7046632124352
40	Segovia	903	40903	Marazoleja	151	86	65	56.953642384106	43.046357615894
40	Segovia	904	40904	Navas de Riofrío	282	136	146	48.2269503546099	51.7730496453901
40	Segovia	905	40905	Cuevas de Provanco	211	109	102	51.6587677725119	48.3412322274882
41	Sevilla	001	41001	Aguadulce	1958	980	978	50.0510725229826	49.9489274770174
41	Sevilla	002	41002	Alanís	2014	1003	1011	49.8013902681231	50.1986097318769
41	Sevilla	003	41003	Albaida del Aljarafe	1820	918	902	50.4395604395604	49.5604395604396
41	Sevilla	004	41004	Alcalá de Guadaira	57206	28348	28858	49.554242561969	50.445757438031
41	Sevilla	005	41005	Alcalá del Río	9301	4715	4586	50.6934738200193	49.3065261799807
41	Sevilla	006	41006	Alcolea del Río	3392	1665	1727	49.0860849056604	50.9139150943396
41	Sevilla	007	41007	Algaba (La)	12916	6497	6419	50.3019510684422	49.6980489315578
41	Sevilla	008	41008	Algámitas	1373	714	659	52.0029133284778	47.9970866715222
41	Sevilla	009	41009	Almadén de la Plata	1764	899	865	50.9637188208617	49.0362811791383
41	Sevilla	010	41010	Almensilla	3110	1580	1530	50.8038585209003	49.1961414790997
41	Sevilla	011	41011	Arahal	18501	9151	9350	49.4621912329063	50.5378087670937
41	Sevilla	012	41012	Aznalcázar	3518	1774	1744	50.4263786242183	49.5736213757817
41	Sevilla	013	41013	Aznalcóllar	5820	2966	2854	50.9621993127148	49.0378006872852
41	Sevilla	014	41014	Badolatosa	3171	1642	1529	51.7817723115736	48.2182276884264
41	Sevilla	015	41015	Benacazón	5021	2542	2479	50.6273650667198	49.3726349332802
41	Sevilla	016	41016	Bollullos de la Mitación	5009	2534	2475	50.5889399081653	49.4110600918347
41	Sevilla	017	41017	Bormujos	9462	4689	4773	49.5561192136969	50.4438807863031
41	Sevilla	018	41018	Brenes	10666	5327	5339	49.9437464841553	50.0562535158447
41	Sevilla	019	41019	Burguillos	3514	1766	1748	50.2561183836084	49.7438816163916
41	Sevilla	020	41020	Cabezas de San Juan (Las)	15676	8059	7617	51.4097984179638	48.5902015820362
41	Sevilla	021	41021	Camas	25333	12396	12937	48.9322227924052	51.0677772075948
41	Sevilla	022	41022	Campana (La)	5169	2593	2576	50.1644418649642	49.8355581350358
41	Sevilla	023	41023	Cantillana	8947	4499	4448	50.2850117357774	49.7149882642226
41	Sevilla	024	41024	Carmona	25723	12959	12764	50.3790382148272	49.6209617851728
41	Sevilla	025	41025	Carrión de los Céspedes	2331	1117	1214	47.9193479193479	52.0806520806521
41	Sevilla	026	41026	Casariche	5200	2623	2577	50.4423076923077	49.5576923076923
41	Sevilla	027	41027	Castilblanco de los Arroyos	4458	2221	2237	49.8205473306416	50.1794526693585
41	Sevilla	028	41028	Castilleja de Guzmán	1447	750	697	51.8313752591569	48.1686247408431
41	Sevilla	029	41029	Castilleja de la Cuesta	16059	7894	8165	49.1562363783548	50.8437636216452
41	Sevilla	030	41030	Castilleja del Campo	617	307	310	49.7568881685575	50.2431118314425
41	Sevilla	031	41031	Castillo de las Guardas (El)	1609	817	792	50.7768800497203	49.2231199502797
41	Sevilla	032	41032	Cazalla de la Sierra	5177	2580	2597	49.8358122464748	50.1641877535252
41	Sevilla	033	41033	Constantina	7145	3505	3640	49.0552834149755	50.9447165850245
41	Sevilla	034	41034	Coria del Río	23935	11981	11954	50.0564027574681	49.9435972425319
41	Sevilla	035	41035	Coripe	1541	790	751	51.2654120700844	48.7345879299156
41	Sevilla	036	41036	Coronil (El)	5132	2593	2539	50.5261106780982	49.4738893219018
41	Sevilla	037	41037	Corrales (Los)	4141	2112	2029	51.0021733880705	48.9978266119295
41	Sevilla	038	41038	Dos Hermanas	97324	48254	49070	49.580781718795	50.4192182812051
41	Sevilla	039	41039	Écija	37652	18549	19103	49.2643153086157	50.7356846913843
41	Sevilla	040	41040	Espartinas	5092	2601	2491	51.0801256873527	48.9198743126473
41	Sevilla	041	41041	Estepa	11721	5777	5944	49.2876034468049	50.7123965531951
41	Sevilla	042	41042	Fuentes de Andalucía	7461	3688	3773	49.4303712639056	50.5696287360944
41	Sevilla	043	41043	Garrobo (El)	772	386	386	50	50
41	Sevilla	044	41044	Gelves	6009	2955	3054	49.1762356465302	50.8237643534698
41	Sevilla	045	41045	Gerena	5509	2752	2757	49.9546197131966	50.0453802868034
41	Sevilla	046	41046	Gilena	3835	1946	1889	50.7431551499348	49.2568448500652
41	Sevilla	047	41047	Gines	9895	4877	5018	49.2875189489641	50.7124810510359
41	Sevilla	048	41048	Guadalcanal	2970	1474	1496	49.6296296296296	50.3703703703704
41	Sevilla	049	41049	Guillena	8406	4243	4163	50.475850582917	49.524149417083
41	Sevilla	050	41050	Herrera	6046	2973	3073	49.1730069467417	50.8269930532584
41	Sevilla	051	41051	Huévar del Aljarafe	2271	1175	1096	51.7393218846323	48.2606781153677
41	Sevilla	052	41052	Lantejuela (La)	3609	1847	1762	51.1776115267387	48.8223884732613
41	Sevilla	053	41053	Lebrija	24172	12191	11981	50.4343868939269	49.5656131060732
41	Sevilla	054	41054	Lora de Estepa	781	391	390	50.0640204865557	49.9359795134443
41	Sevilla	055	41055	Lora del Río	18848	9306	9542	49.3739388794567	50.6260611205433
41	Sevilla	056	41056	Luisiana (La)	4344	2215	2129	50.9898710865562	49.0101289134438
41	Sevilla	057	41057	Madroño (El)	364	183	181	50.2747252747253	49.7252747252747
41	Sevilla	058	41058	Mairena del Alcor	16649	8290	8359	49.792780347168	50.207219652832
41	Sevilla	059	41059	Mairena del Aljarafe	33914	17022	16892	50.1916612608362	49.8083387391638
41	Sevilla	060	41060	Marchena	18086	8903	9183	49.2259206015703	50.7740793984297
41	Sevilla	061	41061	Marinaleda	2634	1303	1331	49.4684889901291	50.5315110098709
41	Sevilla	062	41062	Martín de la Jara	2747	1440	1307	52.4208227156898	47.5791772843102
41	Sevilla	063	41063	Molares (Los)	2674	1344	1330	50.261780104712	49.738219895288
41	Sevilla	064	41064	Montellano	6829	3451	3378	50.5344852833504	49.4655147166496
41	Sevilla	065	41065	Morón de la Frontera	28000	13884	14116	49.5857142857143	50.4142857142857
41	Sevilla	066	41066	Navas de la Concepción (Las)	1888	945	943	50.0529661016949	49.9470338983051
41	Sevilla	067	41067	Olivares	7793	3918	3875	50.2758886179905	49.7241113820095
41	Sevilla	068	41068	Osuna	17290	8540	8750	49.3927125506073	50.6072874493927
41	Sevilla	069	41069	Palacios y Villafranca (Los)	32762	16561	16201	50.5494170075087	49.4505829924913
41	Sevilla	070	41070	Palomares del Río	3759	1919	1840	51.0508113860069	48.9491886139931
41	Sevilla	071	41071	Paradas	7028	3528	3500	50.199203187251	49.800796812749
41	Sevilla	072	41072	Pedrera	5008	2501	2507	49.9400958466454	50.0599041533546
41	Sevilla	073	41073	Pedroso (El)	2380	1178	1202	49.4957983193277	50.5042016806723
41	Sevilla	074	41074	Peñaflor	3832	1941	1891	50.6524008350731	49.3475991649269
41	Sevilla	075	41075	Pilas	11289	5567	5722	49.3134910089468	50.6865089910532
41	Sevilla	076	41076	Pruna	3264	1659	1605	50.8272058823529	49.1727941176471
41	Sevilla	077	41077	Puebla de Cazalla (La)	10691	5356	5335	50.0982134505659	49.9017865494341
41	Sevilla	078	41078	Puebla de los Infantes (La)	3462	1739	1723	50.2310803004044	49.7689196995956
41	Sevilla	079	41079	Puebla del Río (La)	10688	5329	5359	49.8596556886228	50.1403443113773
41	Sevilla	080	41080	Real de la Jara (El)	1706	823	883	48.2415005861665	51.7584994138335
41	Sevilla	081	41081	Rinconada (La)	28487	14391	14096	50.5177800400183	49.4822199599817
41	Sevilla	082	41082	Roda de Andalucía (La)	4193	2073	2120	49.4395420939661	50.5604579060339
41	Sevilla	083	41083	Ronquillo (El)	1421	712	709	50.1055594651654	49.8944405348346
41	Sevilla	084	41084	Rubio (El)	3719	1858	1861	49.9596665770368	50.0403334229632
41	Sevilla	085	41085	Salteras	3064	1529	1535	49.902088772846	50.097911227154
41	Sevilla	086	41086	San Juan de Aznalfarache	20187	9767	10420	48.3826224798137	51.6173775201863
41	Sevilla	087	41087	Sanlúcar la Mayor	10951	5441	5510	49.6849602776002	50.3150397223998
41	Sevilla	088	41088	San Nicolás del Puerto	716	368	348	51.3966480446927	48.6033519553073
41	Sevilla	089	41089	Santiponce	7000	3509	3491	50.1285714285714	49.8714285714286
41	Sevilla	090	41090	Saucejo (El)	4266	2115	2151	49.57805907173	50.42194092827
41	Sevilla	091	41091	Sevilla	700716	334445	366271	47.7290371562802	52.2709628437199
41	Sevilla	092	41092	Tocina	8851	4380	4471	49.4859337927918	50.5140662072082
41	Sevilla	093	41093	Tomares	17842	8820	9022	49.4339199641296	50.5660800358704
41	Sevilla	094	41094	Umbrete	4901	2460	2441	50.1938379922465	49.8061620077535
41	Sevilla	095	41095	Utrera	46084	23070	23014	50.0607586147036	49.9392413852964
41	Sevilla	096	41096	Valencina de la Concepción	6750	3379	3371	50.0592592592593	49.9407407407407
41	Sevilla	097	41097	Villamanrique de la Condesa	3805	1864	1941	48.988173455979	51.011826544021
41	Sevilla	098	41098	Villanueva del Ariscal	4750	2303	2447	48.4842105263158	51.5157894736842
41	Sevilla	099	41099	Villanueva del Río y Minas	5467	2631	2836	48.1251143222974	51.8748856777026
41	Sevilla	100	41100	Villanueva de San Juan	1527	759	768	49.705304518664	50.294695481336
41	Sevilla	101	41101	Villaverde del Río	6632	3367	3265	50.7689987937274	49.2310012062726
41	Sevilla	102	41102	Viso del Alcor (El)	16170	8178	7992	50.5751391465677	49.4248608534323
41	Sevilla	901	41901	Cañada Rosal	2988	1478	1510	49.4645247657296	50.5354752342704
41	Sevilla	902	41902	Villafranco del Guadalquivir	6057	3035	3022	50.1073138517418	49.8926861482582
41	Sevilla	903	41903	Cuervo de Sevilla (El)	7743	3912	3831	50.5230530802015	49.4769469197985
42	Soria	001	42001	Abejar	359	189	170	52.6462395543176	47.3537604456825
42	Soria	003	42003	Adradas	98	53	45	54.0816326530612	45.9183673469388
42	Soria	004	42004	Ágreda	3260	1607	1653	49.2944785276074	50.7055214723926
42	Soria	006	42006	Alconaba	179	100	79	55.8659217877095	44.1340782122905
42	Soria	007	42007	Alcubilla de Avellaneda	228	113	115	49.5614035087719	50.4385964912281
42	Soria	008	42008	Alcubilla de las Peñas	103	52	51	50.4854368932039	49.5145631067961
42	Soria	009	42009	Aldealafuente	153	76	77	49.6732026143791	50.3267973856209
42	Soria	010	42010	Aldealices	33	16	17	48.4848484848485	51.5151515151515
42	Soria	011	42011	Aldealpozo	31	14	17	45.1612903225806	54.8387096774194
42	Soria	012	42012	Aldealseñor	51	31	20	60.7843137254902	39.2156862745098
42	Soria	013	42013	Aldehuela de Periáñez	43	22	21	51.1627906976744	48.8372093023256
42	Soria	014	42014	Aldehuelas (Las)	120	67	53	55.8333333333333	44.1666666666667
42	Soria	015	42015	Alentisque	43	19	24	44.1860465116279	55.8139534883721
42	Soria	016	42016	Aliud	38	19	19	50	50
42	Soria	017	42017	Almajano	177	88	89	49.7175141242938	50.2824858757062
42	Soria	018	42018	Almaluez	303	160	143	52.8052805280528	47.1947194719472
42	Soria	019	42019	Almarza	615	337	278	54.7967479674797	45.2032520325203
42	Soria	020	42020	Almazán	5795	2881	2914	49.7152717860224	50.2847282139776
42	Soria	021	42021	Almazul	167	86	81	51.497005988024	48.502994011976
42	Soria	022	42022	Almenar de Soria	387	207	180	53.4883720930233	46.5116279069767
42	Soria	023	42023	Alpanseque	105	53	52	50.4761904761905	49.5238095238095
42	Soria	024	42024	Arancón	118	65	53	55.0847457627119	44.9152542372881
42	Soria	025	42025	Arcos de Jalón	1856	941	915	50.7004310344828	49.2995689655172
42	Soria	026	42026	Arenillas	44	25	19	56.8181818181818	43.1818181818182
42	Soria	027	42027	Arévalo de la Sierra	102	56	46	54.9019607843137	45.0980392156863
42	Soria	028	42028	Ausejo de la Sierra	61	30	31	49.1803278688525	50.8196721311475
42	Soria	029	42029	Baraona	232	126	106	54.3103448275862	45.6896551724138
42	Soria	030	42030	Barca	139	79	60	56.8345323741007	43.1654676258993
42	Soria	031	42031	Barcones	46	25	21	54.3478260869565	45.6521739130435
42	Soria	032	42032	Bayubas de Abajo	278	147	131	52.8776978417266	47.1223021582734
42	Soria	033	42033	Bayubas de Arriba	81	40	41	49.3827160493827	50.6172839506173
42	Soria	034	42034	Beratón	34	27	7	79.4117647058823	20.5882352941176
42	Soria	035	42035	Berlanga de Duero	1148	583	565	50.7839721254355	49.2160278745645
42	Soria	036	42036	Blacos	61	38	23	62.2950819672131	37.7049180327869
42	Soria	037	42037	Bliecos	57	32	25	56.140350877193	43.859649122807
42	Soria	038	42038	Borjabad	61	34	27	55.7377049180328	44.2622950819672
42	Soria	039	42039	Borobia	381	185	196	48.5564304461942	51.4435695538058
42	Soria	041	42041	Buberos	49	24	25	48.9795918367347	51.0204081632653
42	Soria	042	42042	Buitrago	55	25	30	45.4545454545455	54.5454545454545
42	Soria	043	42043	Burgo de Osma-Ciudad de Osma	4966	2440	2526	49.1341119613371	50.8658880386629
42	Soria	044	42044	Cabrejas del Campo	87	49	38	56.3218390804598	43.6781609195402
42	Soria	045	42045	Cabrejas del Pinar	466	251	215	53.862660944206	46.137339055794
42	Soria	046	42046	Calatañazor	75	43	32	57.3333333333333	42.6666666666667
42	Soria	048	42048	Caltojar	124	65	59	52.4193548387097	47.5806451612903
42	Soria	049	42049	Candilichera	235	117	118	49.7872340425532	50.2127659574468
42	Soria	050	42050	Cañamaque	45	26	19	57.7777777777778	42.2222222222222
42	Soria	051	42051	Carabantes	37	17	20	45.945945945946	54.0540540540541
42	Soria	052	42052	Caracena	23	16	7	69.5652173913043	30.4347826086957
42	Soria	053	42053	Carrascosa de Abajo	39	20	19	51.2820512820513	48.7179487179487
42	Soria	054	42054	Carrascosa de la Sierra	14	7	7	50	50
42	Soria	055	42055	Casarejos	258	133	125	51.5503875968992	48.4496124031008
42	Soria	056	42056	Castilfrío de la Sierra	29	18	11	62.0689655172414	37.9310344827586
42	Soria	057	42057	Castilruiz	323	162	161	50.1547987616099	49.8452012383901
42	Soria	058	42058	Castillejo de Robledo	193	101	92	52.3316062176166	47.6683937823834
42	Soria	059	42059	Centenera de Andaluz	29	10	19	34.4827586206897	65.5172413793104
42	Soria	060	42060	Cerbón	50	28	22	56	44
42	Soria	061	42061	Cidones	341	190	151	55.7184750733138	44.2815249266862
42	Soria	062	42062	Cigudosa	76	45	31	59.2105263157895	40.7894736842105
42	Soria	063	42063	Cihuela	105	50	55	47.6190476190476	52.3809523809524
42	Soria	064	42064	Ciria	112	52	60	46.4285714285714	53.5714285714286
42	Soria	065	42065	Cirujales del Río	41	22	19	53.6585365853659	46.3414634146342
42	Soria	068	42068	Coscurita	141	82	59	58.1560283687943	41.8439716312057
42	Soria	069	42069	Covaleda	2043	1034	1009	50.6118453255017	49.3881546744983
42	Soria	070	42070	Cubilla	73	40	33	54.7945205479452	45.2054794520548
42	Soria	071	42071	Cubo de la Solana	250	137	113	54.8	45.2
42	Soria	073	42073	Cueva de Ágreda	101	51	50	50.4950495049505	49.5049504950495
42	Soria	075	42075	Dévanos	133	71	62	53.3834586466165	46.6165413533835
42	Soria	076	42076	Deza	388	195	193	50.2577319587629	49.7422680412371
42	Soria	078	42078	Duruelo de la Sierra	1452	724	728	49.8622589531681	50.137741046832
42	Soria	079	42079	Escobosa de Almazán	41	24	17	58.5365853658537	41.4634146341463
42	Soria	080	42080	Espeja de San Marcelino	259	142	117	54.8262548262548	45.1737451737452
42	Soria	081	42081	Espejón	225	111	114	49.3333333333333	50.6666666666667
42	Soria	082	42082	Estepa de San Juan	15	8	7	53.3333333333333	46.6666666666667
42	Soria	083	42083	Frechilla de Almazán	49	25	24	51.0204081632653	48.9795918367347
42	Soria	084	42084	Fresno de Caracena	55	31	24	56.3636363636364	43.6363636363636
42	Soria	085	42085	Fuentearmegil	343	184	159	53.6443148688047	46.3556851311953
42	Soria	086	42086	Fuentecambrón	76	40	36	52.6315789473684	47.3684210526316
42	Soria	087	42087	Fuentecantos	53	27	26	50.9433962264151	49.0566037735849
42	Soria	088	42088	Fuentelmonge	139	69	70	49.6402877697842	50.3597122302158
42	Soria	089	42089	Fuentelsaz de Soria	60	21	39	35	65
42	Soria	090	42090	Fuentepinilla	154	87	67	56.4935064935065	43.5064935064935
42	Soria	092	42092	Fuentes de Magaña	99	47	52	47.4747474747475	52.5252525252525
42	Soria	093	42093	Fuentestrún	77	45	32	58.4415584415584	41.5584415584416
42	Soria	094	42094	Garray	431	231	200	53.5962877030162	46.4037122969838
42	Soria	095	42095	Golmayo	765	437	328	57.1241830065359	42.8758169934641
42	Soria	096	42096	Gómara	477	246	231	51.5723270440252	48.4276729559748
42	Soria	097	42097	Gormaz	17	7	10	41.1764705882353	58.8235294117647
42	Soria	098	42098	Herrera de Soria	23	16	7	69.5652173913043	30.4347826086957
42	Soria	100	42100	Hinojosa del Campo	48	30	18	62.5	37.5
42	Soria	103	42103	Langa de Duero	932	505	427	54.1845493562232	45.8154506437768
42	Soria	105	42105	Liceras	62	33	29	53.2258064516129	46.7741935483871
42	Soria	106	42106	Losilla (La)	20	12	8	60	40
42	Soria	107	42107	Magaña	103	52	51	50.4854368932039	49.5145631067961
42	Soria	108	42108	Maján	18	10	8	55.5555555555556	44.4444444444444
42	Soria	110	42110	Matalebreras	121	63	58	52.0661157024794	47.9338842975207
42	Soria	111	42111	Matamala de Almazán	403	206	197	51.1166253101737	48.8833746898263
42	Soria	113	42113	Medinaceli	701	354	347	50.4992867332382	49.5007132667618
42	Soria	115	42115	Miño de Medinaceli	114	54	60	47.3684210526316	52.6315789473684
42	Soria	116	42116	Miño de San Esteban	94	54	40	57.4468085106383	42.5531914893617
42	Soria	117	42117	Molinos de Duero	192	103	89	53.6458333333333	46.3541666666667
42	Soria	118	42118	Momblona	40	23	17	57.5	42.5
42	Soria	119	42119	Monteagudo de las Vicarías	304	150	154	49.3421052631579	50.6578947368421
42	Soria	120	42120	Montejo de Tiermes	251	140	111	55.7768924302789	44.2231075697211
42	Soria	121	42121	Montenegro de Cameros	113	62	51	54.8672566371681	45.1327433628319
42	Soria	123	42123	Morón de Almazán	281	132	149	46.9750889679715	53.0249110320285
42	Soria	124	42124	Muriel de la Fuente	84	48	36	57.1428571428571	42.8571428571429
42	Soria	125	42125	Muriel Viejo	79	36	43	45.5696202531646	54.4303797468354
42	Soria	127	42127	Nafría de Ucero	86	43	43	50	50
42	Soria	128	42128	Narros	52	27	25	51.9230769230769	48.0769230769231
42	Soria	129	42129	Navaleno	959	484	475	50.4692387904067	49.5307612095933
42	Soria	130	42130	Nepas	87	51	36	58.6206896551724	41.3793103448276
42	Soria	131	42131	Nolay	95	49	46	51.5789473684211	48.421052631579
42	Soria	132	42132	Noviercas	242	117	125	48.3471074380165	51.6528925619835
42	Soria	134	42134	Ólvega	3298	1712	1586	51.9102486355367	48.0897513644633
42	Soria	135	42135	Oncala	106	59	47	55.6603773584906	44.3396226415094
42	Soria	139	42139	Pinilla del Campo	24	13	11	54.1666666666667	45.8333333333333
42	Soria	140	42140	Portillo de Soria	21	12	9	57.1428571428571	42.8571428571429
42	Soria	141	42141	Póveda de Soria (La)	121	63	58	52.0661157024794	47.9338842975207
42	Soria	142	42142	Pozalmuro	108	52	56	48.1481481481482	51.8518518518519
42	Soria	144	42144	Quintana Redonda	568	298	270	52.4647887323944	47.5352112676056
42	Soria	145	42145	Quintanas de Gormaz	199	104	95	52.2613065326633	47.7386934673367
42	Soria	148	42148	Quiñonería	15	5	10	33.3333333333333	66.6666666666667
42	Soria	149	42149	Rábanos (Los)	414	237	177	57.2463768115942	42.7536231884058
42	Soria	151	42151	Rebollar	52	29	23	55.7692307692308	44.2307692307692
42	Soria	152	42152	Recuerda	115	58	57	50.4347826086956	49.5652173913044
42	Soria	153	42153	Rello	42	19	23	45.2380952380952	54.7619047619048
42	Soria	154	42154	Renieblas	122	65	57	53.2786885245902	46.7213114754098
42	Soria	155	42155	Retortillo de Soria	241	132	109	54.7717842323651	45.2282157676349
42	Soria	156	42156	Reznos	42	26	16	61.9047619047619	38.0952380952381
42	Soria	157	42157	Riba de Escalote (La)	29	17	12	58.6206896551724	41.3793103448276
42	Soria	158	42158	Rioseco de Soria	145	72	73	49.6551724137931	50.3448275862069
42	Soria	159	42159	Rollamienta	45	26	19	57.7777777777778	42.2222222222222
42	Soria	160	42160	Royo (El)	335	166	169	49.5522388059702	50.4477611940299
42	Soria	161	42161	Salduero	193	105	88	54.4041450777202	45.5958549222798
42	Soria	162	42162	San Esteban de Gormaz	3348	1702	1646	50.8363201911589	49.1636798088411
42	Soria	163	42163	San Felices	85	43	42	50.5882352941176	49.4117647058824
42	Soria	164	42164	San Leonardo de Yagüe	2070	1057	1013	51.0628019323672	48.9371980676328
42	Soria	165	42165	San Pedro Manrique	487	261	226	53.5934291581109	46.4065708418891
42	Soria	166	42166	Santa Cruz de Yanguas	61	36	25	59.0163934426229	40.9836065573771
42	Soria	167	42167	Santa María de Huerta	449	235	214	52.3385300668152	47.6614699331849
42	Soria	168	42168	Santa María de las Hoyas	206	111	95	53.8834951456311	46.1165048543689
42	Soria	171	42171	Serón de Nágima	260	135	125	51.9230769230769	48.0769230769231
42	Soria	172	42172	Soliedra	40	25	15	62.5	37.5
42	Soria	173	42173	Soria	34088	16203	17885	47.532856137057	52.467143862943
42	Soria	174	42174	Sotillo del Rincón	230	117	113	50.8695652173913	49.1304347826087
42	Soria	175	42175	Suellacabras	38	21	17	55.2631578947369	44.7368421052632
42	Soria	176	42176	Tajahuerce	47	22	25	46.8085106382979	53.1914893617021
42	Soria	177	42177	Tajueco	122	64	58	52.4590163934426	47.5409836065574
42	Soria	178	42178	Talveila	199	104	95	52.2613065326633	47.7386934673367
42	Soria	181	42181	Tardelcuende	636	319	317	50.1572327044025	49.8427672955975
42	Soria	182	42182	Taroda	81	41	40	50.6172839506173	49.3827160493827
42	Soria	183	42183	Tejado	219	111	108	50.6849315068493	49.3150684931507
42	Soria	184	42184	Torlengua	110	54	56	49.0909090909091	50.9090909090909
42	Soria	185	42185	Torreblacos	37	19	18	51.3513513513514	48.6486486486487
42	Soria	187	42187	Torrubia de Soria	95	53	42	55.7894736842105	44.2105263157895
42	Soria	188	42188	Trévago	76	31	45	40.7894736842105	59.2105263157895
42	Soria	189	42189	Ucero	111	58	53	52.2522522522523	47.7477477477478
42	Soria	190	42190	Vadillo	147	78	69	53.0612244897959	46.9387755102041
42	Soria	191	42191	Valdeavellano de Tera	256	127	129	49.609375	50.390625
42	Soria	192	42192	Valdegeña	48	28	20	58.3333333333333	41.6666666666667
42	Soria	193	42193	Valdelagua del Cerro	27	15	12	55.5555555555556	44.4444444444444
42	Soria	194	42194	Valdemaluque	305	152	153	49.8360655737705	50.1639344262295
42	Soria	195	42195	Valdenebro	144	75	69	52.0833333333333	47.9166666666667
42	Soria	196	42196	Valdeprado	19	9	10	47.3684210526316	52.6315789473684
42	Soria	197	42197	Valderrodilla	123	62	61	50.4065040650407	49.5934959349593
42	Soria	198	42198	Valtajeros	30	16	14	53.3333333333333	46.6666666666667
42	Soria	200	42200	Velamazán	147	82	65	55.7823129251701	44.2176870748299
42	Soria	201	42201	Velilla de la Sierra	22	10	12	45.4545454545455	54.5454545454545
42	Soria	202	42202	Velilla de los Ajos	45	27	18	60	40
42	Soria	204	42204	Viana de Duero	77	47	30	61.038961038961	38.961038961039
42	Soria	205	42205	Villaciervos	99	60	39	60.6060606060606	39.3939393939394
42	Soria	206	42206	Villanueva de Gormaz	19	12	7	63.1578947368421	36.8421052631579
42	Soria	207	42207	Villar del Ala	57	26	31	45.6140350877193	54.3859649122807
42	Soria	208	42208	Villar del Campo	36	19	17	52.7777777777778	47.2222222222222
42	Soria	209	42209	Villar del Río	180	95	85	52.7777777777778	47.2222222222222
42	Soria	211	42211	Villares de Soria (Los)	114	56	58	49.1228070175439	50.8771929824562
42	Soria	212	42212	Villasayas	99	60	39	60.6060606060606	39.3939393939394
42	Soria	213	42213	Villaseca de Arciel	44	25	19	56.8181818181818	43.1818181818182
42	Soria	215	42215	Vinuesa	1070	564	506	52.7102803738318	47.2897196261682
42	Soria	216	42216	Vizmanos	41	27	14	65.8536585365854	34.1463414634146
42	Soria	217	42217	Vozmediano	54	30	24	55.5555555555556	44.4444444444444
42	Soria	218	42218	Yanguas	136	67	69	49.2647058823529	50.7352941176471
42	Soria	219	42219	Yelo	63	33	30	52.3809523809524	47.6190476190476
43	Tarragona	001	43001	Aiguamúrcia	652	339	313	51.9938650306749	48.0061349693252
43	Tarragona	002	43002	Albinyana	1380	718	662	52.0289855072464	47.9710144927536
43	Tarragona	003	43003	Albiol (L')	175	96	79	54.8571428571429	45.1428571428571
43	Tarragona	004	43004	Alcanar	7878	3917	3961	49.7207413048997	50.2792586951003
43	Tarragona	005	43005	Alcover	3787	1927	1860	50.884605228413	49.115394771587
43	Tarragona	006	43006	Aldover	792	377	415	47.6010101010101	52.3989898989899
43	Tarragona	007	43007	Aleixar (L')	717	367	350	51.1854951185495	48.8145048814505
43	Tarragona	008	43008	Alfara de Carles	365	194	171	53.1506849315069	46.8493150684932
43	Tarragona	009	43009	Alforja	1269	648	621	51.063829787234	48.936170212766
43	Tarragona	010	43010	Alió	372	185	187	49.7311827956989	50.2688172043011
43	Tarragona	011	43011	Almoster	823	423	400	51.3973268529769	48.6026731470231
43	Tarragona	012	43012	Altafulla	3111	1589	1522	51.0768241722919	48.9231758277081
43	Tarragona	013	43013	Ametlla de Mar (L')	4946	2482	2464	50.1819652244238	49.8180347755762
43	Tarragona	014	43014	Amposta	16372	8073	8299	49.3097972147569	50.6902027852431
43	Tarragona	015	43015	Arbolí	139	70	69	50.3597122302158	49.6402877697842
43	Tarragona	016	43016	Arboç (L')	3551	1841	1710	51.8445508307519	48.1554491692481
43	Tarragona	017	43017	Argentera (L')	148	85	63	57.4324324324324	42.5675675675676
43	Tarragona	018	43018	Arnes	517	268	249	51.8375241779497	48.1624758220503
43	Tarragona	019	43019	Ascó	1707	864	843	50.6151142355009	49.3848857644991
43	Tarragona	020	43020	Banyeres del Penedès	1694	885	809	52.2432113341204	47.7567886658796
43	Tarragona	021	43021	Barberà de la Conca	409	202	207	49.3887530562347	50.6112469437653
43	Tarragona	022	43022	Batea	1964	987	977	50.2545824847251	49.745417515275
43	Tarragona	023	43023	Bellmunt del Priorat	310	151	159	48.7096774193548	51.2903225806452
43	Tarragona	024	43024	Bellvei	1368	722	646	52.7777777777778	47.2222222222222
43	Tarragona	025	43025	Benifallet	883	441	442	49.9433748584371	50.0566251415629
43	Tarragona	026	43026	Benissanet	1022	523	499	51.174168297456	48.825831702544
43	Tarragona	027	43027	Bisbal de Falset (La)	242	120	122	49.5867768595041	50.4132231404959
43	Tarragona	028	43028	Bisbal del Penedès (La)	1943	1023	920	52.6505404014411	47.3494595985589
43	Tarragona	029	43029	Blancafort	379	196	183	51.7150395778364	48.2849604221636
43	Tarragona	030	43030	Bonastre	319	166	153	52.0376175548589	47.9623824451411
43	Tarragona	031	43031	Borges del Camp (Les)	1577	797	780	50.5389980976538	49.4610019023462
43	Tarragona	032	43032	Bot	830	419	411	50.4819277108434	49.5180722891566
43	Tarragona	033	43033	Botarell	624	318	306	50.9615384615385	49.0384615384615
43	Tarragona	034	43034	Bràfim	573	279	294	48.6910994764398	51.3089005235602
43	Tarragona	035	43035	Cabacés	339	178	161	52.5073746312684	47.4926253687316
43	Tarragona	036	43036	Cabra del Camp	601	315	286	52.4126455906822	47.5873544093178
43	Tarragona	037	43037	Calafell	12219	6160	6059	50.4132907766593	49.5867092233407
43	Tarragona	038	43038	Cambrils	19942	9911	10031	49.699127469662	50.300872530338
43	Tarragona	039	43039	Capafonts	124	65	59	52.4193548387097	47.5806451612903
43	Tarragona	040	43040	Capçanes	401	184	217	45.8852867830424	54.1147132169576
43	Tarragona	041	43041	Caseres	325	161	164	49.5384615384615	50.4615384615385
43	Tarragona	042	43042	Castellvell del Camp	1062	543	519	51.1299435028249	48.8700564971751
43	Tarragona	043	43043	Catllar (El)	2363	1243	1120	52.6026237833263	47.3973762166737
43	Tarragona	044	43044	Sénia (La)	5034	2562	2472	50.8939213349225	49.1060786650775
43	Tarragona	045	43045	Colldejou	198	108	90	54.5454545454545	45.4545454545455
43	Tarragona	046	43046	Conesa	116	63	53	54.3103448275862	45.6896551724138
43	Tarragona	047	43047	Constantí	5021	2599	2422	51.7625970922127	48.2374029077873
43	Tarragona	048	43048	Corbera d'Ebre	1056	543	513	51.4204545454545	48.5795454545455
43	Tarragona	049	43049	Cornudella de Montsant	840	427	413	50.8333333333333	49.1666666666667
43	Tarragona	050	43050	Creixell	1837	922	915	50.1905280348394	49.8094719651606
43	Tarragona	051	43051	Cunit	5943	3059	2884	51.472320376914	48.527679623086
43	Tarragona	052	43052	Xerta	1225	608	617	49.6326530612245	50.3673469387755
43	Tarragona	053	43053	Duesaigües	199	120	79	60.3015075376884	39.6984924623116
43	Tarragona	054	43054	Espluga de Francolí (L')	3654	1802	1852	49.3158182813355	50.6841817186645
43	Tarragona	055	43055	Falset	2448	1234	1214	50.4084967320261	49.5915032679739
43	Tarragona	056	43056	Fatarella (La)	1244	620	624	49.8392282958199	50.1607717041801
43	Tarragona	057	43057	Febró (La)	63	39	24	61.9047619047619	38.0952380952381
43	Tarragona	058	43058	Figuera (La)	121	61	60	50.4132231404959	49.5867768595041
43	Tarragona	059	43059	Figuerola del Camp	280	134	146	47.8571428571429	52.1428571428571
43	Tarragona	060	43060	Flix	4208	2099	2109	49.8811787072243	50.1188212927757
43	Tarragona	061	43061	Forès	68	33	35	48.5294117647059	51.4705882352941
43	Tarragona	062	43062	Freginals	362	180	182	49.7237569060774	50.2762430939227
43	Tarragona	063	43063	Galera (La)	746	367	379	49.1957104557641	50.8042895442359
43	Tarragona	064	43064	Gandesa	2564	1284	1280	50.0780031201248	49.9219968798752
43	Tarragona	065	43065	Garcia	512	262	250	51.171875	48.828125
43	Tarragona	066	43066	Garidells (Els)	162	80	82	49.3827160493827	50.6172839506173
43	Tarragona	067	43067	Ginestar	837	423	414	50.5376344086022	49.4623655913979
43	Tarragona	068	43068	Godall	721	366	355	50.7628294036061	49.2371705963939
43	Tarragona	069	43069	Gratallops	232	123	109	53.0172413793103	46.9827586206897
43	Tarragona	070	43070	Guiamets (Els)	304	152	152	50	50
43	Tarragona	071	43071	Horta de Sant Joan	1233	653	580	52.9602595296026	47.0397404703974
43	Tarragona	072	43072	Lloar (El)	123	61	62	49.5934959349593	50.4065040650407
43	Tarragona	073	43073	Llorac	120	58	62	48.3333333333333	51.6666666666667
43	Tarragona	074	43074	Llorenç del Penedès	1575	755	820	47.9365079365079	52.0634920634921
43	Tarragona	075	43075	Margalef	129	66	63	51.1627906976744	48.8372093023256
43	Tarragona	076	43076	Marçà	600	295	305	49.1666666666667	50.8333333333333
43	Tarragona	077	43077	Mas de Barberans	699	360	339	51.5021459227468	48.4978540772532
43	Tarragona	078	43078	Masdenverge	956	488	468	51.0460251046025	48.9539748953975
43	Tarragona	079	43079	Masllorenç	409	206	203	50.3667481662592	49.6332518337408
43	Tarragona	080	43080	Masó (La)	275	134	141	48.7272727272727	51.2727272727273
43	Tarragona	081	43081	Maspujols	464	243	221	52.3706896551724	47.6293103448276
43	Tarragona	082	43082	Masroig (El)	506	246	260	48.6166007905138	51.3833992094862
43	Tarragona	083	43083	Milà (El)	162	79	83	48.7654320987654	51.2345679012346
43	Tarragona	084	43084	Miravet	788	415	373	52.6649746192893	47.3350253807107
43	Tarragona	085	43085	Molar (El)	289	152	137	52.5951557093426	47.4048442906574
43	Tarragona	086	43086	Montblanc	6029	2984	3045	49.4941117930005	50.5058882069995
43	Tarragona	088	43088	Montbrió del Camp	1459	732	727	50.1713502398903	49.8286497601097
43	Tarragona	089	43089	Montferri	157	80	77	50.9554140127389	49.0445859872611
43	Tarragona	090	43090	Montmell (El)	408	226	182	55.3921568627451	44.6078431372549
43	Tarragona	091	43091	Mont-ral	160	89	71	55.625	44.375
43	Tarragona	092	43092	Mont-roig del Camp	6683	3402	3281	50.9052820589556	49.0947179410444
43	Tarragona	093	43093	Móra d'Ebre	4816	2376	2440	49.3355481727575	50.6644518272425
43	Tarragona	094	43094	Móra la Nova	2661	1324	1337	49.7557309282225	50.2442690717775
43	Tarragona	095	43095	Morell (El)	2308	1168	1140	50.6065857885615	49.3934142114385
43	Tarragona	096	43096	Morera de Montsant (La)	176	101	75	57.3863636363636	42.6136363636364
43	Tarragona	097	43097	Nou de Gaià (La)	376	189	187	50.2659574468085	49.7340425531915
43	Tarragona	098	43098	Nulles	347	160	187	46.1095100864553	53.8904899135447
43	Tarragona	099	43099	Palma d'Ebre (La)	419	200	219	47.7326968973747	52.2673031026253
43	Tarragona	100	43100	Pallaresos (Els)	2537	1308	1229	51.5569570358691	48.4430429641309
43	Tarragona	101	43101	Passanant	183	109	74	59.5628415300546	40.4371584699454
43	Tarragona	102	43102	Paüls	640	324	316	50.625	49.375
43	Tarragona	103	43103	Perafort	610	312	298	51.1475409836066	48.8524590163934
43	Tarragona	104	43104	Perelló (El)	2145	1101	1044	51.3286713286713	48.6713286713287
43	Tarragona	105	43105	Piles (Les)	178	98	80	55.0561797752809	44.9438202247191
43	Tarragona	106	43106	Pinell de Brai (El)	1074	546	528	50.8379888268156	49.1620111731844
43	Tarragona	107	43107	Pira	402	197	205	49.0049751243781	50.9950248756219
43	Tarragona	108	43108	Pla de Santa Maria (El)	1651	849	802	51.4233797698365	48.5766202301635
43	Tarragona	109	43109	Pobla de Mafumet (La)	1115	558	557	50.0448430493274	49.9551569506726
43	Tarragona	110	43110	Pobla de Massaluca (La)	442	227	215	51.3574660633484	48.6425339366516
43	Tarragona	111	43111	Pobla de Montornès (La)	1336	721	615	53.9670658682635	46.0329341317365
43	Tarragona	112	43112	Poboleda	335	169	166	50.4477611940299	49.5522388059702
43	Tarragona	113	43113	Pont d'Armentera (El)	576	297	279	51.5625	48.4375
43	Tarragona	114	43114	Porrera	472	254	218	53.8135593220339	46.1864406779661
43	Tarragona	115	43115	Pradell de la Teixeta	198	101	97	51.010101010101	48.989898989899
43	Tarragona	116	43116	Prades	528	267	261	50.5681818181818	49.4318181818182
43	Tarragona	117	43117	Prat de Comte	178	85	93	47.7528089887641	52.247191011236
43	Tarragona	118	43118	Pratdip	563	282	281	50.088809946714	49.911190053286
43	Tarragona	119	43119	Puigpelat	597	300	297	50.251256281407	49.748743718593
43	Tarragona	120	43120	Querol	305	170	135	55.7377049180328	44.2622950819672
43	Tarragona	121	43121	Rasquera	792	402	390	50.7575757575758	49.2424242424242
43	Tarragona	122	43122	Renau	61	29	32	47.5409836065574	52.4590163934426
43	Tarragona	123	43123	Reus	89179	43499	45680	48.7771784837238	51.2228215162762
43	Tarragona	124	43124	Riba (La)	732	380	352	51.9125683060109	48.0874316939891
43	Tarragona	125	43125	Riba-roja d'Ebre	1350	696	654	51.5555555555556	48.4444444444444
43	Tarragona	126	43126	Riera de Gaià (La)	970	486	484	50.1030927835052	49.8969072164948
43	Tarragona	127	43127	Riudecanyes	694	349	345	50.2881844380404	49.7118155619597
43	Tarragona	128	43128	Riudecols	997	511	486	51.2537612838516	48.7462387161484
43	Tarragona	129	43129	Riudoms	5201	2613	2588	50.2403383964622	49.7596616035378
43	Tarragona	130	43130	Rocafort de Queralt	279	148	131	53.0465949820789	46.9534050179212
43	Tarragona	131	43131	Roda de Barà	3361	1829	1532	54.4183278786076	45.5816721213924
43	Tarragona	132	43132	Rodonyà	420	218	202	51.9047619047619	48.0952380952381
43	Tarragona	133	43133	Roquetes	6366	3203	3163	50.3141690229344	49.6858309770657
43	Tarragona	134	43134	Rourell (El)	262	139	123	53.0534351145038	46.9465648854962
43	Tarragona	135	43135	Salomó	382	194	188	50.7853403141361	49.2146596858639
43	Tarragona	136	43136	Sant Carles de la Ràpita	11194	5552	5642	49.5979989279971	50.4020010720029
43	Tarragona	137	43137	Sant Jaume dels Domenys	1390	724	666	52.0863309352518	47.9136690647482
43	Tarragona	138	43138	Santa Bàrbara	3257	1628	1629	49.9846484494934	50.0153515505066
43	Tarragona	139	43139	Santa Coloma de Queralt	2615	1263	1352	48.2982791586998	51.7017208413002
43	Tarragona	140	43140	Santa Oliva	2101	1066	1035	50.7377439314612	49.2622560685388
43	Tarragona	141	43141	Pontils	148	75	73	50.6756756756757	49.3243243243243
43	Tarragona	142	43142	Sarral	1430	745	685	52.0979020979021	47.9020979020979
43	Tarragona	143	43143	Savallà del Comtat	75	36	39	48	52
43	Tarragona	144	43144	Secuita (La)	1131	572	559	50.5747126436782	49.4252873563218
43	Tarragona	145	43145	Selva del Camp (La)	4103	2064	2039	50.3046551303924	49.6953448696076
43	Tarragona	146	43146	Senan	31	20	11	64.5161290322581	35.4838709677419
43	Tarragona	147	43147	Solivella	622	304	318	48.8745980707396	51.1254019292605
43	Tarragona	148	43148	Tarragona	114097	55698	58399	48.8163580111659	51.1836419888341
43	Tarragona	149	43149	Tivenys	917	458	459	49.9454743729553	50.0545256270447
43	Tarragona	150	43150	Tivissa	1764	876	888	49.6598639455782	50.3401360544218
43	Tarragona	151	43151	Torre de Fontaubella (La)	128	63	65	49.21875	50.78125
43	Tarragona	152	43152	Torre de l'Espanyol (La)	674	349	325	51.7804154302671	48.2195845697329
43	Tarragona	153	43153	Torredembarra	10581	5254	5327	49.6550420565164	50.3449579434836
43	Tarragona	154	43154	Torroja del Priorat	139	80	59	57.5539568345324	42.4460431654676
43	Tarragona	155	43155	Tortosa	29481	14288	15193	48.4651131237068	51.5348868762932
43	Tarragona	156	43156	Ulldecona	5304	2627	2677	49.5286576168929	50.4713423831071
43	Tarragona	157	43157	Ulldemolins	495	259	236	52.3232323232323	47.6767676767677
43	Tarragona	158	43158	Vallclara	117	62	55	52.991452991453	47.008547008547
43	Tarragona	159	43159	Vallfogona de Riucorb	164	85	79	51.8292682926829	48.1707317073171
43	Tarragona	160	43160	Vallmoll	1168	609	559	52.1404109589041	47.8595890410959
43	Tarragona	161	43161	Valls	20382	9994	10388	49.0334608968698	50.9665391031302
43	Tarragona	162	43162	Vandellòs i l'Hospitalet de l'Infant	4343	2176	2167	50.1036150126641	49.8963849873359
43	Tarragona	163	43163	Vendrell (El)	22543	11310	11233	50.1707847225303	49.8292152774697
43	Tarragona	164	43164	Vespella de Gaià	205	116	89	56.5853658536585	43.4146341463415
43	Tarragona	165	43165	Vilabella	788	397	391	50.3807106598985	49.6192893401015
43	Tarragona	166	43166	Vilallonga del Camp	1237	614	623	49.6362166531932	50.3637833468068
43	Tarragona	167	43167	Vilanova d'Escornalbou	449	234	215	52.1158129175947	47.8841870824054
43	Tarragona	168	43168	Vilanova de Prades	157	80	77	50.9554140127389	49.0445859872611
43	Tarragona	169	43169	Vilaplana	526	264	262	50.1901140684411	49.8098859315589
43	Tarragona	170	43170	Vila-rodona	1034	562	472	54.3520309477756	45.6479690522244
43	Tarragona	171	43171	Vila-seca	13133	6612	6521	50.3464554937943	49.6535445062057
43	Tarragona	172	43172	Vilaverd	354	177	177	50	50
43	Tarragona	173	43173	Vilella Alta (La)	128	66	62	51.5625	48.4375
43	Tarragona	174	43174	Vilella Baixa (La)	174	94	80	54.0229885057471	45.9770114942529
43	Tarragona	175	43175	Vilalba dels Arcs	762	399	363	52.3622047244094	47.6377952755905
43	Tarragona	176	43176	Vimbodí	1011	539	472	53.3135509396637	46.6864490603363
43	Tarragona	177	43177	Vinebre	443	221	222	49.8871331828442	50.1128668171558
43	Tarragona	178	43178	Vinyols i els Arcs	1213	632	581	52.1022258862325	47.8977741137675
43	Tarragona	901	43901	Deltebre	10250	5132	5118	50.0682926829268	49.9317073170732
43	Tarragona	902	43902	Sant Jaume d'Enveja	3305	1668	1637	50.4689863842663	49.5310136157337
43	Tarragona	903	43903	Camarles	2887	1428	1459	49.4631104953239	50.5368895046761
43	Tarragona	904	43904	Aldea (L')	3546	1803	1743	50.8460236886633	49.1539763113367
43	Tarragona	905	43905	Salou	13059	6629	6430	50.761926640631	49.238073359369
43	Tarragona	906	43906	Ampolla (L')	1831	906	925	49.4811578372474	50.5188421627526
44	Teruel	001	44001	Ababuj	85	48	37	56.4705882352941	43.5294117647059
44	Teruel	002	44002	Abejuela	58	40	18	68.9655172413793	31.0344827586207
44	Teruel	003	44003	Aguatón	24	10	14	41.6666666666667	58.3333333333333
44	Teruel	004	44004	Aguaviva	592	290	302	48.9864864864865	51.0135135135135
44	Teruel	005	44005	Aguilar del Alfambra	83	40	43	48.1927710843374	51.8072289156626
44	Teruel	006	44006	Alacón	457	234	223	51.2035010940919	48.7964989059081
44	Teruel	007	44007	Alba	271	142	129	52.3985239852399	47.6014760147602
44	Teruel	008	44008	Albalate del Arzobispo	2283	1115	1168	48.8392466053439	51.1607533946562
44	Teruel	009	44009	Albarracín	1055	552	503	52.3222748815166	47.6777251184834
44	Teruel	010	44010	Albentosa	257	131	126	50.9727626459144	49.0272373540856
44	Teruel	011	44011	Alcaine	74	43	31	58.1081081081081	41.8918918918919
44	Teruel	012	44012	Alcalá de la Selva	478	259	219	54.18410041841	45.81589958159
44	Teruel	013	44013	Alcañiz	13127	6484	6643	49.3943779995429	50.6056220004571
44	Teruel	014	44014	Alcorisa	3245	1629	1616	50.2003081664099	49.7996918335901
44	Teruel	016	44016	Alfambra	645	330	315	51.1627906976744	48.8372093023256
44	Teruel	017	44017	Aliaga	393	208	185	52.9262086513995	47.0737913486005
44	Teruel	018	44018	Almohaja	29	18	11	62.0689655172414	37.9310344827586
44	Teruel	019	44019	Alobras	92	51	41	55.4347826086957	44.5652173913043
44	Teruel	020	44020	Alpeñés	28	18	10	64.2857142857143	35.7142857142857
44	Teruel	021	44021	Allepuz	143	75	68	52.4475524475525	47.5524475524476
44	Teruel	022	44022	Alloza	772	367	405	47.5388601036269	52.4611398963731
44	Teruel	023	44023	Allueva	16	11	5	68.75	31.25
44	Teruel	024	44024	Anadón	17	9	8	52.9411764705882	47.0588235294118
44	Teruel	025	44025	Andorra	8000	4122	3878	51.525	48.475
44	Teruel	026	44026	Arcos de las Salinas	144	68	76	47.2222222222222	52.7777777777778
44	Teruel	027	44027	Arens de Lledó	241	115	126	47.7178423236515	52.2821576763486
44	Teruel	028	44028	Argente	262	136	126	51.9083969465649	48.0916030534351
44	Teruel	029	44029	Ariño	866	423	443	48.8452655889146	51.1547344110854
44	Teruel	031	44031	Azaila	174	97	77	55.7471264367816	44.2528735632184
44	Teruel	032	44032	Bádenas	24	12	12	50	50
44	Teruel	033	44033	Báguena	500	251	249	50.2	49.8
44	Teruel	034	44034	Bañón	182	99	83	54.3956043956044	45.6043956043956
44	Teruel	035	44035	Barrachina	163	83	80	50.920245398773	49.079754601227
44	Teruel	036	44036	Bea	45	28	17	62.2222222222222	37.7777777777778
44	Teruel	037	44037	Beceite	638	319	319	50	50
44	Teruel	038	44038	Belmonte de San José	144	78	66	54.1666666666667	45.8333333333333
44	Teruel	039	44039	Bello	393	186	207	47.3282442748092	52.6717557251908
44	Teruel	040	44040	Berge	231	117	114	50.6493506493506	49.3506493506493
44	Teruel	041	44041	Bezas	70	37	33	52.8571428571429	47.1428571428571
44	Teruel	042	44042	Blancas	183	100	83	54.6448087431694	45.3551912568306
44	Teruel	043	44043	Blesa	156	95	61	60.8974358974359	39.1025641025641
44	Teruel	044	44044	Bordón	148	74	74	50	50
44	Teruel	045	44045	Bronchales	457	245	212	53.6105032822757	46.3894967177243
44	Teruel	046	44046	Bueña	102	56	46	54.9019607843137	45.0980392156863
44	Teruel	047	44047	Burbáguena	326	147	179	45.0920245398773	54.9079754601227
44	Teruel	048	44048	Cabra de Mora	115	65	50	56.5217391304348	43.4782608695652
44	Teruel	049	44049	Calaceite	1193	616	577	51.6345347862531	48.3654652137469
44	Teruel	050	44050	Calamocha	4063	2025	2038	49.8400196898843	50.1599803101157
44	Teruel	051	44051	Calanda	3484	1766	1718	50.6888633754305	49.3111366245695
44	Teruel	052	44052	Calomarde	82	39	43	47.5609756097561	52.4390243902439
44	Teruel	053	44053	Camañas	137	79	58	57.6642335766423	42.3357664233577
44	Teruel	054	44054	Camarena de la Sierra	186	104	82	55.9139784946237	44.0860215053763
44	Teruel	055	44055	Camarillas	122	66	56	54.0983606557377	45.9016393442623
44	Teruel	056	44056	Caminreal	813	405	408	49.8154981549816	50.1845018450184
44	Teruel	059	44059	Cantavieja	734	386	348	52.5885558583106	47.4114441416894
44	Teruel	060	44060	Cañada de Benatanduz	63	40	23	63.4920634920635	36.5079365079365
44	Teruel	061	44061	Cañada de Verich (La)	106	58	48	54.7169811320755	45.2830188679245
44	Teruel	062	44062	Cañada Vellida	58	38	20	65.5172413793104	34.4827586206897
44	Teruel	063	44063	Cañizar del Olivar	125	64	61	51.2	48.8
44	Teruel	064	44064	Cascante del Río	121	75	46	61.9834710743802	38.0165289256198
44	Teruel	065	44065	Castejón de Tornos	103	50	53	48.5436893203884	51.4563106796116
44	Teruel	066	44066	Castel de Cabra	172	90	82	52.3255813953488	47.6744186046512
44	Teruel	067	44067	Castelnou	98	51	47	52.0408163265306	47.9591836734694
44	Teruel	068	44068	Castelserás	858	454	404	52.9137529137529	47.0862470862471
44	Teruel	070	44070	Castellar (El)	97	52	45	53.6082474226804	46.3917525773196
44	Teruel	071	44071	Castellote	737	382	355	51.831750339213	48.168249660787
44	Teruel	074	44074	Cedrillas	527	272	255	51.6129032258065	48.3870967741936
44	Teruel	075	44075	Celadas	424	229	195	54.0094339622642	45.9905660377359
44	Teruel	076	44076	Cella	2897	1496	1401	51.6396272005523	48.3603727994477
44	Teruel	077	44077	Cerollera (La)	111	62	49	55.8558558558559	44.1441441441441
44	Teruel	080	44080	Codoñera (La)	344	180	164	52.3255813953488	47.6744186046512
44	Teruel	082	44082	Corbalán	76	45	31	59.2105263157895	40.7894736842105
44	Teruel	084	44084	Cortes de Aragón	117	58	59	49.5726495726496	50.4273504273504
44	Teruel	085	44085	Cosa	104	56	48	53.8461538461539	46.1538461538462
44	Teruel	086	44086	Cretas	603	309	294	51.2437810945274	48.7562189054726
44	Teruel	087	44087	Crivillén	128	68	60	53.125	46.875
44	Teruel	088	44088	Cuba (La)	60	29	31	48.3333333333333	51.6666666666667
44	Teruel	089	44089	Cubla	50	26	24	52	48
44	Teruel	090	44090	Cucalón	76	42	34	55.2631578947369	44.7368421052632
44	Teruel	092	44092	Cuervo (El)	123	62	61	50.4065040650407	49.5934959349593
44	Teruel	093	44093	Cuevas de Almudén	103	56	47	54.3689320388349	45.6310679611651
44	Teruel	094	44094	Cuevas Labradas	162	88	74	54.320987654321	45.679012345679
44	Teruel	096	44096	Ejulve	229	116	113	50.6550218340611	49.3449781659389
44	Teruel	097	44097	Escorihuela	234	115	119	49.1452991452991	50.8547008547009
44	Teruel	099	44099	Escucha	1103	583	520	52.8558476881233	47.1441523118767
44	Teruel	100	44100	Estercuel	348	182	166	52.2988505747126	47.7011494252874
44	Teruel	101	44101	Ferreruela de Huerva	87	47	40	54.0229885057471	45.9770114942529
44	Teruel	102	44102	Fonfría	32	18	14	56.25	43.75
44	Teruel	103	44103	Formiche Alto	199	104	95	52.2613065326633	47.7386934673367
44	Teruel	105	44105	Fórnoles	104	49	55	47.1153846153846	52.8846153846154
44	Teruel	106	44106	Fortanete	194	105	89	54.1237113402062	45.8762886597938
44	Teruel	107	44107	Foz-Calanda	241	131	110	54.3568464730291	45.643153526971
44	Teruel	108	44108	Fresneda (La)	416	217	199	52.1634615384615	47.8365384615385
44	Teruel	109	44109	Frías de Albarracín	157	84	73	53.5031847133758	46.4968152866242
44	Teruel	110	44110	Fuenferrada	47	26	21	55.3191489361702	44.6808510638298
44	Teruel	111	44111	Fuentes Calientes	129	73	56	56.5891472868217	43.4108527131783
44	Teruel	112	44112	Fuentes Claras	650	321	329	49.3846153846154	50.6153846153846
44	Teruel	113	44113	Fuentes de Rubielos	88	49	39	55.6818181818182	44.3181818181818
44	Teruel	114	44114	Fuentespalda	357	179	178	50.140056022409	49.859943977591
44	Teruel	115	44115	Galve	145	78	67	53.7931034482759	46.2068965517241
44	Teruel	116	44116	Gargallo	121	66	55	54.5454545454545	45.4545454545455
44	Teruel	117	44117	Gea de Albarracín	453	233	220	51.4348785871965	48.5651214128035
44	Teruel	118	44118	Ginebrosa (La)	249	137	112	55.0200803212851	44.9799196787149
44	Teruel	119	44119	Griegos	138	81	57	58.695652173913	41.304347826087
44	Teruel	120	44120	Guadalaviar	287	146	141	50.8710801393728	49.1289198606272
44	Teruel	121	44121	Gúdar	74	44	30	59.4594594594595	40.5405405405405
44	Teruel	122	44122	Híjar	1901	964	937	50.7101525512888	49.2898474487112
44	Teruel	123	44123	Hinojosa de Jarque	177	91	86	51.4124293785311	48.5875706214689
44	Teruel	124	44124	Hoz de la Vieja (La)	123	62	61	50.4065040650407	49.5934959349593
44	Teruel	125	44125	Huesa del Común	135	78	57	57.7777777777778	42.2222222222222
44	Teruel	126	44126	Iglesuela del Cid (La)	499	261	238	52.3046092184369	47.6953907815631
44	Teruel	127	44127	Jabaloyas	89	46	43	51.685393258427	48.314606741573
44	Teruel	128	44128	Jarque de la Val	95	53	42	55.7894736842105	44.2105263157895
44	Teruel	129	44129	Jatiel	67	34	33	50.7462686567164	49.2537313432836
44	Teruel	130	44130	Jorcas	48	30	18	62.5	37.5
44	Teruel	131	44131	Josa	39	22	17	56.4102564102564	43.5897435897436
44	Teruel	132	44132	Lagueruela	69	36	33	52.1739130434783	47.8260869565217
44	Teruel	133	44133	Lanzuela	30	19	11	63.3333333333333	36.6666666666667
44	Teruel	135	44135	Libros	161	82	79	50.9316770186335	49.0683229813665
44	Teruel	136	44136	Lidón	79	36	43	45.5696202531646	54.4303797468354
44	Teruel	137	44137	Linares de Mora	294	164	130	55.7823129251701	44.2176870748299
44	Teruel	138	44138	Loscos	217	117	100	53.9170506912442	46.0829493087558
44	Teruel	141	44141	Lledó	201	110	91	54.726368159204	45.273631840796
44	Teruel	142	44142	Maicas	35	15	20	42.8571428571429	57.1428571428571
44	Teruel	143	44143	Manzanera	467	259	208	55.4603854389722	44.5396145610278
44	Teruel	144	44144	Martín del Río	495	251	244	50.7070707070707	49.2929292929293
44	Teruel	145	44145	Mas de las Matas	1488	754	734	50.6720430107527	49.3279569892473
44	Teruel	146	44146	Mata de los Olmos (La)	267	124	143	46.4419475655431	53.5580524344569
44	Teruel	147	44147	Mazaleón	601	308	293	51.2479201331115	48.7520798668885
44	Teruel	148	44148	Mezquita de Jarque	133	72	61	54.1353383458647	45.8646616541353
44	Teruel	149	44149	Mirambel	146	83	63	56.8493150684932	43.1506849315069
44	Teruel	150	44150	Miravete de la Sierra	49	30	19	61.2244897959184	38.7755102040816
44	Teruel	151	44151	Molinos	329	173	156	52.5835866261398	47.4164133738602
44	Teruel	152	44152	Monforte de Moyuela	61	35	26	57.3770491803279	42.6229508196721
44	Teruel	153	44153	Monreal del Campo	2311	1149	1162	49.7187364777153	50.2812635222847
44	Teruel	154	44154	Monroyo	362	193	169	53.3149171270718	46.6850828729282
44	Teruel	155	44155	Montalbán	1588	811	777	51.0705289672544	48.9294710327456
44	Teruel	156	44156	Monteagudo del Castillo	68	40	28	58.8235294117647	41.1764705882353
44	Teruel	157	44157	Monterde de Albarracín	67	36	31	53.7313432835821	46.2686567164179
44	Teruel	158	44158	Mora de Rubielos	1371	704	667	51.3493800145879	48.6506199854121
44	Teruel	159	44159	Moscardón	55	29	26	52.7272727272727	47.2727272727273
44	Teruel	160	44160	Mosqueruela	693	364	329	52.5252525252525	47.4747474747475
44	Teruel	161	44161	Muniesa	737	380	357	51.5603799185889	48.4396200814111
44	Teruel	163	44163	Noguera de Albarracín	176	91	85	51.7045454545455	48.2954545454546
44	Teruel	164	44164	Nogueras	20	15	5	75	25
44	Teruel	165	44165	Nogueruelas	223	118	105	52.914798206278	47.085201793722
44	Teruel	167	44167	Obón	52	26	26	50	50
44	Teruel	168	44168	Odón	271	126	145	46.4944649446495	53.5055350553506
44	Teruel	169	44169	Ojos Negros	563	295	268	52.3978685612789	47.6021314387211
44	Teruel	171	44171	Olba	195	97	98	49.7435897435897	50.2564102564103
44	Teruel	172	44172	Oliete	476	242	234	50.8403361344538	49.1596638655462
44	Teruel	173	44173	Olmos (Los)	142	73	69	51.4084507042254	48.5915492957747
44	Teruel	174	44174	Orihuela del Tremedal	628	310	318	49.3630573248408	50.6369426751592
44	Teruel	175	44175	Orrios	191	98	93	51.3089005235602	48.6910994764398
44	Teruel	176	44176	Palomar de Arroyos	255	141	114	55.2941176470588	44.7058823529412
44	Teruel	177	44177	Pancrudo	167	89	78	53.2934131736527	46.7065868263473
44	Teruel	178	44178	Parras de Castellote (Las)	76	41	35	53.9473684210526	46.0526315789474
44	Teruel	179	44179	Peñarroya de Tastavins	521	273	248	52.3992322456814	47.6007677543186
44	Teruel	180	44180	Peracense	108	58	50	53.7037037037037	46.2962962962963
44	Teruel	181	44181	Peralejos	93	48	45	51.6129032258065	48.3870967741936
44	Teruel	182	44182	Perales del Alfambra	295	155	140	52.5423728813559	47.4576271186441
44	Teruel	183	44183	Pitarque	109	50	59	45.8715596330275	54.1284403669725
44	Teruel	184	44184	Plou	47	24	23	51.063829787234	48.936170212766
44	Teruel	185	44185	Pobo (El)	146	81	65	55.4794520547945	44.5205479452055
44	Teruel	187	44187	Portellada (La)	312	163	149	52.2435897435897	47.7564102564103
44	Teruel	189	44189	Pozondón	83	43	40	51.8072289156626	48.1927710843374
44	Teruel	190	44190	Pozuel del Campo	115	63	52	54.7826086956522	45.2173913043478
44	Teruel	191	44191	Puebla de Híjar (La)	1089	542	547	49.7704315886134	50.2295684113866
44	Teruel	192	44192	Puebla de Valverde (La)	489	268	221	54.8057259713701	45.1942740286299
44	Teruel	193	44193	Puertomingalvo	140	75	65	53.5714285714286	46.4285714285714
44	Teruel	194	44194	Ráfales	201	101	100	50.2487562189055	49.7512437810945
44	Teruel	195	44195	Rillo	139	75	64	53.9568345323741	46.0431654676259
44	Teruel	196	44196	Riodeva	218	104	114	47.7064220183486	52.2935779816514
44	Teruel	197	44197	Ródenas	98	48	50	48.9795918367347	51.0204081632653
44	Teruel	198	44198	Royuela	238	136	102	57.1428571428571	42.8571428571429
44	Teruel	199	44199	Rubiales	58	32	26	55.1724137931034	44.8275862068966
44	Teruel	200	44200	Rubielos de la Cérida	62	30	32	48.3870967741936	51.6129032258065
44	Teruel	201	44201	Rubielos de Mora	616	310	306	50.3246753246753	49.6753246753247
44	Teruel	203	44203	Salcedillo	7	3	4	42.8571428571429	57.1428571428571
44	Teruel	204	44204	Saldón	42	24	18	57.1428571428571	42.8571428571429
44	Teruel	205	44205	Samper de Calanda	988	472	516	47.7732793522267	52.2267206477733
44	Teruel	206	44206	San Agustín	138	69	69	50	50
44	Teruel	207	44207	San Martín del Río	288	138	150	47.9166666666667	52.0833333333333
44	Teruel	208	44208	Santa Cruz de Nogueras	26	15	11	57.6923076923077	42.3076923076923
44	Teruel	209	44209	Santa Eulalia	1230	601	629	48.8617886178862	51.1382113821138
44	Teruel	210	44210	Sarrión	1015	529	486	52.1182266009852	47.8817733990148
44	Teruel	211	44211	Segura de los Baños	50	25	25	50	50
44	Teruel	212	44212	Seno	49	25	24	51.0204081632653	48.9795918367347
44	Teruel	213	44213	Singra	93	45	48	48.3870967741936	51.6129032258065
44	Teruel	215	44215	Terriente	184	104	80	56.5217391304348	43.4782608695652
44	Teruel	216	44216	Teruel	30491	14733	15758	48.3191761503394	51.6808238496605
44	Teruel	217	44217	Toril y Masegoso	32	19	13	59.375	40.625
44	Teruel	218	44218	Tormón	39	20	19	51.2820512820513	48.7179487179487
44	Teruel	219	44219	Tornos	249	134	115	53.8152610441767	46.1847389558233
44	Teruel	220	44220	Torralba de los Sisones	224	114	110	50.8928571428571	49.1071428571429
44	Teruel	221	44221	Torrecilla de Alcañiz	427	225	202	52.6932084309134	47.3067915690867
44	Teruel	222	44222	Torrecilla del Rebollar	186	97	89	52.1505376344086	47.8494623655914
44	Teruel	223	44223	Torre de Arcas	107	52	55	48.5981308411215	51.4018691588785
44	Teruel	224	44224	Torre de las Arcas	34	20	14	58.8235294117647	41.1764705882353
44	Teruel	225	44225	Torre del Compte	175	85	90	48.5714285714286	51.4285714285714
44	Teruel	226	44226	Torrelacárcel	290	153	137	52.7586206896552	47.2413793103448
44	Teruel	227	44227	Torre los Negros	100	49	51	49	51
44	Teruel	228	44228	Torremocha de Jiloca	170	82	88	48.2352941176471	51.764705882353
44	Teruel	229	44229	Torres de Albarracín	161	87	74	54.0372670807454	45.9627329192547
44	Teruel	230	44230	Torrevelilla	203	103	100	50.7389162561576	49.2610837438424
44	Teruel	231	44231	Torrijas	74	33	41	44.5945945945946	55.4054054054054
44	Teruel	232	44232	Torrijo del Campo	556	281	275	50.5395683453237	49.4604316546763
44	Teruel	234	44234	Tramacastiel	118	58	60	49.1525423728814	50.8474576271186
44	Teruel	235	44235	Tramacastilla	124	58	66	46.7741935483871	53.2258064516129
44	Teruel	236	44236	Tronchón	95	51	44	53.6842105263158	46.3157894736842
44	Teruel	237	44237	Urrea de Gaén	610	300	310	49.1803278688525	50.8196721311475
44	Teruel	238	44238	Utrillas	3279	1700	1579	51.8450747179018	48.1549252820982
44	Teruel	239	44239	Valacloche	20	13	7	65	35
44	Teruel	240	44240	Valbona	187	98	89	52.4064171122995	47.5935828877005
44	Teruel	241	44241	Valdealgorfa	736	365	371	49.5923913043478	50.4076086956522
44	Teruel	243	44243	Valdecuenca	39	20	19	51.2820512820513	48.7179487179487
44	Teruel	244	44244	Valdelinares	119	67	52	56.3025210084034	43.6974789915966
44	Teruel	245	44245	Valdeltormo	369	194	175	52.5745257452575	47.4254742547426
44	Teruel	246	44246	Valderrobres	1845	952	893	51.5989159891599	48.4010840108401
44	Teruel	247	44247	Valjunquera	440	218	222	49.5454545454546	50.4545454545455
44	Teruel	249	44249	Vallecillo (El)	69	37	32	53.6231884057971	46.3768115942029
44	Teruel	250	44250	Veguillas de la Sierra	28	17	11	60.7142857142857	39.2857142857143
44	Teruel	251	44251	Villafranca del Campo	382	190	192	49.738219895288	50.261780104712
44	Teruel	252	44252	Villahermosa del Campo	70	38	32	54.2857142857143	45.7142857142857
44	Teruel	256	44256	Villanueva del Rebollar de la Sierra	52	30	22	57.6923076923077	42.3076923076923
44	Teruel	257	44257	Villar del Cobo	223	117	106	52.4663677130045	47.5336322869955
44	Teruel	258	44258	Villar del Salz	101	56	45	55.4455445544555	44.5544554455446
44	Teruel	260	44260	Villarluengo	201	116	85	57.7114427860697	42.2885572139304
44	Teruel	261	44261	Villarquemado	966	490	476	50.7246376811594	49.2753623188406
44	Teruel	262	44262	Villarroya de los Pinares	201	105	96	52.2388059701493	47.7611940298507
44	Teruel	263	44263	Villastar	341	181	160	53.0791788856305	46.9208211143695
44	Teruel	264	44264	Villel	331	170	161	51.3595166163142	48.6404833836858
44	Teruel	265	44265	Vinaceite	287	149	138	51.9163763066202	48.0836236933798
44	Teruel	266	44266	Visiedo	203	93	110	45.8128078817734	54.1871921182266
44	Teruel	267	44267	Vivel del Río Martín	92	49	43	53.2608695652174	46.7391304347826
44	Teruel	268	44268	Zoma (La)	31	16	15	51.6129032258065	48.3870967741936
45	Toledo	001	45001	Ajofrín	2173	1124	1049	51.7257248044179	48.2742751955821
45	Toledo	002	45002	Alameda de la Sagra	2846	1510	1336	53.0569219957836	46.9430780042165
45	Toledo	003	45003	Albarreal de Tajo	612	304	308	49.6732026143791	50.3267973856209
45	Toledo	004	45004	Alcabón	630	319	311	50.6349206349206	49.3650793650794
45	Toledo	005	45005	Alcañizo	326	170	156	52.1472392638037	47.8527607361963
45	Toledo	006	45006	Alcaudete de la Jara	1821	873	948	47.9406919275124	52.0593080724876
45	Toledo	007	45007	Alcolea de Tajo	778	384	394	49.3573264781491	50.6426735218509
45	Toledo	008	45008	Aldea en Cabo	176	94	82	53.4090909090909	46.5909090909091
45	Toledo	009	45009	Aldeanueva de Barbarroya	819	417	402	50.9157509157509	49.0842490842491
45	Toledo	010	45010	Aldeanueva de San Bartolomé	596	294	302	49.3288590604027	50.6711409395973
45	Toledo	011	45011	Almendral de la Cañada	397	206	191	51.8891687657431	48.1108312342569
45	Toledo	012	45012	Almonacid de Toledo	797	410	387	51.4429109159348	48.5570890840653
45	Toledo	013	45013	Almorox	2196	1141	1055	51.9581056466302	48.0418943533698
45	Toledo	014	45014	Añover de Tajo	4542	2359	2183	51.9374724790841	48.0625275209159
45	Toledo	015	45015	Arcicóllar	562	276	286	49.1103202846975	50.8896797153025
45	Toledo	016	45016	Argés	2477	1225	1252	49.454985870004	50.545014129996
45	Toledo	017	45017	Azután	344	176	168	51.1627906976744	48.8372093023256
45	Toledo	018	45018	Barcience	111	58	53	52.2522522522523	47.7477477477478
45	Toledo	019	45019	Bargas	6816	3402	3414	49.9119718309859	50.0880281690141
45	Toledo	020	45020	Belvís de la Jara	1688	827	861	48.9928909952607	51.0071090047393
45	Toledo	021	45021	Borox	2221	1112	1109	50.06753714543	49.93246285457
45	Toledo	022	45022	Buenaventura	540	257	283	47.5925925925926	52.4074074074074
45	Toledo	023	45023	Burguillos de Toledo	965	492	473	50.9844559585492	49.0155440414508
45	Toledo	024	45024	Burujón	1290	660	630	51.1627906976744	48.8372093023256
45	Toledo	025	45025	Cabañas de la Sagra	1288	659	629	51.1645962732919	48.8354037267081
45	Toledo	026	45026	Cabañas de Yepes	249	129	120	51.8072289156626	48.1927710843374
45	Toledo	027	45027	Cabezamesada	482	249	233	51.6597510373444	48.3402489626556
45	Toledo	028	45028	Calera y Chozas	3734	1881	1853	50.3749330476701	49.6250669523299
45	Toledo	029	45029	Caleruela	304	152	152	50	50
45	Toledo	030	45030	Calzada de Oropesa	599	301	298	50.2504173622704	49.7495826377296
45	Toledo	031	45031	Camarena	2235	1146	1089	51.2751677852349	48.7248322147651
45	Toledo	032	45032	Camarenilla	512	256	256	50	50
45	Toledo	033	45033	Campillo de la Jara (El)	520	274	246	52.6923076923077	47.3076923076923
45	Toledo	034	45034	Camuñas	1697	862	835	50.7955215085445	49.2044784914555
45	Toledo	035	45035	Cardiel de los Montes	158	90	68	56.9620253164557	43.0379746835443
45	Toledo	036	45036	Carmena	819	412	407	50.3052503052503	49.6947496947497
45	Toledo	037	45037	Carpio de Tajo (El)	2252	1092	1160	48.4902309058615	51.5097690941385
45	Toledo	038	45038	Carranque	1746	887	859	50.8018327605956	49.1981672394044
45	Toledo	039	45039	Carriches	288	146	142	50.6944444444444	49.3055555555556
45	Toledo	040	45040	Casar de Escalona (El)	961	465	496	48.3870967741936	51.6129032258065
45	Toledo	041	45041	Casarrubios del Monte	2942	1517	1425	51.5635622025833	48.4364377974167
45	Toledo	042	45042	Casasbuenas	227	114	113	50.2202643171806	49.7797356828194
45	Toledo	043	45043	Castillo de Bayuela	1011	501	510	49.5548961424332	50.4451038575668
45	Toledo	045	45045	Cazalegas	1166	581	585	49.8284734133791	50.1715265866209
45	Toledo	046	45046	Cebolla	2809	1395	1414	49.6618013527946	50.3381986472054
45	Toledo	047	45047	Cedillo del Condado	1542	795	747	51.556420233463	48.443579766537
45	Toledo	048	45048	Cerralbos (Los)	454	225	229	49.5594713656388	50.4405286343612
45	Toledo	049	45049	Cervera de los Montes	398	210	188	52.7638190954774	47.2361809045226
45	Toledo	050	45050	Ciruelos	337	184	153	54.5994065281899	45.4005934718101
45	Toledo	051	45051	Cobeja	1804	908	896	50.3325942350333	49.6674057649667
45	Toledo	052	45052	Cobisa	1618	842	776	52.0395550061805	47.9604449938195
45	Toledo	053	45053	Consuegra	9958	4934	5024	49.5481020285198	50.4518979714802
45	Toledo	054	45054	Corral de Almaguer	5622	2813	2809	50.0355745286375	49.9644254713625
45	Toledo	055	45055	Cuerva	1311	643	668	49.0465293668955	50.9534706331045
45	Toledo	056	45056	Chozas de Canales	1002	502	500	50.0998003992016	49.9001996007984
45	Toledo	057	45057	Chueca	263	138	125	52.4714828897338	47.5285171102662
45	Toledo	058	45058	Domingo Pérez	479	238	241	49.6868475991649	50.3131524008351
45	Toledo	059	45059	Dosbarrios	2097	1060	1037	50.548402479733	49.4515975202671
45	Toledo	060	45060	Erustes	199	101	98	50.7537688442211	49.2462311557789
45	Toledo	061	45061	Escalona	2170	1108	1062	51.0599078341014	48.9400921658986
45	Toledo	062	45062	Escalonilla	1432	695	737	48.5335195530726	51.4664804469274
45	Toledo	063	45063	Espinoso del Rey	631	323	308	51.188589540412	48.811410459588
45	Toledo	064	45064	Esquivias	3806	1907	1899	50.1050972149238	49.8949027850762
45	Toledo	065	45065	Estrella (La)	411	216	195	52.5547445255475	47.4452554744526
45	Toledo	066	45066	Fuensalida	7665	3874	3791	50.5414220482714	49.4585779517286
45	Toledo	067	45067	Gálvez	3082	1546	1536	50.1622323166775	49.8377676833225
45	Toledo	068	45068	Garciotum	155	73	82	47.0967741935484	52.9032258064516
45	Toledo	069	45069	Gerindote	1839	936	903	50.8972267536705	49.1027732463295
45	Toledo	070	45070	Guadamur	1578	802	776	50.8238276299113	49.1761723700887
45	Toledo	071	45071	Guardia (La)	2418	1195	1223	49.4210090984285	50.5789909015716
45	Toledo	072	45072	Herencias (Las)	753	389	364	51.660026560425	48.339973439575
45	Toledo	073	45073	Herreruela de Oropesa	426	210	216	49.2957746478873	50.7042253521127
45	Toledo	074	45074	Hinojosa de San Vicente	480	260	220	54.1666666666667	45.8333333333333
45	Toledo	075	45075	Hontanar	126	69	57	54.7619047619048	45.2380952380952
45	Toledo	076	45076	Hormigos	416	211	205	50.7211538461539	49.2788461538462
45	Toledo	077	45077	Huecas	474	247	227	52.1097046413502	47.8902953586498
45	Toledo	078	45078	Huerta de Valdecarábanos	1661	817	844	49.1872366044552	50.8127633955449
45	Toledo	079	45079	Iglesuela (La)	435	213	222	48.9655172413793	51.0344827586207
45	Toledo	080	45080	Illán de Vacas	4	3	1	75	25
45	Toledo	081	45081	Illescas	10347	5198	5149	50.2367836087755	49.7632163912245
45	Toledo	082	45082	Lagartera	1839	906	933	49.2659053833605	50.7340946166395
45	Toledo	083	45083	Layos	268	138	130	51.4925373134328	48.5074626865672
45	Toledo	084	45084	Lillo	2905	1459	1446	50.223752151463	49.776247848537
45	Toledo	085	45085	Lominchar	1198	621	577	51.8363939899833	48.1636060100167
45	Toledo	086	45086	Lucillos	499	244	255	48.8977955911824	51.1022044088176
45	Toledo	087	45087	Madridejos	10500	5189	5311	49.4190476190476	50.5809523809524
45	Toledo	088	45088	Magán	1137	570	567	50.131926121372	49.868073878628
45	Toledo	089	45089	Malpica de Tajo	1888	957	931	50.6885593220339	49.3114406779661
45	Toledo	090	45090	Manzaneque	492	245	247	49.7967479674797	50.2032520325203
45	Toledo	091	45091	Maqueda	455	232	223	50.989010989011	49.010989010989
45	Toledo	092	45092	Marjaliza	325	158	167	48.6153846153846	51.3846153846154
45	Toledo	093	45093	Marrupe	141	72	69	51.063829787234	48.936170212766
45	Toledo	094	45094	Mascaraque	479	231	248	48.2254697286013	51.7745302713987
45	Toledo	095	45095	Mata (La)	991	491	500	49.5459132189707	50.4540867810293
45	Toledo	096	45096	Mazarambroz	1221	611	610	50.04095004095	49.95904995905
45	Toledo	097	45097	Mejorada	1124	561	563	49.9110320284697	50.0889679715303
45	Toledo	098	45098	Menasalbas	2971	1556	1415	52.3729384045776	47.6270615954224
45	Toledo	099	45099	Méntrida	2105	1081	1024	51.353919239905	48.646080760095
45	Toledo	100	45100	Mesegar de Tajo	230	113	117	49.1304347826087	50.8695652173913
45	Toledo	101	45101	Miguel Esteban	4719	2356	2363	49.9258317440136	50.0741682559864
45	Toledo	102	45102	Mocejón	4157	2137	2020	51.4072648544624	48.5927351455377
45	Toledo	103	45103	Mohedas de la Jara	616	314	302	50.974025974026	49.025974025974
45	Toledo	104	45104	Montearagón	441	232	209	52.6077097505669	47.3922902494331
45	Toledo	105	45105	Montesclaros	463	236	227	50.9719222462203	49.0280777537797
45	Toledo	106	45106	Mora	9371	4625	4746	49.354391206915	50.6456087930851
45	Toledo	107	45107	Nambroca	2603	1321	1282	50.7491356127545	49.2508643872455
45	Toledo	108	45108	Nava de Ricomalillo (La)	718	361	357	50.2785515320334	49.7214484679666
45	Toledo	109	45109	Navahermosa	3886	1971	1915	50.7205352547607	49.2794647452393
45	Toledo	110	45110	Navalcán	2288	1201	1087	52.4912587412587	47.5087412587413
45	Toledo	111	45111	Navalmoralejo	72	34	38	47.2222222222222	52.7777777777778
45	Toledo	112	45112	Navalmorales (Los)	2618	1316	1302	50.2673796791444	49.7326203208556
45	Toledo	113	45113	Navalucillos (Los)	2732	1361	1371	49.8169838945827	50.1830161054173
45	Toledo	114	45114	Navamorcuende	741	391	350	52.7665317139001	47.2334682860999
45	Toledo	115	45115	Noblejas	3060	1558	1502	50.9150326797386	49.0849673202614
45	Toledo	116	45116	Noez	817	412	405	50.4283965728274	49.5716034271726
45	Toledo	117	45117	Nombela	938	485	453	51.7057569296375	48.2942430703625
45	Toledo	118	45118	Novés	1545	784	761	50.7443365695793	49.2556634304207
45	Toledo	119	45119	Numancia de la Sagra	2555	1345	1210	52.6418786692759	47.3581213307241
45	Toledo	120	45120	Nuño Gómez	202	101	101	50	50
45	Toledo	121	45121	Ocaña	6190	3076	3114	49.6930533117932	50.3069466882068
45	Toledo	122	45122	Olías del Rey	4287	2163	2124	50.4548635409377	49.5451364590623
45	Toledo	123	45123	Ontígola	1250	676	574	54.08	45.92
45	Toledo	124	45124	Orgaz	2672	1327	1345	49.6631736526946	50.3368263473054
45	Toledo	125	45125	Oropesa	2717	1342	1375	49.3927125506073	50.6072874493927
45	Toledo	126	45126	Otero	203	95	108	46.7980295566502	53.2019704433498
45	Toledo	127	45127	Palomeque	483	252	231	52.1739130434783	47.8260869565217
45	Toledo	128	45128	Pantoja	2469	1264	1205	51.1948157148643	48.8051842851357
45	Toledo	129	45129	Paredes de Escalona	116	56	60	48.2758620689655	51.7241379310345
45	Toledo	130	45130	Parrillas	423	209	214	49.4089834515366	50.5910165484634
45	Toledo	131	45131	Pelahustán	342	179	163	52.3391812865497	47.6608187134503
45	Toledo	132	45132	Pepino	948	475	473	50.1054852320675	49.8945147679325
45	Toledo	133	45133	Polán	3306	1675	1631	50.6654567453116	49.3345432546885
45	Toledo	134	45134	Portillo de Toledo	1971	1014	957	51.4459665144597	48.5540334855403
45	Toledo	135	45135	Puebla de Almoradiel (La)	5380	2697	2683	50.1301115241636	49.8698884758364
45	Toledo	136	45136	Puebla de Montalbán (La)	7111	3574	3537	50.2601603150049	49.7398396849951
45	Toledo	137	45137	Pueblanueva (La)	2018	1031	987	51.0901883052527	48.9098116947473
45	Toledo	138	45138	Puente del Arzobispo (El)	1566	756	810	48.2758620689655	51.7241379310345
45	Toledo	139	45139	Puerto de San Vicente	277	136	141	49.0974729241877	50.9025270758123
45	Toledo	140	45140	Pulgar	1268	644	624	50.788643533123	49.211356466877
45	Toledo	141	45141	Quero	1273	634	639	49.8036135113904	50.1963864886096
45	Toledo	142	45142	Quintanar de la Orden	9503	4707	4796	49.5317268231085	50.4682731768915
45	Toledo	143	45143	Quismondo	1298	652	646	50.231124807396	49.768875192604
45	Toledo	144	45144	Real de San Vicente (El)	996	497	499	49.8995983935743	50.1004016064257
45	Toledo	145	45145	Recas	2614	1378	1236	52.7161438408569	47.2838561591431
45	Toledo	146	45146	Retamoso	160	84	76	52.5	47.5
45	Toledo	147	45147	Rielves	516	257	259	49.8062015503876	50.1937984496124
45	Toledo	148	45148	Robledo del Mazo	518	267	251	51.5444015444015	48.4555984555985
45	Toledo	149	45149	Romeral (El)	895	438	457	48.9385474860335	51.0614525139665
45	Toledo	150	45150	San Bartolomé de las Abiertas	473	251	222	53.0655391120507	46.9344608879493
45	Toledo	151	45151	San Martín de Montalbán	751	365	386	48.6018641810919	51.3981358189081
45	Toledo	152	45152	San Martín de Pusa	790	399	391	50.5063291139241	49.4936708860759
45	Toledo	153	45153	San Pablo de los Montes	2128	1079	1049	50.7048872180451	49.2951127819549
45	Toledo	154	45154	San Román de los Montes	726	377	349	51.9283746556474	48.0716253443526
45	Toledo	155	45155	Santa Ana de Pusa	406	209	197	51.4778325123153	48.5221674876847
45	Toledo	156	45156	Santa Cruz de la Zarza	4392	2209	2183	50.2959927140255	49.7040072859745
45	Toledo	157	45157	Santa Cruz del Retamar	1681	849	832	50.5056513979774	49.4943486020226
45	Toledo	158	45158	Santa Olalla	2567	1312	1255	51.1102454226724	48.8897545773276
45	Toledo	159	45159	Sartajada	116	69	47	59.4827586206897	40.5172413793103
45	Toledo	160	45160	Segurilla	981	488	493	49.7451580020387	50.2548419979613
45	Toledo	161	45161	Seseña	4244	2212	2032	52.1206409048068	47.8793590951932
45	Toledo	162	45162	Sevilleja de la Jara	1056	555	501	52.5568181818182	47.4431818181818
45	Toledo	163	45163	Sonseca	9467	4806	4661	50.7658181049963	49.2341818950037
45	Toledo	164	45164	Sotillo de las Palomas	223	111	112	49.7757847533632	50.2242152466368
45	Toledo	165	45165	Talavera de la Reina	74241	36167	38074	48.7156692393691	51.2843307606309
45	Toledo	166	45166	Tembleque	2099	1063	1036	50.6431634111482	49.3568365888518
45	Toledo	167	45167	Toboso (El)	2077	1021	1056	49.1574386133847	50.8425613866153
45	Toledo	168	45168	Toledo	68537	32870	35667	47.9594963304493	52.0405036695508
45	Toledo	169	45169	Torralba de Oropesa	280	132	148	47.1428571428571	52.8571428571429
45	Toledo	170	45170	Torrecilla de la Jara	292	146	146	50	50
45	Toledo	171	45171	Torre de Esteban Hambrán (La)	1489	772	717	51.846877098724	48.153122901276
45	Toledo	172	45172	Torrico	894	464	430	51.9015659955257	48.0984340044743
45	Toledo	173	45173	Torrijos	10041	4926	5115	49.0588586794144	50.9411413205856
45	Toledo	174	45174	Totanés	363	185	178	50.9641873278237	49.0358126721763
45	Toledo	175	45175	Turleque	971	480	491	49.4335736354274	50.5664263645726
45	Toledo	176	45176	Ugena	1585	835	750	52.6813880126183	47.3186119873817
45	Toledo	177	45177	Urda	2965	1488	1477	50.185497470489	49.814502529511
45	Toledo	179	45179	Valdeverdeja	786	358	428	45.5470737913486	54.4529262086514
45	Toledo	180	45180	Valmojado	2406	1232	1174	51.2053200332502	48.7946799667498
45	Toledo	181	45181	Velada	2386	1244	1142	52.1374685666387	47.8625314333613
45	Toledo	182	45182	Ventas con Peña Aguilera (Las)	1367	695	672	50.8412582297001	49.1587417702999
45	Toledo	183	45183	Ventas de Retamosa (Las)	804	416	388	51.7412935323383	48.2587064676617
45	Toledo	184	45184	Ventas de San Julián (Las)	236	106	130	44.9152542372881	55.0847457627119
45	Toledo	185	45185	Villacañas	9347	4628	4719	49.5132127955494	50.4867872044506
45	Toledo	186	45186	Villa de Don Fadrique (La)	4101	2036	2065	49.6464277005608	50.3535722994392
45	Toledo	187	45187	Villafranca de los Caballeros	5335	2636	2699	49.4095595126523	50.5904404873477
45	Toledo	188	45188	Villaluenga de la Sagra	2642	1307	1335	49.4700984102952	50.5299015897048
45	Toledo	189	45189	Villamiel de Toledo	477	242	235	50.7337526205451	49.2662473794549
45	Toledo	190	45190	Villaminaya	644	325	319	50.4658385093168	49.5341614906832
45	Toledo	191	45191	Villamuelas	743	368	375	49.528936742934	50.471063257066
45	Toledo	192	45192	Villanueva de Alcardete	3293	1665	1628	50.561797752809	49.438202247191
45	Toledo	193	45193	Villanueva de Bogas	819	407	412	49.6947496947497	50.3052503052503
45	Toledo	194	45194	Villarejo de Montalbán	100	53	47	53	47
45	Toledo	195	45195	Villarrubia de Santiago	2869	1434	1435	49.9825723248519	50.0174276751481
45	Toledo	196	45196	Villaseca de la Sagra	1563	773	790	49.4561740243122	50.5438259756878
45	Toledo	197	45197	Villasequilla	2319	1196	1123	51.5739542906425	48.4260457093575
45	Toledo	198	45198	Villatobas	2220	1128	1092	50.8108108108108	49.1891891891892
45	Toledo	199	45199	Viso de San Juan (El)	1170	635	535	54.2735042735043	45.7264957264957
45	Toledo	200	45200	Yébenes (Los)	6199	3095	3104	49.9274076463946	50.0725923536054
45	Toledo	201	45201	Yeles	1731	912	819	52.686308492201	47.313691507799
45	Toledo	202	45202	Yepes	4358	2225	2133	51.0555300596604	48.9444699403396
45	Toledo	203	45203	Yuncler	1855	932	923	50.2425876010782	49.7574123989218
45	Toledo	204	45204	Yunclillos	615	318	297	51.7073170731707	48.2926829268293
45	Toledo	205	45205	Yuncos	3760	1979	1781	52.6329787234043	47.3670212765957
45	Toledo	901	45901	Santo Domingo-Caudilla	790	394	396	49.873417721519	50.126582278481
46	Valencia/València	001	46001	Ademuz	1195	608	587	50.8786610878661	49.1213389121339
46	Valencia/València	002	46002	Ador	1178	595	583	50.509337860781	49.490662139219
46	Valencia/València	003	46003	Atzeneta d'Albaida	1238	632	606	51.0500807754443	48.9499192245557
46	Valencia/València	004	46004	Agullent	2223	1075	1148	48.3580746738642	51.6419253261359
46	Valencia/València	005	46005	Alaquàs	26939	13331	13608	49.4858754964921	50.5141245035079
46	Valencia/València	006	46006	Albaida	5828	2874	2954	49.3136582017845	50.6863417982155
46	Valencia/València	007	46007	Albal	11973	5964	6009	49.8120771736407	50.1879228263593
46	Valencia/València	008	46008	Albalat de la Ribera	3474	1689	1785	48.6183074265976	51.3816925734024
46	Valencia/València	009	46009	Albalat dels Sorells	3479	1696	1783	48.749640701351	51.250359298649
46	Valencia/València	010	46010	Albalat dels Tarongers	709	367	342	51.7630465444288	48.2369534555712
46	Valencia/València	011	46011	Alberic	9227	4508	4719	48.8566164517178	51.1433835482822
46	Valencia/València	012	46012	Alborache	905	463	442	51.1602209944751	48.8397790055249
46	Valencia/València	013	46013	Alboraya	16943	8411	8532	49.642920380098	50.357079619902
46	Valencia/València	014	46014	Albuixech	3032	1465	1567	48.3179419525066	51.6820580474934
46	Valencia/València	015	46015	Alcácer	7229	3634	3595	50.2697468529534	49.7302531470466
46	Valencia/València	016	46016	Alcàntera de Xúquer	1405	701	704	49.8932384341637	50.1067615658363
46	Valencia/València	017	46017	Alzira	40658	19825	20833	48.7603915588568	51.2396084411432
46	Valencia/València	018	46018	Alcublas	854	449	405	52.576112412178	47.423887587822
46	Valencia/València	019	46019	Alcúdia (l')	10584	5230	5354	49.4142101284958	50.5857898715042
46	Valencia/València	020	46020	Alcúdia de Crespins (l')	4223	2075	2148	49.1356855316126	50.8643144683874
46	Valencia/València	021	46021	Aldaia	24485	12197	12288	49.8141719420053	50.1858280579947
46	Valencia/València	022	46022	Alfafar	18878	9332	9546	49.4332026697743	50.5667973302257
46	Valencia/València	023	46023	Alfauir	357	186	171	52.1008403361345	47.8991596638655
46	Valencia/València	024	46024	Alfara de Algimia	502	247	255	49.203187250996	50.796812749004
46	Valencia/València	025	46025	Alfara del Patriarca	2683	1314	1369	48.9750279537831	51.0249720462169
46	Valencia/València	026	46026	Alfarp	1334	648	686	48.575712143928	51.424287856072
46	Valencia/València	027	46027	Alfarrasí	1192	573	619	48.0704697986577	51.9295302013423
46	Valencia/València	028	46028	Algar de Palancia	428	215	213	50.2336448598131	49.7663551401869
46	Valencia/València	029	46029	Algemesí	25028	12332	12696	49.2728144478184	50.7271855521816
46	Valencia/València	030	46030	Algimia de Alfara	856	425	431	49.6495327102804	50.3504672897196
46	Valencia/València	031	46031	Alginet	12069	6015	6054	49.8384290330599	50.1615709669401
46	Valencia/València	032	46032	Almàssera	5759	2763	2996	47.9770793540545	52.0229206459455
46	Valencia/València	033	46033	Almiserà	270	129	141	47.7777777777778	52.2222222222222
46	Valencia/València	034	46034	Almoines	1675	823	852	49.134328358209	50.865671641791
46	Valencia/València	035	46035	Almussafes	7256	3620	3636	49.8897464167585	50.1102535832415
46	Valencia/València	036	46036	Alpuente	941	490	451	52.0722635494155	47.9277364505845
46	Valencia/València	037	46037	Alquería de la Condesa/Alqueria de la Comtessa (l')	1382	652	730	47.178002894356	52.821997105644
46	Valencia/València	038	46038	Andilla	460	265	195	57.6086956521739	42.3913043478261
46	Valencia/València	039	46039	Anna	2572	1292	1280	50.2332814930016	49.7667185069984
46	Valencia/València	040	46040	Antella	1488	737	751	49.5295698924731	50.4704301075269
46	Valencia/València	041	46041	Aras de Alpuente	398	222	176	55.7788944723618	44.2211055276382
46	Valencia/València	042	46042	Aielo de Malferit	3984	1956	2028	49.0963855421687	50.9036144578313
46	Valencia/València	043	46043	Ayelo de Rugat	208	110	98	52.8846153846154	47.1153846153846
46	Valencia/València	044	46044	Ayora	5513	2815	2698	51.0611282423363	48.9388717576637
46	Valencia/València	045	46045	Barxeta	1612	826	786	51.2406947890819	48.7593052109181
46	Valencia/València	046	46046	Barx	1251	609	642	48.6810551558753	51.3189448441247
46	Valencia/València	047	46047	Bèlgida	689	335	354	48.6211901306241	51.3788098693759
46	Valencia/València	048	46048	Bellreguard	3734	1856	1878	49.7054097482592	50.2945902517408
46	Valencia/València	049	46049	Bellús	399	196	203	49.1228070175439	50.8771929824562
46	Valencia/València	050	46050	Benagéber	189	103	86	54.4973544973545	45.5026455026455
46	Valencia/València	051	46051	Benaguasil	9206	4626	4580	50.2498370627851	49.7501629372149
46	Valencia/València	052	46052	Benavites	634	308	326	48.5804416403786	51.4195583596215
46	Valencia/València	053	46053	Beneixida	625	301	324	48.16	51.84
46	Valencia/València	054	46054	Benetússer	13636	6746	6890	49.4719859196245	50.5280140803755
46	Valencia/València	055	46055	Beniarjó	1242	617	625	49.6779388083736	50.3220611916264
46	Valencia/València	056	46056	Beniatjar	231	115	116	49.7835497835498	50.2164502164502
46	Valencia/València	057	46057	Benicolet	496	257	239	51.8145161290323	48.1854838709677
46	Valencia/València	058	46058	Benifairó de les Valls	1954	963	991	49.2835209825998	50.7164790174002
46	Valencia/València	059	46059	Benifairó de la Valldigna	1635	816	819	49.908256880734	50.0917431192661
46	Valencia/València	060	46060	Benifaió	12059	5930	6129	49.1748901235592	50.8251098764408
46	Valencia/València	061	46061	Beniflá	164	74	90	45.1219512195122	54.8780487804878
46	Valencia/València	062	46062	Benigánim	5474	2763	2711	50.4749725977347	49.5250274022653
46	Valencia/València	063	46063	Benimodo	1807	924	883	51.1344770337576	48.8655229662424
46	Valencia/València	064	46064	Benimuslem	547	277	270	50.6398537477148	49.3601462522852
46	Valencia/València	065	46065	Beniparrell	1611	832	779	51.6449410304159	48.3550589695841
46	Valencia/València	066	46066	Benirredrà	1177	557	620	47.3237043330501	52.6762956669499
46	Valencia/València	067	46067	Benisanó	1784	904	880	50.6726457399103	49.3273542600897
46	Valencia/València	068	46068	Benisoda	300	167	133	55.6666666666667	44.3333333333333
46	Valencia/València	069	46069	Benisuera	188	92	96	48.936170212766	51.063829787234
46	Valencia/València	070	46070	Bétera	13885	6917	6968	49.8163485776017	50.1836514223983
46	Valencia/València	071	46071	Bicorp	676	334	342	49.4082840236686	50.5917159763314
46	Valencia/València	072	46072	Bocairent	4508	2227	2281	49.4010647737356	50.5989352262644
46	Valencia/València	073	46073	Bolbaite	1411	717	694	50.8150248051028	49.1849751948972
46	Valencia/València	074	46074	Bonrepòs i Mirambell	2283	1124	1159	49.233464739378	50.766535260622
46	Valencia/València	075	46075	Bufali	206	101	105	49.0291262135922	50.9708737864078
46	Valencia/València	076	46076	Bugarra	828	409	419	49.3961352657005	50.6038647342995
46	Valencia/València	077	46077	Buñol	9301	4628	4673	49.7580905279002	50.2419094720998
46	Valencia/València	078	46078	Burjassot	35171	17073	18098	48.5428335844872	51.4571664155128
46	Valencia/València	079	46079	Calles	434	235	199	54.147465437788	45.852534562212
46	Valencia/València	080	46080	Camporrobles	1362	681	681	50	50
46	Valencia/València	081	46081	Canals	13080	6484	6596	49.5718654434251	50.4281345565749
46	Valencia/València	082	46082	Canet d'En Berenguer	2562	1253	1309	48.9071038251366	51.0928961748634
46	Valencia/València	083	46083	Carcaixent	20609	10036	10573	48.6971711388228	51.3028288611772
46	Valencia/València	084	46084	Cárcer	2070	992	1078	47.9227053140097	52.0772946859903
46	Valencia/València	085	46085	Carlet	13975	6861	7114	49.0948121645796	50.9051878354204
46	Valencia/València	086	46086	Carrícola	73	34	39	46.5753424657534	53.4246575342466
46	Valencia/València	087	46087	Casas Altas	157	83	74	52.8662420382166	47.1337579617834
46	Valencia/València	088	46088	Casas Bajas	286	153	133	53.4965034965035	46.5034965034965
46	Valencia/València	089	46089	Casinos	2395	1235	1160	51.5657620041754	48.4342379958246
46	Valencia/València	090	46090	Castelló de Rugat	2057	1063	994	51.6771998055421	48.322800194458
46	Valencia/València	091	46091	Castellonet de la Conquesta	154	86	68	55.8441558441558	44.1558441558442
46	Valencia/València	092	46092	Castielfabib	519	279	240	53.757225433526	46.242774566474
46	Valencia/València	093	46093	Catadau	2345	1173	1172	50.0213219616205	49.9786780383795
46	Valencia/València	094	46094	Catarroja	20616	10131	10485	49.1414435389988	50.8585564610012
46	Valencia/València	095	46095	Caudete de las Fuentes	805	407	398	50.5590062111801	49.4409937888199
46	Valencia/València	096	46096	Cerdà	287	142	145	49.4773519163763	50.5226480836237
46	Valencia/València	097	46097	Cofrentes	1056	528	528	50	50
46	Valencia/València	098	46098	Corbera	3068	1488	1580	48.5006518904824	51.4993481095176
46	Valencia/València	099	46099	Cortes de Pallás	792	419	373	52.9040404040404	47.0959595959596
46	Valencia/València	100	46100	Cotes	369	168	201	45.5284552845528	54.4715447154472
46	Valencia/València	101	46101	Quart de les Valls	1048	493	555	47.0419847328244	52.9580152671756
46	Valencia/València	102	46102	Quart de Poblet	26131	12891	13240	49.3322107841261	50.6677892158739
46	Valencia/València	103	46103	Quartell	1369	663	706	48.4295105916728	51.5704894083273
46	Valencia/València	104	46104	Quatretonda	2549	1313	1236	51.5103962338172	48.4896037661828
46	Valencia/València	105	46105	Cullera	20663	10223	10440	49.47490683831	50.52509316169
46	Valencia/València	106	46106	Chelva	2105	1080	1025	51.3064133016627	48.6935866983373
46	Valencia/València	107	46107	Chella	2527	1254	1273	49.6240601503759	50.3759398496241
46	Valencia/València	108	46108	Chera	567	299	268	52.7336860670194	47.2663139329806
46	Valencia/València	109	46109	Cheste	6915	3516	3399	50.8459869848156	49.1540130151844
46	Valencia/València	110	46110	Xirivella	26053	12893	13160	49.4875830038767	50.5124169961233
46	Valencia/València	111	46111	Chiva	9721	4875	4846	50.149161608888	49.850838391112
46	Valencia/València	112	46112	Chulilla	778	385	393	49.4858611825193	50.5141388174807
46	Valencia/València	113	46113	Daimús	1674	840	834	50.179211469534	49.820788530466
46	Valencia/València	114	46114	Domeño	516	264	252	51.1627906976744	48.8372093023256
46	Valencia/València	115	46115	Dos Aguas	406	231	175	56.8965517241379	43.1034482758621
46	Valencia/València	116	46116	Eliana (l')	13087	6534	6553	49.9274088790403	50.0725911209597
46	Valencia/València	117	46117	Emperador	210	106	104	50.4761904761905	49.5238095238095
46	Valencia/València	118	46118	Enguera	4703	2324	2379	49.4152668509462	50.5847331490538
46	Valencia/València	119	46119	Ènova (l')	1049	528	521	50.3336510962822	49.6663489037178
46	Valencia/València	120	46120	Estivella	1114	522	592	46.8581687612208	53.1418312387792
46	Valencia/València	121	46121	Estubeny	151	70	81	46.3576158940397	53.6423841059603
46	Valencia/València	122	46122	Faura	2830	1418	1412	50.1060070671378	49.8939929328622
46	Valencia/València	123	46123	Favara	1755	854	901	48.6609686609687	51.3390313390313
46	Valencia/València	124	46124	Fontanars dels Alforins	970	499	471	51.4432989690722	48.5567010309278
46	Valencia/València	125	46125	Fortaleny	981	493	488	50.2548419979613	49.7451580020387
46	Valencia/València	126	46126	Foios	5372	2600	2772	48.3991064780343	51.6008935219658
46	Valencia/València	127	46127	Font d'En Carròs (la)	3236	1608	1628	49.6909765142151	50.3090234857849
46	Valencia/València	128	46128	Font de la Figuera (la)	2094	1063	1031	50.7640878701051	49.2359121298949
46	Valencia/València	129	46129	Fuenterrobles	728	380	348	52.1978021978022	47.8021978021978
46	Valencia/València	130	46130	Gavarda	1237	600	637	48.5044462409054	51.4955537590946
46	Valencia/València	131	46131	Gandia	59123	28966	30157	48.9927777683812	51.0072222316188
46	Valencia/València	132	46132	Genovés	2383	1183	1200	49.6433067561897	50.3566932438103
46	Valencia/València	133	46133	Gestalgar	738	365	373	49.4579945799458	50.5420054200542
46	Valencia/València	134	46134	Gilet	1477	737	740	49.898442789438	50.101557210562
46	Valencia/València	135	46135	Godella	11222	5500	5722	49.010871502406	50.989128497594
46	Valencia/València	136	46136	Godelleta	2242	1101	1141	49.1079393398751	50.8920606601249
46	Valencia/València	137	46137	Granja de la Costera (la)	360	171	189	47.5	52.5
46	Valencia/València	138	46138	Guadasequies	385	196	189	50.9090909090909	49.0909090909091
46	Valencia/València	139	46139	Guadassuar	5331	2651	2680	49.7280060026262	50.2719939973739
46	Valencia/València	140	46140	Guardamar	68	36	32	52.9411764705882	47.0588235294118
46	Valencia/València	141	46141	Higueruelas	560	289	271	51.6071428571429	48.3928571428571
46	Valencia/València	142	46142	Jalance	1073	542	531	50.5125815470643	49.4874184529357
46	Valencia/València	143	46143	Xeraco	4982	2503	2479	50.2408671216379	49.7591328783621
46	Valencia/València	144	46144	Jarafuel	917	474	443	51.690294438386	48.309705561614
46	Valencia/València	145	46145	Xàtiva	25478	12387	13091	48.6184158882173	51.3815841117827
46	Valencia/València	146	46146	Xeresa	1879	946	933	50.345928685471	49.654071314529
46	Valencia/València	147	46147	Llíria	16856	8415	8441	49.9228761271951	50.0771238728049
46	Valencia/València	148	46148	Loriguilla	1005	511	494	50.8457711442786	49.1542288557214
46	Valencia/València	149	46149	Losa del Obispo	450	217	233	48.2222222222222	51.7777777777778
46	Valencia/València	150	46150	Llutxent	2412	1221	1191	50.6218905472637	49.3781094527363
46	Valencia/València	151	46151	Lugar Nuevo de Fenollet	783	384	399	49.0421455938697	50.9578544061303
46	Valencia/València	152	46152	Lugar Nuevo de la Corona	93	45	48	48.3870967741936	51.6129032258065
46	Valencia/València	153	46153	Llocnou de Sant Jeroni	568	285	283	50.1760563380282	49.8239436619718
46	Valencia/València	154	46154	Llanera de Ranes	992	510	482	51.4112903225807	48.5887096774194
46	Valencia/València	155	46155	Llaurí	118	59	59	50	50
46	Valencia/València	156	46156	Llombai	2271	1144	1127	50.3742844561867	49.6257155438133
46	Valencia/València	157	46157	Llosa de Ranes	3622	1863	1759	51.4356709000552	48.5643290999448
46	Valencia/València	158	46158	Macastre	1050	516	534	49.1428571428571	50.8571428571429
46	Valencia/València	159	46159	Manises	25939	12774	13165	49.2463086472108	50.7536913527892
46	Valencia/València	160	46160	Manuel	2426	1173	1253	48.3511953833471	51.6488046166529
46	Valencia/València	161	46161	Marines	1406	738	668	52.4893314366999	47.5106685633002
46	Valencia/València	162	46162	Masalavés	1464	751	713	51.2978142076503	48.7021857923497
46	Valencia/València	163	46163	Massalfassar	1345	665	680	49.4423791821561	50.5576208178439
46	Valencia/València	164	46164	Massamagrell	12766	6261	6505	49.0443365188783	50.9556634811217
46	Valencia/València	165	46165	Massanassa	7521	3656	3865	48.6105571067677	51.3894428932323
46	Valencia/València	166	46166	Meliana	9051	4416	4635	48.7901889294001	51.2098110705999
46	Valencia/València	167	46167	Millares	628	306	322	48.7261146496815	51.2738853503185
46	Valencia/València	168	46168	Miramar	1232	611	621	49.5941558441558	50.4058441558442
46	Valencia/València	169	46169	Mislata	40616	19876	20740	48.9363797518219	51.0636202481781
46	Valencia/València	170	46170	Mogente/Moixent	4269	2163	2106	50.6676036542516	49.3323963457484
46	Valencia/València	171	46171	Moncada	18602	9209	9393	49.5054295237071	50.4945704762929
46	Valencia/València	172	46172	Monserrat	3157	1624	1533	51.4412416851441	48.5587583148559
46	Valencia/València	173	46173	Montaverner	1702	862	840	50.6462984723854	49.3537015276146
46	Valencia/València	174	46174	Montesa	1256	629	627	50.0796178343949	49.9203821656051
46	Valencia/València	175	46175	Montichelvo	597	301	296	50.4187604690117	49.5812395309883
46	Valencia/València	176	46176	Montroy	1538	791	747	51.4304291287386	48.5695708712614
46	Valencia/València	177	46177	Museros	4158	2074	2084	49.8797498797499	50.1202501202501
46	Valencia/València	178	46178	Náquera	2783	1422	1361	51.095939633489	48.904060366511
46	Valencia/València	179	46179	Navarrés	2744	1392	1352	50.7288629737609	49.2711370262391
46	Valencia/València	180	46180	Novelé/Novetlè	670	326	344	48.6567164179104	51.3432835820896
46	Valencia/València	181	46181	Oliva	21001	10342	10659	49.2452740345698	50.7547259654302
46	Valencia/València	182	46182	Olocau	884	458	426	51.8099547511312	48.1900452488688
46	Valencia/València	183	46183	Olleria (l')	7058	3613	3445	51.1901388495324	48.8098611504676
46	Valencia/València	184	46184	Ontinyent	31926	15801	16125	49.492576583349	50.507423416651
46	Valencia/València	185	46185	Otos	526	266	260	50.5703422053232	49.4296577946768
46	Valencia/València	186	46186	Paiporta	18194	9092	9102	49.9725184126635	50.0274815873365
46	Valencia/València	187	46187	Palma de Gandía	1575	787	788	49.968253968254	50.031746031746
46	Valencia/València	188	46188	Palmera	532	269	263	50.5639097744361	49.4360902255639
46	Valencia/València	189	46189	Palomar	503	248	255	49.3041749502982	50.6958250497018
46	Valencia/València	190	46190	Paterna	47498	23480	24018	49.4336603646469	50.5663396353531
46	Valencia/València	191	46191	Pedralba	2109	1085	1024	51.4461830251304	48.5538169748696
46	Valencia/València	192	46192	Petrés	810	401	409	49.5061728395062	50.4938271604938
46	Valencia/València	193	46193	Picanya	8932	4452	4480	49.8432601880878	50.1567398119122
46	Valencia/València	194	46194	Picassent	16005	8104	7901	50.6341768197438	49.3658231802562
46	Valencia/València	195	46195	Piles	1981	968	1013	48.8642099949521	51.135790005048
46	Valencia/València	196	46196	Pinet	212	110	102	51.8867924528302	48.1132075471698
46	Valencia/València	197	46197	Polinyà de Xúquer	3031	1492	1539	49.2246783239855	50.7753216760145
46	Valencia/València	198	46198	Potríes	937	460	477	49.0928495197439	50.9071504802561
46	Valencia/València	199	46199	Pobla de Farnals (la)	5473	2756	2717	50.3562945368171	49.6437054631829
46	Valencia/València	200	46200	Pobla del Duc (la)	2427	1185	1242	48.8257107540173	51.1742892459827
46	Valencia/València	201	46201	Puebla de San Miguel	81	44	37	54.320987654321	45.679012345679
46	Valencia/València	202	46202	Pobla de Vallbona (la)	11757	6019	5738	51.1950327464489	48.8049672535511
46	Valencia/València	203	46203	Pobla Llarga (la)	4373	2151	2222	49.1882003201464	50.8117996798536
46	Valencia/València	204	46204	Puig	7195	3534	3661	49.1174426685198	50.8825573314802
46	Valencia/València	205	46205	Puçol	14529	7138	7391	49.129327551793	50.870672448207
46	Valencia/València	206	46206	Quesa	797	403	394	50.564617314931	49.435382685069
46	Valencia/València	207	46207	Rafelbuñol/Rafelbunyol	5553	2708	2845	48.7664325589771	51.2335674410229
46	Valencia/València	208	46208	Rafelcofer	1406	665	741	47.2972972972973	52.7027027027027
46	Valencia/València	209	46209	Rafelguaraf	2406	1168	1238	48.5453034081463	51.4546965918537
46	Valencia/València	210	46210	Ráfol de Salem	369	173	196	46.8834688346883	53.1165311653117
46	Valencia/València	211	46211	Real de Gandía	1789	862	927	48.1833426495249	51.8166573504751
46	Valencia/València	212	46212	Real de Montroi	1798	925	873	51.4460511679644	48.5539488320356
46	Valencia/València	213	46213	Requena	19092	9571	9521	50.1309448983868	49.8690551016132
46	Valencia/València	214	46214	Riba-roja de Túria	12908	6453	6455	49.9922528664394	50.0077471335606
46	Valencia/València	215	46215	Riola	1609	804	805	49.9689247980112	50.0310752019888
46	Valencia/València	216	46216	Rocafort	5117	2498	2619	48.8176666015243	51.1823333984757
46	Valencia/València	217	46217	Rotglá y Corberá	1035	512	523	49.4685990338164	50.5314009661836
46	Valencia/València	218	46218	Rótova	1295	658	637	50.8108108108108	49.1891891891892
46	Valencia/València	219	46219	Rugat	207	103	104	49.7584541062802	50.2415458937198
46	Valencia/València	220	46220	Sagunto/Sagunt	56756	27650	29106	48.7173162308831	51.2826837691169
46	Valencia/València	221	46221	Salem	468	236	232	50.4273504273504	49.5726495726496
46	Valencia/València	222	46222	San Juan de Énova	349	161	188	46.1318051575931	53.8681948424069
46	Valencia/València	223	46223	Sedaví	8353	4081	4272	48.8566981922663	51.1433018077337
46	Valencia/València	224	46224	Segart	212	101	111	47.6415094339623	52.3584905660377
46	Valencia/València	225	46225	Sellent	471	252	219	53.5031847133758	46.4968152866242
46	Valencia/València	226	46226	Sempere	39	20	19	51.2820512820513	48.7179487179487
46	Valencia/València	227	46227	Senyera	937	449	488	47.9188900747065	52.0811099252935
46	Valencia/València	228	46228	Serra	1915	974	941	50.8616187989556	49.1383812010444
46	Valencia/València	229	46229	Siete Aguas	1282	661	621	51.5600624024961	48.4399375975039
46	Valencia/València	230	46230	Silla	15614	7875	7739	50.435506596644	49.564493403356
46	Valencia/València	231	46231	Simat de la Valldigna	3112	1582	1530	50.8354755784062	49.1645244215938
46	Valencia/València	232	46232	Sinarcas	1245	643	602	51.6465863453815	48.3534136546185
46	Valencia/València	233	46233	Sollana	4463	2174	2289	48.7116289491374	51.2883710508626
46	Valencia/València	234	46234	Sot de Chera	340	171	169	50.2941176470588	49.7058823529412
46	Valencia/València	235	46235	Sueca	25406	12463	12943	49.0553412579706	50.9446587420294
46	Valencia/València	236	46236	Sumacàrcer	1364	688	676	50.4398826979472	49.5601173020528
46	Valencia/València	237	46237	Tavernes Blanques	8453	4177	4276	49.4144090855318	50.5855909144682
46	Valencia/València	238	46238	Tavernes de la Valldigna	16516	8194	8322	49.6124969726326	50.3875030273674
46	Valencia/València	239	46239	Teresa de Cofrentes	695	351	344	50.5035971223022	49.4964028776978
46	Valencia/València	240	46240	Terrateig	200	102	98	51	49
46	Valencia/València	241	46241	Titaguas	555	300	255	54.0540540540541	45.945945945946
46	Valencia/València	242	46242	Torrebaja	447	229	218	51.2304250559284	48.7695749440716
46	Valencia/València	243	46243	Torrella	175	87	88	49.7142857142857	50.2857142857143
46	Valencia/València	244	46244	Torrent	64586	32025	32561	49.585049391509	50.414950608491
46	Valencia/València	245	46245	Torres Torres	435	219	216	50.3448275862069	49.6551724137931
46	Valencia/València	246	46246	Tous	1183	578	605	48.8588334742181	51.1411665257819
46	Valencia/València	247	46247	Tuéjar	1268	669	599	52.7602523659306	47.2397476340694
46	Valencia/València	248	46248	Turís	4733	2409	2324	50.8979505598986	49.1020494401014
46	Valencia/València	249	46249	Utiel	11781	5867	5914	49.8005262711145	50.1994737288855
46	Valencia/València	250	46250	Valencia	739014	350843	388171	47.4744727434122	52.5255272565878
46	Valencia/València	251	46251	Vallada	3151	1584	1567	50.2697556331323	49.7302443668677
46	Valencia/València	252	46252	Vallanca	235	115	120	48.936170212766	51.063829787234
46	Valencia/València	253	46253	Vallés	102	55	47	53.921568627451	46.078431372549
46	Valencia/València	254	46254	Venta del Moro	1567	797	770	50.8615188257818	49.1384811742183
46	Valencia/València	255	46255	Villalonga	3639	1802	1837	49.5190986534762	50.4809013465238
46	Valencia/València	256	46256	Vilamarxant	5993	3066	2927	51.1596863006841	48.8403136993159
46	Valencia/València	257	46257	Villanueva de Castellón	6950	3420	3530	49.2086330935252	50.7913669064748
46	Valencia/València	258	46258	Villar del Arzobispo	3457	1725	1732	49.8987561469482	50.1012438530518
46	Valencia/València	259	46259	Villargordo del Cabriel	719	374	345	52.0166898470097	47.9833101529903
46	Valencia/València	260	46260	Vinalesa	2341	1112	1229	47.5010679196924	52.4989320803076
46	Valencia/València	261	46261	Yátova	1978	1024	954	51.7694641051567	48.2305358948433
46	Valencia/València	262	46262	Yesa (La)	283	149	134	52.6501766784452	47.3498233215548
46	Valencia/València	263	46263	Zarra	424	229	195	54.0094339622642	45.9905660377359
46	Valencia/València	902	46902	Gátova	500	235	265	47	53
46	Valencia/València	903	46903	San Antonio de Benagéber	2719	1364	1355	50.1655020228025	49.8344979771975
47	Valladolid	001	47001	Adalia	88	44	44	50	50
47	Valladolid	002	47002	Aguasal	24	13	11	54.1666666666667	45.8333333333333
47	Valladolid	003	47003	Aguilar de Campos	367	193	174	52.5885558583106	47.4114441416894
47	Valladolid	004	47004	Alaejos	1614	829	785	51.363073110285	48.636926889715
47	Valladolid	005	47005	Alcazarén	708	377	331	53.2485875706215	46.7514124293785
47	Valladolid	006	47006	Aldea de San Miguel	227	119	108	52.4229074889868	47.5770925110132
47	Valladolid	007	47007	Aldeamayor de San Martín	1436	725	711	50.4874651810585	49.5125348189415
47	Valladolid	008	47008	Almenara de Adaja	31	15	16	48.3870967741936	51.6129032258065
47	Valladolid	009	47009	Amusquillo	173	95	78	54.9132947976879	45.0867052023121
47	Valladolid	010	47010	Arroyo de la Encomienda	3635	1877	1758	51.636863823934	48.363136176066
47	Valladolid	011	47011	Ataquines	870	457	413	52.5287356321839	47.4712643678161
47	Valladolid	012	47012	Bahabón	203	102	101	50.2463054187192	49.7536945812808
47	Valladolid	013	47013	Barcial de la Loma	160	81	79	50.625	49.375
47	Valladolid	014	47014	Barruelo del Valle	76	42	34	55.2631578947369	44.7368421052632
47	Valladolid	015	47015	Becilla de Valderaduey	423	227	196	53.6643026004728	46.3356973995272
47	Valladolid	016	47016	Benafarces	115	58	57	50.4347826086956	49.5652173913044
47	Valladolid	017	47017	Bercero	283	150	133	53.0035335689046	46.9964664310954
47	Valladolid	018	47018	Berceruelo	44	24	20	54.5454545454545	45.4545454545455
47	Valladolid	019	47019	Berrueces	105	60	45	57.1428571428571	42.8571428571429
47	Valladolid	020	47020	Bobadilla del Campo	408	211	197	51.7156862745098	48.2843137254902
47	Valladolid	021	47021	Bocigas	139	67	72	48.2014388489209	51.7985611510791
47	Valladolid	022	47022	Bocos de Duero	85	38	47	44.7058823529412	55.2941176470588
47	Valladolid	023	47023	Boecillo	1614	829	785	51.363073110285	48.636926889715
47	Valladolid	024	47024	Bolaños de Campos	381	193	188	50.6561679790026	49.3438320209974
47	Valladolid	025	47025	Brahojos de Medina	182	99	83	54.3956043956044	45.6043956043956
47	Valladolid	026	47026	Bustillo de Chaves	95	47	48	49.4736842105263	50.5263157894737
47	Valladolid	027	47027	Cabezón de Pisuerga	1816	922	894	50.7709251101322	49.2290748898678
47	Valladolid	028	47028	Cabezón de Valderaduey	47	23	24	48.936170212766	51.063829787234
47	Valladolid	029	47029	Cabreros del Monte	94	51	43	54.2553191489362	45.7446808510638
47	Valladolid	030	47030	Campaspero	1452	749	703	51.5840220385675	48.4159779614325
47	Valladolid	031	47031	Campillo (El)	239	138	101	57.7405857740586	42.2594142259414
47	Valladolid	032	47032	Camporredondo	214	118	96	55.1401869158878	44.8598130841121
47	Valladolid	033	47033	Canalejas de Peñafiel	292	147	145	50.3424657534247	49.6575342465753
47	Valladolid	034	47034	Canillas de Esgueva	131	69	62	52.6717557251908	47.3282442748092
47	Valladolid	035	47035	Carpio	1183	625	558	52.8317836010144	47.1682163989856
47	Valladolid	036	47036	Casasola de Arión	374	205	169	54.8128342245989	45.1871657754011
47	Valladolid	037	47037	Castrejón de Trabancos	260	139	121	53.4615384615385	46.5384615384615
47	Valladolid	038	47038	Castrillo de Duero	199	97	102	48.7437185929648	51.2562814070352
47	Valladolid	039	47039	Castrillo-Tejeriego	268	144	124	53.7313432835821	46.2686567164179
47	Valladolid	040	47040	Castrobol	88	39	49	44.3181818181818	55.6818181818182
47	Valladolid	041	47041	Castrodeza	251	135	116	53.7848605577689	46.2151394422311
47	Valladolid	042	47042	Castromembibre	89	48	41	53.9325842696629	46.0674157303371
47	Valladolid	043	47043	Castromonte	451	233	218	51.6629711751663	48.3370288248337
47	Valladolid	044	47044	Castronuevo de Esgueva	321	167	154	52.0249221183801	47.9750778816199
47	Valladolid	045	47045	Castronuño	1072	534	538	49.8134328358209	50.1865671641791
47	Valladolid	046	47046	Castroponce	196	103	93	52.5510204081633	47.4489795918367
47	Valladolid	047	47047	Castroverde de Cerrato	266	155	111	58.2706766917293	41.7293233082707
47	Valladolid	048	47048	Ceinos de Campos	275	144	131	52.3636363636364	47.6363636363636
47	Valladolid	049	47049	Cervillego de la Cruz	156	77	79	49.3589743589744	50.6410256410256
47	Valladolid	050	47050	Cigales	2802	1371	1431	48.9293361884368	51.0706638115632
47	Valladolid	051	47051	Ciguñuela	372	198	174	53.2258064516129	46.7741935483871
47	Valladolid	052	47052	Cistérniga	3780	1968	1812	52.0634920634921	47.9365079365079
47	Valladolid	053	47053	Cogeces de Íscar	150	80	70	53.3333333333333	46.6666666666667
47	Valladolid	054	47054	Cogeces del Monte	916	497	419	54.2576419213974	45.7423580786026
47	Valladolid	055	47055	Corcos	270	141	129	52.2222222222222	47.7777777777778
47	Valladolid	056	47056	Corrales de Duero	139	82	57	58.9928057553957	41.0071942446043
47	Valladolid	057	47057	Cubillas de Santa Marta	281	151	130	53.7366548042705	46.2633451957295
47	Valladolid	058	47058	Cuenca de Campos	292	146	146	50	50
47	Valladolid	059	47059	Curiel de Duero	128	72	56	56.25	43.75
47	Valladolid	060	47060	Encinas de Esgueva	370	195	175	52.7027027027027	47.2972972972973
47	Valladolid	061	47061	Esguevillas de Esgueva	423	214	209	50.5910165484634	49.4089834515366
47	Valladolid	062	47062	Fombellida	282	147	135	52.1276595744681	47.8723404255319
47	Valladolid	063	47063	Fompedraza	143	77	66	53.8461538461539	46.1538461538462
47	Valladolid	064	47064	Fontihoyuelo	42	27	15	64.2857142857143	35.7142857142857
47	Valladolid	065	47065	Fresno el Viejo	1267	641	626	50.5919494869771	49.4080505130229
47	Valladolid	066	47066	Fuensaldaña	1002	496	506	49.500998003992	50.499001996008
47	Valladolid	067	47067	Fuente el Sol	303	157	146	51.8151815181518	48.1848184818482
47	Valladolid	068	47068	Fuente-Olmedo	68	34	34	50	50
47	Valladolid	069	47069	Gallegos de Hornija	148	72	76	48.6486486486487	51.3513513513514
47	Valladolid	070	47070	Gatón de Campos	42	26	16	61.9047619047619	38.0952380952381
47	Valladolid	071	47071	Geria	472	258	214	54.6610169491525	45.3389830508475
47	Valladolid	073	47073	Herrín de Campos	205	95	110	46.3414634146342	53.6585365853659
47	Valladolid	074	47074	Hornillos de Eresma	162	85	77	52.4691358024691	47.5308641975309
47	Valladolid	075	47075	Íscar	6145	3104	3041	50.5126118795769	49.4873881204231
47	Valladolid	076	47076	Laguna de Duero	16977	8585	8392	50.5684160923602	49.4315839076397
47	Valladolid	077	47077	Langayo	462	246	216	53.2467532467532	46.7532467532468
47	Valladolid	078	47078	Lomoviejo	266	131	135	49.2481203007519	50.7518796992481
47	Valladolid	079	47079	Llano de Olmedo	96	50	46	52.0833333333333	47.9166666666667
47	Valladolid	080	47080	Manzanillo	71	37	34	52.112676056338	47.887323943662
47	Valladolid	081	47081	Marzales	79	39	40	49.3670886075949	50.6329113924051
47	Valladolid	082	47082	Matapozuelos	1005	504	501	50.1492537313433	49.8507462686567
47	Valladolid	083	47083	Matilla de los Caños	105	62	43	59.0476190476191	40.952380952381
47	Valladolid	084	47084	Mayorga	1671	803	868	48.0550568521843	51.9449431478157
47	Valladolid	085	47085	Medina del Campo	20047	9806	10241	48.9150496333616	51.0849503666384
47	Valladolid	086	47086	Medina de Rioseco	4902	2393	2509	48.8168094655243	51.1831905344757
47	Valladolid	087	47087	Megeces	462	227	235	49.1341991341991	50.8658008658009
47	Valladolid	088	47088	Melgar de Abajo	175	89	86	50.8571428571429	49.1428571428571
47	Valladolid	089	47089	Melgar de Arriba	299	149	150	49.8327759197324	50.1672240802676
47	Valladolid	090	47090	Mojados	2565	1277	1288	49.7855750487329	50.2144249512671
47	Valladolid	091	47091	Monasterio de Vega	105	58	47	55.2380952380952	44.7619047619048
47	Valladolid	092	47092	Montealegre de Campos	169	94	75	55.6213017751479	44.3786982248521
47	Valladolid	093	47093	Montemayor de Pililla	1049	557	492	53.0981887511916	46.9018112488084
47	Valladolid	094	47094	Moral de la Reina	226	115	111	50.8849557522124	49.1150442477876
47	Valladolid	095	47095	Moraleja de las Panaderas	32	20	12	62.5	37.5
47	Valladolid	096	47096	Morales de Campos	196	98	98	50	50
47	Valladolid	097	47097	Mota del Marqués	448	215	233	47.9910714285714	52.0089285714286
47	Valladolid	098	47098	Mucientes	617	310	307	50.2431118314425	49.7568881685575
47	Valladolid	099	47099	Mudarra (La)	260	140	120	53.8461538461539	46.1538461538462
47	Valladolid	100	47100	Muriel	214	107	107	50	50
47	Valladolid	101	47101	Nava del Rey	2267	1118	1149	49.3162770180856	50.6837229819144
47	Valladolid	102	47102	Nueva Villa de las Torres	407	228	179	56.019656019656	43.980343980344
47	Valladolid	103	47103	Olivares de Duero	334	186	148	55.688622754491	44.311377245509
47	Valladolid	104	47104	Olmedo	3434	1659	1775	48.3110075713454	51.6889924286546
47	Valladolid	105	47105	Olmos de Esgueva	186	103	83	55.3763440860215	44.6236559139785
47	Valladolid	106	47106	Olmos de Peñafiel	85	43	42	50.5882352941176	49.4117647058824
47	Valladolid	109	47109	Palazuelo de Vedija	254	128	126	50.3937007874016	49.6062992125984
47	Valladolid	110	47110	Parrilla (La)	632	304	328	48.1012658227848	51.8987341772152
47	Valladolid	111	47111	Pedraja de Portillo (La)	1055	532	523	50.4265402843602	49.5734597156398
47	Valladolid	112	47112	Pedrajas de San Esteban	3237	1631	1606	50.3861600247142	49.6138399752858
47	Valladolid	113	47113	Pedrosa del Rey	236	127	109	53.8135593220339	46.1864406779661
47	Valladolid	114	47114	Peñafiel	5099	2542	2557	49.8529123357521	50.1470876642479
47	Valladolid	115	47115	Peñaflor de Hornija	454	242	212	53.3039647577093	46.6960352422908
47	Valladolid	116	47116	Pesquera de Duero	535	283	252	52.8971962616822	47.1028037383178
47	Valladolid	117	47117	Piña de Esgueva	406	210	196	51.7241379310345	48.2758620689655
47	Valladolid	118	47118	Piñel de Abajo	216	116	100	53.7037037037037	46.2962962962963
47	Valladolid	119	47119	Piñel de Arriba	149	74	75	49.6644295302013	50.3355704697987
47	Valladolid	121	47121	Pollos	815	419	396	51.4110429447853	48.5889570552147
47	Valladolid	122	47122	Portillo	2512	1275	1237	50.7563694267516	49.2436305732484
47	Valladolid	123	47123	Pozal de Gallinas	499	266	233	53.3066132264529	46.6933867735471
47	Valladolid	124	47124	Pozaldez	513	252	261	49.1228070175439	50.8771929824562
47	Valladolid	125	47125	Pozuelo de la Orden	79	45	34	56.9620253164557	43.0379746835443
47	Valladolid	126	47126	Puras	60	28	32	46.6666666666667	53.3333333333333
47	Valladolid	127	47127	Quintanilla de Arriba	226	120	106	53.0973451327434	46.9026548672566
47	Valladolid	128	47128	Quintanilla del Molar	85	36	49	42.3529411764706	57.6470588235294
47	Valladolid	129	47129	Quintanilla de Onésimo	1179	605	574	51.314673452078	48.685326547922
47	Valladolid	130	47130	Quintanilla de Trigueros	113	58	55	51.3274336283186	48.6725663716814
47	Valladolid	131	47131	Rábano	249	123	126	49.3975903614458	50.6024096385542
47	Valladolid	132	47132	Ramiro	81	46	35	56.7901234567901	43.2098765432099
47	Valladolid	133	47133	Renedo de Esgueva	935	493	442	52.7272727272727	47.2727272727273
47	Valladolid	134	47134	Roales de Campos	260	133	127	51.1538461538462	48.8461538461539
47	Valladolid	135	47135	Robladillo	106	52	54	49.0566037735849	50.9433962264151
47	Valladolid	137	47137	Roturas	30	15	15	50	50
47	Valladolid	138	47138	Rubí de Bracamonte	333	172	161	51.6516516516517	48.3483483483484
47	Valladolid	139	47139	Rueda	1436	731	705	50.9052924791086	49.0947075208914
47	Valladolid	140	47140	Saelices de Mayorga	196	97	99	49.4897959183674	50.5102040816327
47	Valladolid	141	47141	Salvador de Zapardiel	199	109	90	54.7738693467337	45.2261306532663
47	Valladolid	142	47142	San Cebrián de Mazote	218	118	100	54.1284403669725	45.8715596330275
47	Valladolid	143	47143	San Llorente	203	110	93	54.1871921182266	45.8128078817734
47	Valladolid	144	47144	San Martín de Valvení	108	61	47	56.4814814814815	43.5185185185185
47	Valladolid	145	47145	San Miguel del Arroyo	795	419	376	52.7044025157233	47.2955974842767
47	Valladolid	146	47146	San Miguel del Pino	231	122	109	52.8138528138528	47.1861471861472
47	Valladolid	147	47147	San Pablo de la Moraleja	178	95	83	53.3707865168539	46.6292134831461
47	Valladolid	148	47148	San Pedro de Latarce	649	352	297	54.2372881355932	45.7627118644068
47	Valladolid	149	47149	San Pelayo	45	24	21	53.3333333333333	46.6666666666667
47	Valladolid	150	47150	San Román de Hornija	434	213	221	49.0783410138249	50.9216589861751
47	Valladolid	151	47151	San Salvador	49	25	24	51.0204081632653	48.9795918367347
47	Valladolid	152	47152	Santa Eufemia del Arroyo	135	66	69	48.8888888888889	51.1111111111111
47	Valladolid	153	47153	Santervás de Campos	166	90	76	54.2168674698795	45.7831325301205
47	Valladolid	154	47154	Santibáñez de Valcorba	214	108	106	50.4672897196262	49.5327102803738
47	Valladolid	155	47155	Santovenia de Pisuerga	2278	1155	1123	50.702370500439	49.297629499561
47	Valladolid	156	47156	San Vicente del Palacio	244	125	119	51.2295081967213	48.7704918032787
47	Valladolid	157	47157	Sardón de Duero	629	319	310	50.7154213036566	49.2845786963434
47	Valladolid	158	47158	Seca (La)	1050	561	489	53.4285714285714	46.5714285714286
47	Valladolid	159	47159	Serrada	1059	545	514	51.4636449480642	48.5363550519358
47	Valladolid	160	47160	Siete Iglesias de Trabancos	611	321	290	52.5368248772504	47.4631751227496
47	Valladolid	161	47161	Simancas	3453	1765	1688	51.1149724876919	48.8850275123081
47	Valladolid	162	47162	Tamariz de Campos	97	51	46	52.5773195876289	47.4226804123711
47	Valladolid	163	47163	Tiedra	407	204	203	50.1228501228501	49.8771498771499
47	Valladolid	164	47164	Tordehumos	558	281	277	50.3584229390681	49.6415770609319
47	Valladolid	165	47165	Tordesillas	8066	4085	3981	50.6446813786263	49.3553186213737
47	Valladolid	166	47166	Torrecilla de la Abadesa	367	188	179	51.2261580381471	48.7738419618529
47	Valladolid	167	47167	Torrecilla de la Orden	378	189	189	50	50
47	Valladolid	168	47168	Torrecilla de la Torre	36	21	15	58.3333333333333	41.6666666666667
47	Valladolid	169	47169	Torre de Esgueva	100	49	51	49	51
47	Valladolid	170	47170	Torre de Peñafiel	53	28	25	52.8301886792453	47.1698113207547
47	Valladolid	171	47171	Torrelobatón	576	285	291	49.4791666666667	50.5208333333333
47	Valladolid	172	47172	Torrescárcela	163	86	77	52.760736196319	47.239263803681
47	Valladolid	173	47173	Traspinedo	831	431	400	51.8652226233454	48.1347773766546
47	Valladolid	174	47174	Trigueros del Valle	296	152	144	51.3513513513514	48.6486486486487
47	Valladolid	175	47175	Tudela de Duero	6353	3263	3090	51.3615614670235	48.6384385329765
47	Valladolid	176	47176	Unión de Campos (La)	306	153	153	50	50
47	Valladolid	177	47177	Urones de Castroponce	151	83	68	54.9668874172185	45.0331125827815
47	Valladolid	178	47178	Urueña	212	109	103	51.4150943396226	48.5849056603774
47	Valladolid	179	47179	Valbuena de Duero	521	271	250	52.0153550863724	47.9846449136276
47	Valladolid	180	47180	Valdearcos de la Vega	141	69	72	48.936170212766	51.063829787234
47	Valladolid	181	47181	Valdenebro de los Valles	235	120	115	51.063829787234	48.936170212766
47	Valladolid	182	47182	Valdestillas	1549	774	775	49.9677211103938	50.0322788896062
47	Valladolid	183	47183	Valdunquillo	228	108	120	47.3684210526316	52.6315789473684
47	Valladolid	184	47184	Valoria la Buena	648	333	315	51.3888888888889	48.6111111111111
47	Valladolid	185	47185	Valverde de Campos	119	64	55	53.781512605042	46.218487394958
47	Valladolid	186	47186	Valladolid	319129	153292	165837	48.0344938880515	51.9655061119485
47	Valladolid	187	47187	Vega de Ruiponce	137	66	71	48.1751824817518	51.8248175182482
47	Valladolid	188	47188	Vega de Valdetronco	190	103	87	54.2105263157895	45.7894736842105
47	Valladolid	189	47189	Velascálvaro	194	101	93	52.0618556701031	47.9381443298969
47	Valladolid	190	47190	Velilla	152	78	74	51.3157894736842	48.6842105263158
47	Valladolid	191	47191	Velliza	171	101	70	59.0643274853801	40.9356725146199
47	Valladolid	192	47192	Ventosa de la Cuesta	154	86	68	55.8441558441558	44.1558441558442
47	Valladolid	193	47193	Viana de Cega	1564	798	766	51.0230179028133	48.9769820971867
47	Valladolid	194	47194	Viloria	380	202	178	53.1578947368421	46.8421052631579
47	Valladolid	195	47195	Villabáñez	477	260	217	54.5073375262055	45.4926624737946
47	Valladolid	196	47196	Villabaruz de Campos	49	24	25	48.9795918367347	51.0204081632653
47	Valladolid	197	47197	Villabrágima	1223	638	585	52.1668029435814	47.8331970564186
47	Valladolid	198	47198	Villacarralón	114	57	57	50	50
47	Valladolid	199	47199	Villacid de Campos	122	65	57	53.2786885245902	46.7213114754098
47	Valladolid	200	47200	Villaco	131	78	53	59.5419847328244	40.4580152671756
47	Valladolid	203	47203	Villafrades de Campos	114	48	66	42.1052631578947	57.8947368421053
47	Valladolid	204	47204	Villafranca de Duero	373	190	183	50.9383378016086	49.0616621983914
47	Valladolid	205	47205	Villafrechós	532	276	256	51.8796992481203	48.1203007518797
47	Valladolid	206	47206	Villafuerte	154	77	77	50	50
47	Valladolid	207	47207	Villagarcía de Campos	440	233	207	52.9545454545455	47.0454545454546
47	Valladolid	208	47208	Villagómez la Nueva	98	47	51	47.9591836734694	52.0408163265306
47	Valladolid	209	47209	Villalán de Campos	55	28	27	50.9090909090909	49.0909090909091
47	Valladolid	210	47210	Villalar de los Comuneros	498	238	260	47.7911646586345	52.2088353413655
47	Valladolid	211	47211	Villalba de la Loma	47	27	20	57.4468085106383	42.5531914893617
47	Valladolid	212	47212	Villalba de los Alcores	581	309	272	53.184165232358	46.815834767642
47	Valladolid	213	47213	Villalbarba	167	83	84	49.7005988023952	50.2994011976048
47	Valladolid	214	47214	Villalón de Campos	2101	1020	1081	48.548310328415	51.451689671585
47	Valladolid	215	47215	Villamuriel de Campos	93	44	49	47.3118279569893	52.6881720430108
47	Valladolid	216	47216	Villán de Tordesillas	182	92	90	50.5494505494506	49.4505494505495
47	Valladolid	217	47217	Villanubla	926	490	436	52.9157667386609	47.0842332613391
47	Valladolid	218	47218	Villanueva de Duero	1006	519	487	51.5904572564612	48.4095427435388
47	Valladolid	219	47219	Villanueva de la Condesa	40	24	16	60	40
47	Valladolid	220	47220	Villanueva de los Caballeros	269	129	140	47.9553903345725	52.0446096654275
47	Valladolid	221	47221	Villanueva de los Infantes	147	77	70	52.3809523809524	47.6190476190476
47	Valladolid	222	47222	Villanueva de San Mancio	115	62	53	53.9130434782609	46.0869565217391
47	Valladolid	223	47223	Villardefrades	230	119	111	51.7391304347826	48.2608695652174
47	Valladolid	224	47224	Villarmentero de Esgueva	127	63	64	49.6062992125984	50.3937007874016
47	Valladolid	225	47225	Villasexmir	121	62	59	51.2396694214876	48.7603305785124
47	Valladolid	226	47226	Villavaquerín	220	117	103	53.1818181818182	46.8181818181818
47	Valladolid	227	47227	Villavellid	73	40	33	54.7945205479452	45.2054794520548
47	Valladolid	228	47228	Villaverde de Medina	582	311	271	53.4364261168385	46.5635738831615
47	Valladolid	229	47229	Villavicencio de los Caballeros	326	147	179	45.0920245398773	54.9079754601227
47	Valladolid	230	47230	Wamba	376	194	182	51.5957446808511	48.4042553191489
47	Valladolid	231	47231	Zaratán	1400	722	678	51.5714285714286	48.4285714285714
47	Valladolid	232	47232	Zarza (La)	156	79	77	50.6410256410256	49.3589743589744
48	Vizcaya	001	48001	Abadiño	6851	3427	3424	50.021894613925	49.978105386075
48	Vizcaya	002	48002	Abanto y Ciérvana/Abanto Zierbena	8989	4435	4554	49.3380798754033	50.6619201245967
48	Vizcaya	003	48003	Amorebieta-Etxano	16216	8092	8124	49.9013320177602	50.0986679822398
48	Vizcaya	004	48004	Amoroto	365	194	171	53.1506849315069	46.8493150684932
48	Vizcaya	005	48005	Arakaldo	90	53	37	58.8888888888889	41.1111111111111
48	Vizcaya	006	48006	Arantzazu	276	133	143	48.1884057971014	51.8115942028985
48	Vizcaya	007	48007	Munitibar-Arbatzegi Gerrikaitz	383	204	179	53.2637075718016	46.7362924281984
48	Vizcaya	008	48008	Arcentales	679	370	309	54.4918998527246	45.5081001472754
48	Vizcaya	009	48009	Arrankudiaga	745	351	394	47.1140939597315	52.8859060402685
48	Vizcaya	010	48010	Arrieta	509	258	251	50.6876227897839	49.3123772102161
48	Vizcaya	011	48011	Arrigorriaga	10662	5253	5409	49.2684299380979	50.7315700619021
48	Vizcaya	012	48012	Bakio	1614	818	796	50.6815365551425	49.3184634448575
48	Vizcaya	013	48013	Barakaldo	97281	47518	49763	48.846126170578	51.153873829422
48	Vizcaya	014	48014	Barrika	1159	590	569	50.9059534081104	49.0940465918896
48	Vizcaya	015	48015	Basauri	47036	23266	23770	49.4642401564759	50.5357598435241
48	Vizcaya	016	48016	Berango	4929	2437	2492	49.4420775005072	50.5579224994928
48	Vizcaya	017	48017	Bermeo	16972	8335	8637	49.1102993165213	50.8897006834787
48	Vizcaya	018	48018	Berriatua	940	488	452	51.9148936170213	48.0851063829787
48	Vizcaya	019	48019	Berriz	4139	2090	2049	50.4952887170814	49.5047112829186
48	Vizcaya	020	48020	Bilbao	354271	167846	186425	47.3778548060665	52.6221451939335
48	Vizcaya	021	48021	Busturia	1673	841	832	50.2689778840406	49.7310221159594
48	Vizcaya	022	48022	Carranza	2998	1568	1430	52.3015343562375	47.6984656437625
48	Vizcaya	023	48023	Artea	641	310	331	48.3619344773791	51.6380655226209
48	Vizcaya	024	48024	Zeanuri	1154	594	560	51.473136915078	48.526863084922
48	Vizcaya	025	48025	Zeberio	959	502	457	52.3461939520334	47.6538060479666
48	Vizcaya	026	48026	Dima	1055	539	516	51.0900473933649	48.9099526066351
48	Vizcaya	027	48027	Durango	24742	12065	12677	48.7632366017299	51.2367633982702
48	Vizcaya	028	48028	Ea	814	404	410	49.6314496314496	50.3685503685504
48	Vizcaya	029	48029	Etxebarri. Anteiglesia de San Esteban/Etxebarri Doneztebeko Elizatea	6690	3413	3277	51.01644245142	48.98355754858
48	Vizcaya	030	48030	Etxebarria	808	420	388	51.980198019802	48.019801980198
48	Vizcaya	031	48031	Elantxobe	466	211	255	45.2789699570815	54.7210300429185
48	Vizcaya	032	48032	Elorrio	7166	3578	3588	49.9302260675412	50.0697739324588
48	Vizcaya	033	48033	Ereño	255	126	129	49.4117647058824	50.5882352941176
48	Vizcaya	034	48034	Ermua	17140	8742	8398	51.0035005834306	48.9964994165694
48	Vizcaya	035	48035	Fruiz	341	166	175	48.6803519061584	51.3196480938416
48	Vizcaya	036	48036	Galdakao	29387	14572	14815	49.5865518766802	50.4134481233198
48	Vizcaya	037	48037	Galdames	805	425	380	52.7950310559006	47.2049689440994
48	Vizcaya	038	48038	Gamiz-Fika	1138	581	557	51.0544815465729	48.9455184534271
48	Vizcaya	039	48039	Garay	241	121	120	50.2074688796681	49.792531120332
48	Vizcaya	040	48040	Gatika	1217	624	593	51.2736236647494	48.7263763352506
48	Vizcaya	041	48041	Gautegiz Arteaga	834	422	412	50.599520383693	49.400479616307
48	Vizcaya	042	48042	Gordexola	1437	717	720	49.8956158663883	50.1043841336117
48	Vizcaya	043	48043	Gorliz	4179	2084	2095	49.868389566882	50.131610433118
48	Vizcaya	044	48044	Getxo	83789	40070	43719	47.8225065342706	52.1774934657294
48	Vizcaya	045	48045	Güeñes	5896	2897	2999	49.1350067842605	50.8649932157395
48	Vizcaya	046	48046	Gernika-Lumo	15427	7510	7917	48.6808841641278	51.3191158358722
48	Vizcaya	047	48047	Guizaburuaga	140	69	71	49.2857142857143	50.7142857142857
48	Vizcaya	048	48048	Ibarrangelu	522	246	276	47.1264367816092	52.8735632183908
48	Vizcaya	049	48049	Ispaster	613	323	290	52.6916802610114	47.3083197389886
48	Vizcaya	050	48050	Izurtza	262	130	132	49.618320610687	50.381679389313
48	Vizcaya	051	48051	Lanestosa	287	146	141	50.8710801393728	49.1289198606272
48	Vizcaya	052	48052	Larrabetzu	1537	769	768	50.0325309043591	49.9674690956409
48	Vizcaya	053	48053	Laukiz	958	495	463	51.6701461377871	48.3298538622129
48	Vizcaya	054	48054	Leioa	27925	13769	14156	49.307072515667	50.692927484333
48	Vizcaya	055	48055	Lemoa	2544	1258	1286	49.4496855345912	50.5503144654088
48	Vizcaya	056	48056	Lemoiz	882	467	415	52.9478458049887	47.0521541950113
48	Vizcaya	057	48057	Lekeitio	7423	3662	3761	49.3331537114374	50.6668462885626
48	Vizcaya	058	48058	Mallabia	1119	590	529	52.7256478999106	47.2743521000894
48	Vizcaya	059	48059	Mañaria	465	242	223	52.0430107526882	47.9569892473118
48	Vizcaya	060	48060	Markina-Xemein	4661	2313	2348	49.6245440892512	50.3754559107488
48	Vizcaya	061	48061	Maruri-Jatabe	630	307	323	48.7301587301587	51.2698412698413
48	Vizcaya	062	48062	Mendata	335	180	155	53.7313432835821	46.2686567164179
48	Vizcaya	063	48063	Mendexa	338	182	156	53.8461538461539	46.1538461538462
48	Vizcaya	064	48064	Meñaka	514	257	257	50	50
48	Vizcaya	065	48065	Ugao-Miraballes	4122	2072	2050	50.2668607472101	49.7331392527899
48	Vizcaya	066	48066	Morga	398	217	181	54.5226130653266	45.4773869346734
48	Vizcaya	067	48067	Muxika	1361	708	653	52.0205731080088	47.9794268919912
48	Vizcaya	068	48068	Mundaka	1806	850	956	47.0653377630122	52.9346622369878
48	Vizcaya	069	48069	Mungia	13647	6708	6939	49.1536601450868	50.8463398549132
48	Vizcaya	070	48070	Aulesti	651	335	316	51.4592933947773	48.5407066052227
48	Vizcaya	071	48071	Muskiz	6208	3052	3156	49.1623711340206	50.8376288659794
48	Vizcaya	072	48072	Otxandio	1010	536	474	53.0693069306931	46.9306930693069
48	Vizcaya	073	48073	Ondarroa	9925	4957	4968	49.9445843828715	50.0554156171285
48	Vizcaya	074	48074	Orduña	3916	2001	1915	51.0980592441267	48.9019407558733
48	Vizcaya	075	48075	Orozko	2031	1024	1007	50.4185130477597	49.5814869522403
48	Vizcaya	076	48076	Sukarrieta	313	163	150	52.0766773162939	47.9233226837061
48	Vizcaya	077	48077	Plentzia	3556	1716	1840	48.2564679415073	51.7435320584927
48	Vizcaya	078	48078	Portugalete	52681	25720	26961	48.8221559955202	51.1778440044798
48	Vizcaya	079	48079	Errigoiti	464	259	205	55.8189655172414	44.1810344827586
48	Vizcaya	080	48080	Valle de Trápaga-Trapagaran	12450	6145	6305	49.3574297188755	50.6425702811245
48	Vizcaya	081	48081	Lezama	2124	1069	1055	50.3295668549906	49.6704331450094
48	Vizcaya	082	48082	Santurtzi	47999	23506	24493	48.9718535802829	51.0281464197171
48	Vizcaya	083	48083	Ortuella	8819	4315	4504	48.9284499376347	51.0715500623653
48	Vizcaya	084	48084	Sestao	32852	15996	16856	48.6910994764398	51.3089005235602
48	Vizcaya	085	48085	Sopelana	10097	5035	5062	49.8662969198772	50.1337030801228
48	Vizcaya	086	48086	Sopuerta	2237	1135	1102	50.7375949932946	49.2624050067054
48	Vizcaya	087	48087	Trucios-Turtzioz	546	267	279	48.9010989010989	51.0989010989011
48	Vizcaya	088	48088	Ubide	171	84	87	49.1228070175439	50.8771929824562
48	Vizcaya	089	48089	Urduliz	2999	1510	1489	50.3501167055685	49.6498832944315
48	Vizcaya	090	48090	Balmaseda	7007	3380	3627	48.2374768089054	51.7625231910946
48	Vizcaya	091	48091	Atxondo	1461	744	717	50.9240246406571	49.0759753593429
48	Vizcaya	092	48092	Bedia	950	472	478	49.6842105263158	50.3157894736842
48	Vizcaya	093	48093	Areatza	1044	470	574	45.0191570881226	54.9808429118774
48	Vizcaya	094	48094	Igorre	3917	1956	1961	49.936175644626	50.063824355374
48	Vizcaya	095	48095	Zaldibar	2896	1405	1491	48.5151933701657	51.4848066298343
48	Vizcaya	096	48096	Zalla	7725	3809	3916	49.3074433656958	50.6925566343042
48	Vizcaya	097	48097	Zaratamo	1662	843	819	50.7220216606498	49.2779783393502
48	Vizcaya	901	48901	Derio	4700	2363	2337	50.2765957446809	49.7234042553191
48	Vizcaya	902	48902	Erandio	22853	11262	11591	49.2801820329935	50.7198179670065
48	Vizcaya	903	48903	Loiu	1885	938	947	49.7612732095491	50.2387267904509
48	Vizcaya	904	48904	Sondika	3929	1903	2026	48.4347162127768	51.5652837872232
48	Vizcaya	905	48905	Zamudio	2900	1455	1445	50.1724137931034	49.8275862068966
48	Vizcaya	906	48906	Forua	979	493	486	50.3575076608784	49.6424923391216
48	Vizcaya	907	48907	Kortezubi	387	202	185	52.1963824289406	47.8036175710594
48	Vizcaya	908	48908	Murueta	223	117	106	52.4663677130045	47.5336322869955
48	Vizcaya	909	48909	Nabarniz	231	111	120	48.0519480519481	51.9480519480519
48	Vizcaya	910	48910	Iurreta	4310	2138	2172	49.6055684454756	50.3944315545244
48	Vizcaya	911	48911	Ajangiz	418	213	205	50.9569377990431	49.0430622009569
48	Vizcaya	912	48912	Alonsotegi	2760	1331	1429	48.2246376811594	51.7753623188406
48	Vizcaya	913	48913	Zierbena	1206	642	564	53.2338308457712	46.7661691542289
48	Vizcaya	914	48914	Arratzu	390	188	202	48.2051282051282	51.7948717948718
49	Zamora	002	49002	Abezames	110	56	54	50.9090909090909	49.0909090909091
49	Zamora	003	49003	Alcañices	1130	568	562	50.2654867256637	49.7345132743363
49	Zamora	004	49004	Alcubilla de Nogales	204	98	106	48.0392156862745	51.9607843137255
49	Zamora	005	49005	Alfaraz de Sayago	210	114	96	54.2857142857143	45.7142857142857
49	Zamora	006	49006	Algodre	195	99	96	50.7692307692308	49.2307692307692
49	Zamora	007	49007	Almaraz de Duero	471	238	233	50.5307855626327	49.4692144373673
49	Zamora	008	49008	Almeida de Sayago	694	349	345	50.2881844380404	49.7118155619597
49	Zamora	009	49009	Andavías	510	251	259	49.2156862745098	50.7843137254902
49	Zamora	010	49010	Arcenillas	305	151	154	49.5081967213115	50.4918032786885
49	Zamora	011	49011	Arcos de la Polvorosa	301	159	142	52.8239202657807	47.1760797342193
49	Zamora	012	49012	Argañín	100	45	55	45	55
49	Zamora	013	49013	Argujillo	380	196	184	51.5789473684211	48.421052631579
49	Zamora	014	49014	Arquillinos	179	92	87	51.3966480446927	48.6033519553073
49	Zamora	015	49015	Arrabalde	391	189	202	48.3375959079284	51.6624040920716
49	Zamora	016	49016	Aspariegos	370	184	186	49.7297297297297	50.2702702702703
49	Zamora	017	49017	Asturianos	361	182	179	50.415512465374	49.584487534626
49	Zamora	018	49018	Ayoó de Vidriales	473	235	238	49.6828752642706	50.3171247357294
49	Zamora	019	49019	Barcial del Barco	308	173	135	56.1688311688312	43.8311688311688
49	Zamora	020	49020	Belver de los Montes	473	249	224	52.6427061310782	47.3572938689218
49	Zamora	021	49021	Benavente	16763	8119	8644	48.4340511841556	51.5659488158444
49	Zamora	022	49022	Benegiles	418	222	196	53.11004784689	46.8899521531101
49	Zamora	023	49023	Bermillo de Sayago	1436	746	690	51.949860724234	48.050139275766
49	Zamora	024	49024	Bóveda de Toro (La)	1003	505	498	50.3489531405783	49.6510468594217
49	Zamora	025	49025	Bretó	246	129	117	52.4390243902439	47.5609756097561
49	Zamora	026	49026	Bretocino	329	173	156	52.5835866261398	47.4164133738602
49	Zamora	027	49027	Brime de Sog	252	114	138	45.2380952380952	54.7619047619048
49	Zamora	028	49028	Brime de Urz	154	84	70	54.5454545454545	45.4545454545455
49	Zamora	029	49029	Burganes de Valverde	908	466	442	51.3215859030837	48.6784140969163
49	Zamora	030	49030	Bustillo del Oro	157	78	79	49.6815286624204	50.3184713375796
49	Zamora	031	49031	Cabañas de Sayago	196	92	104	46.9387755102041	53.0612244897959
49	Zamora	032	49032	Calzadilla de Tera	508	249	259	49.0157480314961	50.9842519685039
49	Zamora	033	49033	Camarzana de Tera	1057	523	534	49.4796594134342	50.5203405865658
49	Zamora	034	49034	Cañizal	626	331	295	52.8753993610224	47.1246006389776
49	Zamora	035	49035	Cañizo	328	163	165	49.6951219512195	50.3048780487805
49	Zamora	036	49036	Carbajales de Alba	678	334	344	49.2625368731563	50.7374631268437
49	Zamora	037	49037	Carbellino	272	138	134	50.7352941176471	49.2647058823529
49	Zamora	038	49038	Casaseca de Campeán	158	85	73	53.7974683544304	46.2025316455696
49	Zamora	039	49039	Casaseca de las Chanas	371	185	186	49.8652291105121	50.1347708894879
49	Zamora	040	49040	Castrillo de la Guareña	159	77	82	48.4276729559748	51.5723270440252
49	Zamora	041	49041	Castrogonzalo	571	307	264	53.7653239929948	46.2346760070053
49	Zamora	042	49042	Castronuevo	352	180	172	51.1363636363636	48.8636363636364
49	Zamora	043	49043	Castroverde de Campos	415	211	204	50.8433734939759	49.1566265060241
49	Zamora	044	49044	Cazurra	97	54	43	55.6701030927835	44.3298969072165
49	Zamora	046	49046	Cerecinos de Campos	432	222	210	51.3888888888889	48.6111111111111
49	Zamora	047	49047	Cerecinos del Carrizal	154	83	71	53.8961038961039	46.1038961038961
49	Zamora	048	49048	Cernadilla	177	85	92	48.0225988700565	51.9774011299435
49	Zamora	050	49050	Cobreros	797	397	400	49.8117942283563	50.1882057716437
49	Zamora	052	49052	Coomonte	334	174	160	52.0958083832335	47.9041916167665
49	Zamora	053	49053	Coreses	1199	609	590	50.7923269391159	49.2076730608841
49	Zamora	054	49054	Corrales	1141	546	595	47.8527607361963	52.1472392638037
49	Zamora	055	49055	Cotanes del Monte	162	84	78	51.8518518518519	48.1481481481482
49	Zamora	056	49056	Cubillos	397	202	195	50.8816120906801	49.1183879093199
49	Zamora	057	49057	Cubo de Benavente	180	95	85	52.7777777777778	47.2222222222222
49	Zamora	058	49058	Cubo de Tierra del Vino (El)	475	246	229	51.7894736842105	48.2105263157895
49	Zamora	059	49059	Cuelgamures	143	80	63	55.944055944056	44.0559440559441
49	Zamora	061	49061	Entrala	165	83	82	50.3030303030303	49.6969696969697
49	Zamora	062	49062	Espadañedo	222	109	113	49.0990990990991	50.9009009009009
49	Zamora	063	49063	Faramontanos de Tábara	509	257	252	50.4911591355599	49.5088408644401
49	Zamora	064	49064	Fariza	722	362	360	50.1385041551247	49.8614958448754
49	Zamora	065	49065	Fermoselle	1646	824	822	50.0607533414338	49.9392466585662
49	Zamora	066	49066	Ferreras de Abajo	629	304	325	48.3306836248013	51.6693163751987
49	Zamora	067	49067	Ferreras de Arriba	525	264	261	50.2857142857143	49.7142857142857
49	Zamora	068	49068	Ferreruela	666	347	319	52.1021021021021	47.8978978978979
49	Zamora	069	49069	Figueruela de Arriba	572	280	292	48.951048951049	51.0489510489511
49	Zamora	071	49071	Fonfría	1189	613	576	51.555929352397	48.444070647603
49	Zamora	075	49075	Fresno de la Polvorosa	216	101	115	46.7592592592593	53.2407407407407
49	Zamora	076	49076	Fresno de la Ribera	419	227	192	54.1766109785203	45.8233890214797
49	Zamora	077	49077	Fresno de Sayago	268	133	135	49.6268656716418	50.3731343283582
49	Zamora	078	49078	Friera de Valverde	276	143	133	51.8115942028985	48.1884057971014
49	Zamora	079	49079	Fuente Encalada	151	76	75	50.3311258278146	49.6688741721854
49	Zamora	080	49080	Fuentelapeña	1051	537	514	51.0941960038059	48.9058039961941
49	Zamora	081	49081	Fuentesaúco	1888	944	944	50	50
49	Zamora	082	49082	Fuentes de Ropel	575	293	282	50.9565217391304	49.0434782608696
49	Zamora	083	49083	Fuentesecas	89	41	48	46.0674157303371	53.9325842696629
49	Zamora	084	49084	Fuentespreadas	407	223	184	54.7911547911548	45.2088452088452
49	Zamora	085	49085	Galende	1363	665	698	48.7894350696992	51.2105649303008
49	Zamora	086	49086	Gallegos del Pan	167	88	79	52.6946107784431	47.3053892215569
49	Zamora	087	49087	Gallegos del Río	850	452	398	53.1764705882353	46.8235294117647
49	Zamora	088	49088	Gamones	99	58	41	58.5858585858586	41.4141414141414
49	Zamora	090	49090	Gema	270	133	137	49.2592592592593	50.7407407407407
49	Zamora	091	49091	Granja de Moreruela	385	189	196	49.0909090909091	50.9090909090909
49	Zamora	092	49092	Granucillo	257	130	127	50.5836575875486	49.4163424124514
49	Zamora	093	49093	Guarrate	377	200	177	53.0503978779841	46.9496021220159
49	Zamora	094	49094	Hermisende	444	241	203	54.2792792792793	45.7207207207207
49	Zamora	095	49095	Hiniesta (La)	383	187	196	48.8250652741514	51.1749347258486
49	Zamora	096	49096	Jambrina	269	130	139	48.3271375464684	51.6728624535316
49	Zamora	097	49097	Justel	170	92	78	54.1176470588235	45.8823529411765
49	Zamora	098	49098	Losacino	346	186	160	53.757225433526	46.242774566474
49	Zamora	099	49099	Losacio	161	85	76	52.7950310559006	47.2049689440994
49	Zamora	100	49100	Lubián	378	184	194	48.6772486772487	51.3227513227513
49	Zamora	101	49101	Luelmo	255	131	124	51.3725490196078	48.6274509803922
49	Zamora	102	49102	Maderal (El)	302	154	148	50.9933774834437	49.0066225165563
49	Zamora	103	49103	Madridanos	566	280	286	49.469964664311	50.5300353356891
49	Zamora	104	49104	Mahide	567	295	272	52.0282186948854	47.9717813051146
49	Zamora	105	49105	Maire de Castroponce	250	128	122	51.2	48.8
49	Zamora	107	49107	Malva	228	116	112	50.8771929824562	49.1228070175439
49	Zamora	108	49108	Manganeses de la Lampreana	786	395	391	50.2544529262087	49.7455470737913
49	Zamora	109	49109	Manganeses de la Polvorosa	876	429	447	48.972602739726	51.027397260274
49	Zamora	110	49110	Manzanal de Arriba	460	231	229	50.2173913043478	49.7826086956522
49	Zamora	111	49111	Manzanal del Barco	200	105	95	52.5	47.5
49	Zamora	112	49112	Manzanal de los Infantes	194	102	92	52.5773195876289	47.4226804123711
49	Zamora	113	49113	Matilla de Arzón	261	142	119	54.4061302681992	45.5938697318008
49	Zamora	114	49114	Matilla la Seca	70	34	36	48.5714285714286	51.4285714285714
49	Zamora	115	49115	Mayalde	245	121	124	49.3877551020408	50.6122448979592
49	Zamora	116	49116	Melgar de Tera	595	290	305	48.7394957983193	51.2605042016807
49	Zamora	117	49117	Micereces de Tera	649	332	317	51.15562403698	48.84437596302
49	Zamora	118	49118	Milles de la Polvorosa	279	139	140	49.820788530466	50.179211469534
49	Zamora	119	49119	Molacillos	307	161	146	52.442996742671	47.557003257329
49	Zamora	120	49120	Molezuelas de la Carballeda	118	60	58	50.8474576271186	49.1525423728814
49	Zamora	121	49121	Mombuey	476	234	242	49.1596638655462	50.8403361344538
49	Zamora	122	49122	Monfarracinos	588	317	271	53.9115646258503	46.0884353741497
49	Zamora	123	49123	Montamarta	685	333	352	48.6131386861314	51.3868613138686
49	Zamora	124	49124	Moral de Sayago	386	208	178	53.8860103626943	46.1139896373057
49	Zamora	125	49125	Moraleja del Vino	1259	664	595	52.7402700555997	47.2597299444003
49	Zamora	126	49126	Moraleja de Sayago	297	158	139	53.1986531986532	46.8013468013468
49	Zamora	127	49127	Morales del Vino	1634	840	794	51.4075887392901	48.5924112607099
49	Zamora	128	49128	Morales de Rey	760	365	395	48.0263157894737	51.9736842105263
49	Zamora	129	49129	Morales de Toro	1082	541	541	50	50
49	Zamora	130	49130	Morales de Valverde	302	142	160	47.0198675496689	52.9801324503311
49	Zamora	131	49131	Moralina	378	193	185	51.0582010582011	48.9417989417989
49	Zamora	132	49132	Moreruela de los Infanzones	480	252	228	52.5	47.5
49	Zamora	133	49133	Moreruela de Tábara	531	279	252	52.5423728813559	47.4576271186441
49	Zamora	134	49134	Muelas de los Caballeros	255	135	120	52.9411764705882	47.0588235294118
49	Zamora	135	49135	Muelas del Pan	922	455	467	49.3492407809111	50.6507592190889
49	Zamora	136	49136	Muga de Sayago	504	244	260	48.4126984126984	51.5873015873016
49	Zamora	137	49137	Navianos de Valverde	258	139	119	53.8759689922481	46.1240310077519
49	Zamora	138	49138	Olmillos de Castro	427	223	204	52.2248243559719	47.7751756440281
49	Zamora	139	49139	Otero de Bodas	283	154	129	54.416961130742	45.583038869258
49	Zamora	141	49141	Pajares de la Lampreana	500	252	248	50.4	49.6
49	Zamora	142	49142	Palacios del Pan	248	109	139	43.9516129032258	56.0483870967742
49	Zamora	143	49143	Palacios de Sanabria	356	171	185	48.0337078651685	51.9662921348315
49	Zamora	145	49145	Pedralba de la Pradería	305	143	162	46.8852459016394	53.1147540983607
49	Zamora	146	49146	Pego (El)	456	232	224	50.8771929824562	49.1228070175439
49	Zamora	147	49147	Peleagonzalo	446	228	218	51.1210762331839	48.8789237668162
49	Zamora	148	49148	Peleas de Abajo	265	120	145	45.2830188679245	54.7169811320755
49	Zamora	149	49149	Peñausende	576	291	285	50.5208333333333	49.4791666666667
49	Zamora	150	49150	Peque	218	108	110	49.5412844036697	50.4587155963303
49	Zamora	151	49151	Perdigón (El)	773	396	377	51.228978007762	48.771021992238
49	Zamora	152	49152	Pereruela	741	372	369	50.2024291497976	49.7975708502024
49	Zamora	153	49153	Perilla de Castro	264	132	132	50	50
49	Zamora	154	49154	Pías	237	118	119	49.789029535865	50.210970464135
49	Zamora	155	49155	Piedrahita de Castro	150	82	68	54.6666666666667	45.3333333333333
49	Zamora	156	49156	Pinilla de Toro	381	187	194	49.0813648293963	50.9186351706037
49	Zamora	157	49157	Pino	247	134	113	54.251012145749	45.748987854251
49	Zamora	158	49158	Piñero (El)	312	165	147	52.8846153846154	47.1153846153846
49	Zamora	159	49159	Pobladura del Valle	334	165	169	49.4011976047904	50.5988023952096
49	Zamora	160	49160	Pobladura de Valderaduey	80	37	43	46.25	53.75
49	Zamora	162	49162	Porto	338	180	158	53.2544378698225	46.7455621301775
49	Zamora	163	49163	Pozoantiguo	333	169	164	50.7507507507508	49.2492492492493
49	Zamora	164	49164	Pozuelo de Tábara	246	121	125	49.1869918699187	50.8130081300813
49	Zamora	165	49165	Prado	103	52	51	50.4854368932039	49.5145631067961
49	Zamora	166	49166	Puebla de Sanabria	1645	787	858	47.8419452887538	52.1580547112462
49	Zamora	167	49167	Pueblica de Valverde	324	163	161	50.3086419753087	49.6913580246914
49	Zamora	168	49168	Quintanilla del Monte	151	68	83	45.0331125827815	54.9668874172185
49	Zamora	169	49169	Quintanilla del Olmo	62	29	33	46.7741935483871	53.2258064516129
49	Zamora	170	49170	Quintanilla de Urz	153	79	74	51.6339869281046	48.3660130718954
49	Zamora	171	49171	Quiruelas de Vidriales	981	463	518	47.1967380224261	52.8032619775739
49	Zamora	172	49172	Rabanales	847	436	411	51.4757969303424	48.5242030696576
49	Zamora	173	49173	Rábano de Aliste	480	242	238	50.4166666666667	49.5833333333333
49	Zamora	174	49174	Requejo	213	94	119	44.131455399061	55.868544600939
49	Zamora	175	49175	Revellinos	342	186	156	54.3859649122807	45.6140350877193
49	Zamora	176	49176	Riofrío de Aliste	1088	568	520	52.2058823529412	47.7941176470588
49	Zamora	177	49177	Rionegro del Puente	402	197	205	49.0049751243781	50.9950248756219
49	Zamora	178	49178	Roales	392	201	191	51.2755102040816	48.7244897959184
49	Zamora	179	49179	Robleda-Cervantes	447	213	234	47.6510067114094	52.3489932885906
49	Zamora	180	49180	Roelos de Sayago	164	87	77	53.0487804878049	46.9512195121951
49	Zamora	181	49181	Rosinos de la Requejada	528	256	272	48.4848484848485	51.5151515151515
49	Zamora	183	49183	Salce	149	79	70	53.0201342281879	46.9798657718121
49	Zamora	184	49184	Samir de los Caños	234	122	112	52.1367521367522	47.8632478632479
49	Zamora	185	49185	San Agustín del Pozo	211	112	99	53.0805687203791	46.9194312796209
49	Zamora	186	49186	San Cebrián de Castro	379	178	201	46.9656992084433	53.0343007915567
49	Zamora	187	49187	San Cristóbal de Entreviñas	1633	825	808	50.520514390692	49.479485609308
49	Zamora	188	49188	San Esteban del Molar	183	101	82	55.1912568306011	44.8087431693989
49	Zamora	189	49189	San Justo	370	179	191	48.3783783783784	51.6216216216216
49	Zamora	190	49190	San Martín de Valderaduey	98	48	50	48.9795918367347	51.0204081632653
49	Zamora	191	49191	San Miguel de la Ribera	402	200	202	49.7512437810945	50.2487562189055
49	Zamora	192	49192	San Miguel del Valle	225	105	120	46.6666666666667	53.3333333333333
49	Zamora	193	49193	San Pedro de Ceque	703	344	359	48.9331436699858	51.0668563300142
49	Zamora	194	49194	San Pedro de la Nave-Almendra	530	259	271	48.8679245283019	51.1320754716981
49	Zamora	197	49197	Santa Clara de Avedillo	261	128	133	49.0421455938697	50.9578544061303
49	Zamora	199	49199	Santa Colomba de las Monjas	331	168	163	50.7552870090635	49.2447129909366
49	Zamora	200	49200	Santa Cristina de la Polvorosa	1279	661	618	51.6810007818608	48.3189992181392
49	Zamora	201	49201	Santa Croya de Tera	484	242	242	50	50
49	Zamora	202	49202	Santa Eufemia del Barco	297	165	132	55.5555555555556	44.4444444444444
49	Zamora	203	49203	Santa María de la Vega	503	262	241	52.0874751491054	47.9125248508946
49	Zamora	204	49204	Santa María de Valverde	99	45	54	45.4545454545455	54.5454545454545
49	Zamora	205	49205	Santibáñez de Tera	605	298	307	49.2561983471074	50.7438016528926
49	Zamora	206	49206	Santibáñez de Vidriales	1404	695	709	49.5014245014245	50.4985754985755
49	Zamora	207	49207	Santovenia	431	205	226	47.5638051044084	52.4361948955916
49	Zamora	208	49208	San Vicente de la Cabeza	628	326	302	51.9108280254777	48.0891719745223
49	Zamora	209	49209	San Vitero	727	380	347	52.2696011004127	47.7303988995873
49	Zamora	210	49210	Sanzoles	707	364	343	51.4851485148515	48.5148514851485
49	Zamora	214	49214	Tábara	964	493	471	51.1410788381743	48.8589211618257
49	Zamora	216	49216	Tapioles	247	132	115	53.4412955465587	46.5587044534413
49	Zamora	219	49219	Toro	9325	4524	4801	48.514745308311	51.485254691689
49	Zamora	220	49220	Torre del Valle (La)	192	105	87	54.6875	45.3125
49	Zamora	221	49221	Torregamones	331	162	169	48.9425981873112	51.0574018126888
49	Zamora	222	49222	Torres del Carrizal	521	270	251	51.8234165067179	48.1765834932822
49	Zamora	223	49223	Trabazos	949	474	475	49.9473129610116	50.0526870389884
49	Zamora	224	49224	Trefacio	240	118	122	49.1666666666667	50.8333333333333
49	Zamora	225	49225	Uña de Quintana	231	112	119	48.4848484848485	51.5151515151515
49	Zamora	226	49226	Vadillo de la Guareña	378	198	180	52.3809523809524	47.6190476190476
49	Zamora	227	49227	Valcabado	360	180	180	50	50
49	Zamora	228	49228	Valdefinjas	103	59	44	57.2815533980583	42.7184466019417
49	Zamora	229	49229	Valdescorriel	198	105	93	53.030303030303	46.969696969697
49	Zamora	230	49230	Vallesa de la Guareña	183	100	83	54.6448087431694	45.3551912568306
49	Zamora	231	49231	Vega de Tera	523	249	274	47.6099426386233	52.3900573613767
49	Zamora	232	49232	Vega de Villalobos	160	70	90	43.75	56.25
49	Zamora	233	49233	Vegalatrave	150	77	73	51.3333333333333	48.6666666666667
49	Zamora	234	49234	Venialbo	544	283	261	52.0220588235294	47.9779411764706
49	Zamora	235	49235	Vezdemarbán	700	341	359	48.7142857142857	51.2857142857143
49	Zamora	236	49236	Vidayanes	116	56	60	48.2758620689655	51.7241379310345
49	Zamora	237	49237	Videmala	205	98	107	47.8048780487805	52.1951219512195
49	Zamora	238	49238	Villabrázaro	378	186	192	49.2063492063492	50.7936507936508
49	Zamora	239	49239	Villabuena del Puente	987	521	466	52.7862208713273	47.2137791286727
49	Zamora	240	49240	Villadepera	278	133	145	47.841726618705	52.158273381295
49	Zamora	241	49241	Villaescusa	379	193	186	50.9234828496042	49.0765171503958
49	Zamora	242	49242	Villafáfila	673	334	339	49.62852897474	50.37147102526
49	Zamora	243	49243	Villaferrueña	159	81	78	50.9433962264151	49.0566037735849
49	Zamora	244	49244	Villageriz	72	39	33	54.1666666666667	45.8333333333333
49	Zamora	245	49245	Villalazán	394	192	202	48.7309644670051	51.2690355329949
49	Zamora	246	49246	Villalba de la Lampreana	323	168	155	52.0123839009288	47.9876160990712
49	Zamora	247	49247	Villalcampo	677	339	338	50.0738552437223	49.9261447562777
49	Zamora	248	49248	Villalobos	318	148	170	46.5408805031447	53.4591194968554
49	Zamora	249	49249	Villalonso	127	64	63	50.3937007874016	49.6062992125984
49	Zamora	250	49250	Villalpando	1731	855	876	49.3934142114385	50.6065857885615
49	Zamora	251	49251	Villalube	318	159	159	50	50
49	Zamora	252	49252	Villamayor de Campos	557	284	273	50.9874326750449	49.0125673249551
49	Zamora	255	49255	Villamor de los Escuderos	587	296	291	50.4258943781942	49.5741056218058
49	Zamora	256	49256	Villanázar	382	182	200	47.6439790575916	52.3560209424084
49	Zamora	257	49257	Villanueva de Azoague	368	188	180	51.0869565217391	48.9130434782609
49	Zamora	258	49258	Villanueva de Campeán	189	94	95	49.7354497354497	50.2645502645503
49	Zamora	259	49259	Villanueva de las Peras	191	95	96	49.738219895288	50.261780104712
49	Zamora	260	49260	Villanueva del Campo	1085	540	545	49.7695852534562	50.2304147465438
49	Zamora	261	49261	Villaralbo	1617	813	804	50.278293135436	49.721706864564
49	Zamora	262	49262	Villardeciervos	514	240	274	46.692607003891	53.307392996109
49	Zamora	263	49263	Villar de Fallaves	108	56	52	51.8518518518519	48.1481481481482
49	Zamora	264	49264	Villar del Buey	864	462	402	53.4722222222222	46.5277777777778
49	Zamora	265	49265	Villardiegua de la Ribera	177	86	91	48.5875706214689	51.4124293785311
49	Zamora	266	49266	Villárdiga	110	57	53	51.8181818181818	48.1818181818182
49	Zamora	267	49267	Villardondiego	131	70	61	53.4351145038168	46.5648854961832
49	Zamora	268	49268	Villarrín de Campos	651	343	308	52.6881720430108	47.3118279569893
49	Zamora	269	49269	Villaseco del Pan	324	156	168	48.1481481481482	51.8518518518519
49	Zamora	270	49270	Villavendimio	203	114	89	56.1576354679803	43.8423645320197
49	Zamora	271	49271	Villaveza del Agua	280	146	134	52.1428571428571	47.8571428571429
49	Zamora	272	49272	Villaveza de Valverde	148	76	72	51.3513513513514	48.6486486486487
49	Zamora	273	49273	Viñas	293	146	147	49.8293515358362	50.1706484641638
49	Zamora	275	49275	Zamora	65226	30954	34272	47.4565357372827	52.5434642627173
50	Zaragoza	001	50001	Abanto	184	100	84	54.3478260869565	45.6521739130435
50	Zaragoza	002	50002	Acered	271	138	133	50.9225092250922	49.0774907749078
50	Zaragoza	003	50003	Agón	182	99	83	54.3956043956044	45.6043956043956
50	Zaragoza	004	50004	Aguarón	751	372	379	49.5339547270306	50.4660452729694
50	Zaragoza	005	50005	Aguilón	276	133	143	48.1884057971014	51.8115942028985
50	Zaragoza	006	50006	Ainzón	1228	634	594	51.628664495114	48.371335504886
50	Zaragoza	007	50007	Aladrén	77	43	34	55.8441558441558	44.1558441558442
50	Zaragoza	008	50008	Alagón	5621	2807	2814	49.9377334993773	50.0622665006227
50	Zaragoza	009	50009	Alarba	158	88	70	55.6962025316456	44.3037974683544
50	Zaragoza	010	50010	Alberite de San Juan	97	55	42	56.701030927835	43.298969072165
50	Zaragoza	011	50011	Albeta	119	58	61	48.7394957983193	51.2605042016807
50	Zaragoza	012	50012	Alborge	141	73	68	51.7730496453901	48.2269503546099
50	Zaragoza	013	50013	Alcalá de Ebro	296	139	157	46.9594594594595	53.0405405405405
50	Zaragoza	014	50014	Alcalá de Moncayo	147	77	70	52.3809523809524	47.6190476190476
50	Zaragoza	015	50015	Alconchel de Ariza	162	87	75	53.7037037037037	46.2962962962963
50	Zaragoza	016	50016	Aldehuela de Liestos	58	30	28	51.7241379310345	48.2758620689655
50	Zaragoza	017	50017	Alfajarín	1495	759	736	50.7692307692308	49.2307692307692
50	Zaragoza	018	50018	Alfamén	1315	699	616	53.1558935361217	46.8441064638783
50	Zaragoza	019	50019	Alforque	88	48	40	54.5454545454545	45.4545454545455
50	Zaragoza	020	50020	Alhama de Aragón	1178	568	610	48.2173174872666	51.7826825127334
50	Zaragoza	021	50021	Almochuel	50	27	23	54	46
50	Zaragoza	022	50022	Almolda (La)	691	346	345	50.0723589001447	49.9276410998553
50	Zaragoza	023	50023	Almonacid de la Cuba	339	168	171	49.5575221238938	50.4424778761062
50	Zaragoza	024	50024	Almonacid de la Sierra	859	448	411	52.1536670547148	47.8463329452852
50	Zaragoza	025	50025	Almunia de Doña Godina (La)	5591	2856	2735	51.0820962260776	48.9179037739224
50	Zaragoza	026	50026	Alpartir	603	323	280	53.5655058043118	46.4344941956882
50	Zaragoza	027	50027	Ambel	357	161	196	45.0980392156863	54.9019607843137
50	Zaragoza	028	50028	Anento	107	66	41	61.6822429906542	38.3177570093458
50	Zaragoza	029	50029	Aniñón	907	479	428	52.8114663726571	47.1885336273429
50	Zaragoza	030	50030	Añón de Moncayo	304	177	127	58.2236842105263	41.7763157894737
50	Zaragoza	031	50031	Aranda de Moncayo	247	133	114	53.8461538461539	46.1538461538462
50	Zaragoza	032	50032	Arándiga	503	258	245	51.2922465208747	48.7077534791253
50	Zaragoza	033	50033	Ardisa	79	44	35	55.6962025316456	44.3037974683544
50	Zaragoza	034	50034	Ariza	1334	683	651	51.1994002998501	48.8005997001499
50	Zaragoza	035	50035	Artieda	100	57	43	57	43
50	Zaragoza	036	50036	Asín	101	51	50	50.4950495049505	49.5049504950495
50	Zaragoza	037	50037	Atea	239	134	105	56.0669456066946	43.9330543933054
50	Zaragoza	038	50038	Ateca	1986	972	1014	48.9425981873112	51.0574018126888
50	Zaragoza	039	50039	Azuara	716	381	335	53.2122905027933	46.7877094972067
50	Zaragoza	040	50040	Badules	121	66	55	54.5454545454545	45.4545454545455
50	Zaragoza	041	50041	Bagüés	46	24	22	52.1739130434783	47.8260869565217
50	Zaragoza	042	50042	Balconchán	26	13	13	50	50
50	Zaragoza	043	50043	Bárboles	326	172	154	52.760736196319	47.239263803681
50	Zaragoza	044	50044	Bardallur	297	143	154	48.1481481481482	51.8518518518519
50	Zaragoza	045	50045	Belchite	1643	862	781	52.4650030432136	47.5349969567864
50	Zaragoza	046	50046	Belmonte de Gracián	282	151	131	53.5460992907801	46.4539007092199
50	Zaragoza	047	50047	Berdejo	49	26	23	53.0612244897959	46.9387755102041
50	Zaragoza	048	50048	Berrueco	39	22	17	56.4102564102564	43.5897435897436
50	Zaragoza	050	50050	Bijuesca	129	73	56	56.5891472868217	43.4108527131783
50	Zaragoza	051	50051	Biota	1222	625	597	51.1456628477905	48.8543371522095
50	Zaragoza	052	50052	Bisimbre	128	57	71	44.53125	55.46875
50	Zaragoza	053	50053	Boquiñeni	992	499	493	50.3024193548387	49.6975806451613
50	Zaragoza	054	50054	Bordalba	100	58	42	58	42
50	Zaragoza	055	50055	Borja	4256	2079	2177	48.8486842105263	51.1513157894737
50	Zaragoza	056	50056	Botorrita	489	261	228	53.3742331288344	46.6257668711656
50	Zaragoza	057	50057	Brea de Aragón	2009	997	1012	49.6266799402688	50.3733200597312
50	Zaragoza	058	50058	Bubierca	108	53	55	49.0740740740741	50.9259259259259
50	Zaragoza	059	50059	Bujaraloz	986	521	465	52.8397565922921	47.1602434077079
50	Zaragoza	060	50060	Bulbuente	263	146	117	55.5133079847909	44.4866920152091
50	Zaragoza	061	50061	Bureta	320	159	161	49.6875	50.3125
50	Zaragoza	062	50062	Burgo de Ebro (El)	1550	792	758	51.0967741935484	48.9032258064516
50	Zaragoza	063	50063	Buste (El)	111	56	55	50.4504504504505	49.5495495495496
50	Zaragoza	064	50064	Cabañas de Ebro	550	285	265	51.8181818181818	48.1818181818182
50	Zaragoza	065	50065	Cabolafuente	87	50	37	57.4712643678161	42.5287356321839
50	Zaragoza	066	50066	Cadrete	1679	895	784	53.3055390113163	46.6944609886837
50	Zaragoza	067	50067	Calatayud	17876	8623	9253	48.2378608189752	51.7621391810248
50	Zaragoza	068	50068	Calatorao	2725	1413	1312	51.8532110091743	48.1467889908257
50	Zaragoza	069	50069	Calcena	90	48	42	53.3333333333333	46.6666666666667
50	Zaragoza	070	50070	Calmarza	98	50	48	51.0204081632653	48.9795918367347
50	Zaragoza	071	50071	Campillo de Aragón	183	102	81	55.7377049180328	44.2622950819672
50	Zaragoza	072	50072	Carenas	220	112	108	50.9090909090909	49.0909090909091
50	Zaragoza	073	50073	Cariñena	2875	1477	1398	51.3739130434783	48.6260869565217
50	Zaragoza	074	50074	Caspe	7727	3782	3945	48.9452568914197	51.0547431085803
50	Zaragoza	075	50075	Castejón de Alarba	116	64	52	55.1724137931034	44.8275862068966
50	Zaragoza	076	50076	Castejón de las Armas	135	66	69	48.8888888888889	51.1111111111111
50	Zaragoza	077	50077	Castejón de Valdejasa	336	174	162	51.7857142857143	48.2142857142857
50	Zaragoza	078	50078	Castiliscar	408	211	197	51.7156862745098	48.2843137254902
50	Zaragoza	079	50079	Cervera de la Cañada	341	167	174	48.9736070381232	51.0263929618768
50	Zaragoza	080	50080	Cerveruela	14	12	2	85.7142857142857	14.2857142857143
50	Zaragoza	081	50081	Cetina	730	359	371	49.1780821917808	50.8219178082192
50	Zaragoza	082	50082	Cimballa	165	82	83	49.6969696969697	50.3030303030303
50	Zaragoza	083	50083	Cinco Olivas	137	67	70	48.9051094890511	51.0948905109489
50	Zaragoza	084	50084	Clarés de Ribota	107	56	51	52.3364485981308	47.6635514018692
50	Zaragoza	085	50085	Codo	278	136	142	48.9208633093525	51.0791366906475
50	Zaragoza	086	50086	Codos	283	164	119	57.9505300353357	42.0494699646643
50	Zaragoza	087	50087	Contamina	59	32	27	54.2372881355932	45.7627118644068
50	Zaragoza	088	50088	Cosuenda	415	219	196	52.7710843373494	47.2289156626506
50	Zaragoza	089	50089	Cuarte de Huerva	1847	958	889	51.8678938819708	48.1321061180292
50	Zaragoza	090	50090	Cubel	237	116	121	48.9451476793249	51.0548523206751
50	Zaragoza	091	50091	Cuerlas (Las)	97	48	49	49.4845360824742	50.5154639175258
50	Zaragoza	092	50092	Chiprana	377	186	191	49.3368700265252	50.6631299734748
50	Zaragoza	093	50093	Chodes	121	58	63	47.9338842975207	52.0661157024794
50	Zaragoza	094	50094	Daroca	2286	1148	1138	50.2187226596675	49.7812773403325
50	Zaragoza	095	50095	Ejea de los Caballeros	15532	7895	7637	50.8305433942828	49.1694566057172
50	Zaragoza	096	50096	Embid de Ariza	70	36	34	51.4285714285714	48.5714285714286
50	Zaragoza	098	50098	Encinacorba	304	163	141	53.6184210526316	46.3815789473684
50	Zaragoza	099	50099	Épila	3971	2043	1928	51.4479979853941	48.5520020146059
50	Zaragoza	100	50100	Erla	466	223	243	47.8540772532189	52.1459227467811
50	Zaragoza	101	50101	Escatrón	1282	626	656	48.8299531981279	51.1700468018721
50	Zaragoza	102	50102	Fabara	1218	637	581	52.2988505747126	47.7011494252874
50	Zaragoza	104	50104	Farlete	461	232	229	50.3253796095445	49.6746203904555
50	Zaragoza	105	50105	Fayón	385	204	181	52.987012987013	47.012987012987
50	Zaragoza	106	50106	Fayos (Los)	191	101	90	52.8795811518325	47.1204188481675
50	Zaragoza	107	50107	Figueruelas	1011	511	500	50.5440158259149	49.4559841740851
50	Zaragoza	108	50108	Fombuena	19	13	6	68.421052631579	31.5789473684211
50	Zaragoza	109	50109	Frago (El)	122	75	47	61.4754098360656	38.5245901639344
50	Zaragoza	110	50110	Frasno (El)	561	299	262	53.2976827094474	46.7023172905526
50	Zaragoza	111	50111	Fréscano	252	123	129	48.8095238095238	51.1904761904762
50	Zaragoza	113	50113	Fuendejalón	872	437	435	50.1146788990826	49.8853211009174
50	Zaragoza	114	50114	Fuendetodos	199	100	99	50.251256281407	49.748743718593
50	Zaragoza	115	50115	Fuentes de Ebro	3848	1989	1859	51.6891891891892	48.3108108108108
50	Zaragoza	116	50116	Fuentes de Jiloca	353	187	166	52.9745042492918	47.0254957507082
50	Zaragoza	117	50117	Gallocanta	167	86	81	51.497005988024	48.502994011976
50	Zaragoza	118	50118	Gallur	2921	1483	1438	50.770284149264	49.2297158507361
50	Zaragoza	119	50119	Gelsa	1253	632	621	50.438946528332	49.561053471668
50	Zaragoza	120	50120	Godojos	68	33	35	48.5294117647059	51.4705882352941
50	Zaragoza	121	50121	Gotor	380	204	176	53.6842105263158	46.3157894736842
50	Zaragoza	122	50122	Grisel	70	41	29	58.5714285714286	41.4285714285714
50	Zaragoza	123	50123	Grisén	479	243	236	50.7306889352818	49.2693110647182
50	Zaragoza	124	50124	Herrera de los Navarros	616	324	292	52.5974025974026	47.4025974025974
50	Zaragoza	125	50125	Ibdes	558	285	273	51.0752688172043	48.9247311827957
50	Zaragoza	126	50126	Illueca	3295	1614	1681	48.9833080424886	51.0166919575114
50	Zaragoza	128	50128	Isuerre	62	38	24	61.2903225806452	38.7096774193548
50	Zaragoza	129	50129	Jaraba	321	173	148	53.8940809968847	46.1059190031153
50	Zaragoza	130	50130	Jarque	583	314	269	53.8593481989708	46.1406518010292
50	Zaragoza	131	50131	Jaulín	300	154	146	51.3333333333333	48.6666666666667
50	Zaragoza	132	50132	Joyosa (La)	382	200	182	52.3560209424084	47.6439790575916
50	Zaragoza	133	50133	Lagata	140	77	63	55	45
50	Zaragoza	134	50134	Langa del Castillo	197	91	106	46.1928934010152	53.8071065989848
50	Zaragoza	135	50135	Layana	139	68	71	48.9208633093525	51.0791366906475
50	Zaragoza	136	50136	Lécera	837	405	432	48.3870967741936	51.6129032258065
50	Zaragoza	137	50137	Leciñena	1367	686	681	50.1828822238478	49.8171177761522
50	Zaragoza	138	50138	Lechón	53	32	21	60.377358490566	39.622641509434
50	Zaragoza	139	50139	Letux	478	242	236	50.6276150627615	49.3723849372385
50	Zaragoza	140	50140	Litago	182	100	82	54.9450549450549	45.0549450549451
50	Zaragoza	141	50141	Lituénigo	118	57	61	48.3050847457627	51.6949152542373
50	Zaragoza	142	50142	Lobera de Onsella	54	32	22	59.2592592592593	40.7407407407407
50	Zaragoza	143	50143	Longares	915	501	414	54.7540983606557	45.2459016393443
50	Zaragoza	144	50144	Longás	52	32	20	61.5384615384615	38.4615384615385
50	Zaragoza	146	50146	Lucena de Jalón	251	127	124	50.597609561753	49.402390438247
50	Zaragoza	147	50147	Luceni	1056	524	532	49.6212121212121	50.3787878787879
50	Zaragoza	148	50148	Luesia	443	230	213	51.9187358916479	48.0812641083521
50	Zaragoza	149	50149	Luesma	23	13	10	56.5217391304348	43.4782608695652
50	Zaragoza	150	50150	Lumpiaque	917	475	442	51.7993456924755	48.2006543075245
50	Zaragoza	151	50151	Luna	928	489	439	52.6939655172414	47.3060344827586
50	Zaragoza	152	50152	Maella	1996	1003	993	50.250501002004	49.749498997996
50	Zaragoza	153	50153	Magallón	1201	650	551	54.1215653621982	45.8784346378018
50	Zaragoza	154	50154	Mainar	183	101	82	55.1912568306011	44.8087431693989
50	Zaragoza	155	50155	Malanquilla	126	65	61	51.5873015873016	48.4126984126984
50	Zaragoza	156	50156	Maleján	296	152	144	51.3513513513514	48.6486486486487
50	Zaragoza	157	50157	Malón	455	234	221	51.4285714285714	48.5714285714286
50	Zaragoza	159	50159	Maluenda	973	469	504	48.2014388489209	51.7985611510791
50	Zaragoza	160	50160	Mallén	2983	1527	1456	51.190077103587	48.809922896413
50	Zaragoza	161	50161	Manchones	153	75	78	49.0196078431373	50.9803921568627
50	Zaragoza	162	50162	Mara	205	103	102	50.2439024390244	49.7560975609756
50	Zaragoza	163	50163	María de Huerva	1121	559	562	49.8661909009813	50.1338090990187
50	Zaragoza	164	50164	Mediana de Aragón	514	258	256	50.1945525291829	49.8054474708171
50	Zaragoza	165	50165	Mequinenza	2478	1235	1243	49.8385794995965	50.1614205004036
50	Zaragoza	166	50166	Mesones de Isuela	374	183	191	48.9304812834225	51.0695187165775
50	Zaragoza	167	50167	Mezalocha	319	178	141	55.7993730407524	44.2006269592476
50	Zaragoza	168	50168	Mianos	45	24	21	53.3333333333333	46.6666666666667
50	Zaragoza	169	50169	Miedes de Aragón	512	268	244	52.34375	47.65625
50	Zaragoza	170	50170	Monegrillo	534	290	244	54.3071161048689	45.6928838951311
50	Zaragoza	171	50171	Moneva	145	71	74	48.9655172413793	51.0344827586207
50	Zaragoza	172	50172	Monreal de Ariza	299	155	144	51.8394648829431	48.1605351170569
50	Zaragoza	173	50173	Monterde	264	136	128	51.5151515151515	48.4848484848485
50	Zaragoza	174	50174	Montón	140	72	68	51.4285714285714	48.5714285714286
50	Zaragoza	175	50175	Morata de Jalón	1540	764	776	49.6103896103896	50.3896103896104
50	Zaragoza	176	50176	Morata de Jiloca	330	175	155	53.030303030303	46.969696969697
50	Zaragoza	177	50177	Morés	487	256	231	52.5667351129364	47.4332648870637
50	Zaragoza	178	50178	Moros	510	251	259	49.2156862745098	50.7843137254902
50	Zaragoza	179	50179	Moyuela	353	184	169	52.1246458923513	47.8753541076487
50	Zaragoza	180	50180	Mozota	114	57	57	50	50
50	Zaragoza	181	50181	Muel	1123	562	561	50.0445235975067	49.9554764024933
50	Zaragoza	182	50182	Muela (La)	1351	708	643	52.4056254626203	47.5943745373797
50	Zaragoza	183	50183	Munébrega	463	243	220	52.4838012958963	47.5161987041037
50	Zaragoza	184	50184	Murero	149	85	64	57.0469798657718	42.9530201342282
50	Zaragoza	185	50185	Murillo de Gállego	133	79	54	59.3984962406015	40.6015037593985
50	Zaragoza	186	50186	Navardún	62	32	30	51.6129032258065	48.3870967741936
50	Zaragoza	187	50187	Nigüella	122	67	55	54.9180327868853	45.0819672131148
50	Zaragoza	188	50188	Nombrevilla	66	39	27	59.0909090909091	40.9090909090909
50	Zaragoza	189	50189	Nonaspe	1080	547	533	50.6481481481482	49.3518518518519
50	Zaragoza	190	50190	Novallas	731	357	374	48.8372093023256	51.1627906976744
50	Zaragoza	191	50191	Novillas	670	343	327	51.1940298507463	48.8059701492537
50	Zaragoza	192	50192	Nuévalos	344	197	147	57.2674418604651	42.7325581395349
50	Zaragoza	193	50193	Nuez de Ebro	592	313	279	52.8716216216216	47.1283783783784
50	Zaragoza	194	50194	Olvés	169	90	79	53.2544378698225	46.7455621301775
50	Zaragoza	195	50195	Orcajo	47	24	23	51.063829787234	48.936170212766
50	Zaragoza	196	50196	Orera	126	63	63	50	50
50	Zaragoza	197	50197	Orés	101	60	41	59.4059405940594	40.5940594059406
50	Zaragoza	198	50198	Oseja	50	29	21	58	42
50	Zaragoza	199	50199	Osera de Ebro	354	170	184	48.0225988700565	51.9774011299435
50	Zaragoza	200	50200	Paniza	697	351	346	50.3586800573888	49.6413199426112
50	Zaragoza	201	50201	Paracuellos de Jiloca	500	230	270	46	54
50	Zaragoza	202	50202	Paracuellos de la Ribera	291	134	157	46.0481099656357	53.9518900343643
50	Zaragoza	203	50203	Pastriz	1043	511	532	48.993288590604	51.006711409396
50	Zaragoza	204	50204	Pedrola	2637	1340	1297	50.8153204398938	49.1846795601062
50	Zaragoza	205	50205	Pedrosas (Las)	96	47	49	48.9583333333333	51.0416666666667
50	Zaragoza	206	50206	Perdiguera	508	261	247	51.3779527559055	48.6220472440945
50	Zaragoza	207	50207	Piedratajada	133	67	66	50.3759398496241	49.6240601503759
50	Zaragoza	208	50208	Pina de Ebro	2239	1112	1127	49.6650290308173	50.3349709691827
50	Zaragoza	209	50209	Pinseque	1606	805	801	50.1245330012453	49.8754669987547
50	Zaragoza	210	50210	Pintanos (Los)	89	45	44	50.561797752809	49.438202247191
50	Zaragoza	211	50211	Plasencia de Jalón	366	198	168	54.0983606557377	45.9016393442623
50	Zaragoza	212	50212	Pleitas	61	37	24	60.655737704918	39.344262295082
50	Zaragoza	213	50213	Plenas	137	68	69	49.6350364963504	50.3649635036496
50	Zaragoza	214	50214	Pomer	27	18	9	66.6666666666667	33.3333333333333
50	Zaragoza	215	50215	Pozuel de Ariza	24	16	8	66.6666666666667	33.3333333333333
50	Zaragoza	216	50216	Pozuelo de Aragón	339	186	153	54.8672566371681	45.1327433628319
50	Zaragoza	217	50217	Pradilla de Ebro	647	338	309	52.241112828439	47.7588871715611
50	Zaragoza	218	50218	Puebla de Albortón	148	80	68	54.0540540540541	45.945945945946
50	Zaragoza	219	50219	Puebla de Alfindén (La)	1907	974	933	51.0749868904038	48.9250131095962
50	Zaragoza	220	50220	Puendeluna	60	35	25	58.3333333333333	41.6666666666667
50	Zaragoza	221	50221	Purujosa	40	30	10	75	25
50	Zaragoza	222	50222	Quinto	2110	1054	1056	49.9526066350711	50.0473933649289
50	Zaragoza	223	50223	Remolinos	1244	620	624	49.8392282958199	50.1607717041801
50	Zaragoza	224	50224	Retascón	78	44	34	56.4102564102564	43.5897435897436
50	Zaragoza	225	50225	Ricla	2083	1120	963	53.7686029764762	46.2313970235238
50	Zaragoza	227	50227	Romanos	143	81	62	56.6433566433567	43.3566433566434
50	Zaragoza	228	50228	Rueda de Jalón	353	181	172	51.2747875354108	48.7252124645892
50	Zaragoza	229	50229	Ruesca	89	46	43	51.685393258427	48.314606741573
50	Zaragoza	230	50230	Sádaba	1666	835	831	50.1200480192077	49.8799519807923
50	Zaragoza	231	50231	Salillas de Jalón	352	186	166	52.8409090909091	47.1590909090909
50	Zaragoza	232	50232	Salvatierra de Esca	278	142	136	51.0791366906475	48.9208633093525
50	Zaragoza	233	50233	Samper del Salz	142	73	69	51.4084507042254	48.5915492957747
50	Zaragoza	234	50234	San Martín de la Virgen de Moncayo	305	161	144	52.7868852459016	47.2131147540984
50	Zaragoza	235	50235	San Mateo de Gállego	2137	1096	1041	51.2868507253159	48.7131492746841
50	Zaragoza	236	50236	Santa Cruz de Grío	232	128	104	55.1724137931034	44.8275862068966
50	Zaragoza	237	50237	Santa Cruz de Moncayo	121	58	63	47.9338842975207	52.0661157024794
50	Zaragoza	238	50238	Santa Eulalia de Gállego	127	61	66	48.0314960629921	51.9685039370079
50	Zaragoza	239	50239	Santed	80	38	42	47.5	52.5
50	Zaragoza	240	50240	Sástago	1444	726	718	50.2770083102493	49.7229916897507
50	Zaragoza	241	50241	Sabiñán	931	450	481	48.3351235230935	51.6648764769066
50	Zaragoza	242	50242	Sediles	102	52	50	50.9803921568627	49.0196078431373
50	Zaragoza	243	50243	Sestrica	478	243	235	50.836820083682	49.163179916318
50	Zaragoza	244	50244	Sierra de Luna	250	127	123	50.8	49.2
50	Zaragoza	245	50245	Sigüés	187	94	93	50.2673796791444	49.7326203208556
50	Zaragoza	246	50246	Sisamón	82	49	33	59.7560975609756	40.2439024390244
50	Zaragoza	247	50247	Sobradiel	641	319	322	49.7659906396256	50.2340093603744
50	Zaragoza	248	50248	Sos del Rey Católico	774	395	379	51.0335917312661	48.9664082687339
50	Zaragoza	249	50249	Tabuenca	480	262	218	54.5833333333333	45.4166666666667
50	Zaragoza	250	50250	Talamantes	70	42	28	60	40
50	Zaragoza	251	50251	Tarazona	10416	5026	5390	48.252688172043	51.747311827957
50	Zaragoza	252	50252	Tauste	6932	3454	3478	49.8268897864974	50.1731102135026
50	Zaragoza	253	50253	Terrer	625	300	325	48	52
50	Zaragoza	254	50254	Tierga	253	141	112	55.7312252964427	44.2687747035573
50	Zaragoza	255	50255	Tobed	281	142	139	50.5338078291815	49.4661921708185
50	Zaragoza	256	50256	Torralba de los Frailes	105	51	54	48.5714285714286	51.4285714285714
50	Zaragoza	257	50257	Torralba de Ribota	220	120	100	54.5454545454545	45.4545454545455
50	Zaragoza	258	50258	Torralbilla	76	38	38	50	50
50	Zaragoza	259	50259	Torrehermosa	114	62	52	54.3859649122807	45.6140350877193
50	Zaragoza	260	50260	Torrelapaja	45	22	23	48.8888888888889	51.1111111111111
50	Zaragoza	261	50261	Torrellas	305	154	151	50.4918032786885	49.5081967213115
50	Zaragoza	262	50262	Torres de Berrellén	1400	709	691	50.6428571428572	49.3571428571429
50	Zaragoza	263	50263	Torrijo de la Cañada	386	211	175	54.6632124352332	45.3367875647668
50	Zaragoza	264	50264	Tosos	200	103	97	51.5	48.5
50	Zaragoza	265	50265	Trasmoz	60	32	28	53.3333333333333	46.6666666666667
50	Zaragoza	266	50266	Trasobares	226	118	108	52.212389380531	47.787610619469
50	Zaragoza	267	50267	Uncastillo	889	435	454	48.9313835770529	51.0686164229471
50	Zaragoza	268	50268	Undués de Lerda	48	29	19	60.4166666666667	39.5833333333333
50	Zaragoza	269	50269	Urrea de Jalón	334	171	163	51.1976047904192	48.8023952095808
50	Zaragoza	270	50270	Urriés	77	45	32	58.4415584415584	41.5584415584416
50	Zaragoza	271	50271	Used	383	207	176	54.0469973890339	45.9530026109661
50	Zaragoza	272	50272	Utebo	10719	5427	5292	50.6297229219144	49.3702770780856
50	Zaragoza	273	50273	Valdehorna	59	30	29	50.8474576271186	49.1525423728814
50	Zaragoza	274	50274	Val de San Martín	84	39	45	46.4285714285714	53.5714285714286
50	Zaragoza	275	50275	Valmadrid	67	39	28	58.2089552238806	41.7910447761194
50	Zaragoza	276	50276	Valpalmas	200	98	102	49	51
50	Zaragoza	277	50277	Valtorres	90	43	47	47.7777777777778	52.2222222222222
50	Zaragoza	278	50278	Velilla de Ebro	276	134	142	48.5507246376812	51.4492753623188
50	Zaragoza	279	50279	Velilla de Jiloca	116	59	57	50.8620689655172	49.1379310344828
50	Zaragoza	280	50280	Vera de Moncayo	482	250	232	51.8672199170125	48.1327800829876
50	Zaragoza	281	50281	Vierlas	108	55	53	50.9259259259259	49.0740740740741
50	Zaragoza	282	50282	Vilueña (La)	101	43	58	42.5742574257426	57.4257425742574
50	Zaragoza	283	50283	Villadoz	83	47	36	56.6265060240964	43.3734939759036
50	Zaragoza	284	50284	Villafeliche	245	121	124	49.3877551020408	50.6122448979592
50	Zaragoza	285	50285	Villafranca de Ebro	680	331	349	48.6764705882353	51.3235294117647
50	Zaragoza	286	50286	Villalba de Perejil	114	60	54	52.6315789473684	47.3684210526316
50	Zaragoza	287	50287	Villalengua	428	225	203	52.5700934579439	47.4299065420561
50	Zaragoza	288	50288	Villanueva de Gállego	3134	1587	1547	50.6381620931717	49.3618379068283
50	Zaragoza	289	50289	Villanueva de Jiloca	115	57	58	49.5652173913044	50.4347826086956
50	Zaragoza	290	50290	Villanueva de Huerva	598	310	288	51.8394648829431	48.1605351170569
50	Zaragoza	291	50291	Villar de los Navarros	175	80	95	45.7142857142857	54.2857142857143
50	Zaragoza	292	50292	Villarreal de Huerva	182	100	82	54.9450549450549	45.0549450549451
50	Zaragoza	293	50293	Villarroya de la Sierra	683	348	335	50.9516837481698	49.0483162518302
50	Zaragoza	294	50294	Villarroya del Campo	86	43	43	50	50
50	Zaragoza	295	50295	Vistabella	34	19	15	55.8823529411765	44.1176470588235
50	Zaragoza	296	50296	Zaida (La)	596	294	302	49.3288590604027	50.6711409395973
50	Zaragoza	297	50297	Zaragoza	604631	290842	313789	48.102396337601	51.8976036623991
50	Zaragoza	298	50298	Zuera	5448	2798	2650	51.3582966226138	48.6417033773862
50	Zaragoza	901	50901	Biel	240	133	107	55.4166666666667	44.5833333333333
50	Zaragoza	902	50902	Marracos	130	66	64	50.7692307692308	49.2307692307692
51	Ceuta	001	51001	Ceuta	75241	38497	36744	51.1649233795404	48.8350766204596
52	Melilla	001	52001	Melilla	66263	33976	32287	51.2744668970617	48.7255331029383
